FECHA,N° DOC,TERCERO,DESCRIPCIÓN,ORIGEN,DEBITO,CREDITO,SALDO
01/02/2024,11733,,9160,Terminal LS - Efectivo TPV,71500,0,"-28500,37"
01/02/2024,11722,,9138,Terminal LS - Efectivo TPV,"163680,02",0,"135179,65"
01/02/2024,11724,,9140,Terminal LS - Efectivo TPV,106700,0,"241879,65"
01/02/2024,11730,,9152,Terminal LS - Efectivo TPV,"118800,01",0,"360679,66"
01/02/2024,11729,,9150,Terminal LS - Efectivo TPV,"78100,01",0,"438779,67"
01/02/2024,11721,,9137,Terminal LS - Efectivo TPV,"157850,02",0,"596629,69"
01/02/2024,11725,,9144,Terminal LS - Efectivo TPV,134000,0,"720629,69"
01/02/2024,11731,,9154,Terminal LS - Efectivo TPV,61050,0,"781679,69"
01/02/2024,11726,,9145,Terminal LS - Efectivo TPV,"102000,01",0,"883679,7"
01/02/2024,11723,,9139,Terminal LS - Efectivo TPV,"56000,01",0,"939679,83"
01/02/2024,11732,,9156,Terminal LS - Efectivo TPV,154660,0,"1027339,29"
01/02/2024,11728,,9149,Terminal LS - Efectivo TPV,53000,0,"1080339,29"
01/02/2024,11727,,9148,Terminal LS - Efectivo TPV,70000,0,"1150339,29"
01/03/2024,11734,,,Terminal LS - Efectivo TPV,1327200,0,"2477539,29"
01/03/2024,11855,,9194,Terminal LS - Efectivo TPV,6800,0,"2484339,29"
01/03/2024,11854,,9193,Terminal LS - Efectivo TPV,74580,0,"2558919,29"
01/03/2024,11734,,,Terminal LS - Efectivo TPV,0,1327200,"1231719,29"
01/03/2024,11754,,,Terminal LS - Transferencia TPV,602200,0,"1833919,29"
01/03/2024,11848,,9168,Terminal LS - Efectivo TPV,14000,0,"1847919,29"
01/03/2024,11746,,,Terminal LS - Tarjeta TPV,1074678,0,"2922597,29"
01/03/2024,11853,,9192,Terminal LS - Efectivo TPV,51000,0,"2618098,14"
01/03/2024,11852,,9183,Terminal LS - Efectivo TPV,64350,0,"2682448,14"
01/03/2024,11851,,9175,Terminal LS - Efectivo TPV,"19000,01",0,"2701448,15"
01/03/2024,11850,,9171,Terminal LS - Efectivo TPV,49000,0,"2567662,6"
01/03/2024,11849,,9169,Terminal LS - Efectivo TPV,34000,0,"2601662,6"
01/04/2024,12271,,9205,Terminal LS - Efectivo TPV,"71999,99",0,"2673662,59"
01/04/2024,12276,,9244,Terminal LS - Efectivo TPV,"66549,99",0,"2740212,58"
01/04/2024,12273,,9231,Terminal LS - Efectivo TPV,"139699,99",0,"2879912,57"
01/04/2024,12277,,9253,Terminal LS - Efectivo TPV,"69740,01",0,"2949652,58"
01/04/2024,11878,,,Terminal LS - Transferencia TPV,1083180,0,"4032832,58"
01/04/2024,12275,,9239,Terminal LS - Efectivo TPV,68200,0,"4101032,58"
01/04/2024,12274,,9234,Terminal LS - Efectivo TPV,108900,0,"4209932,58"
01/04/2024,12278,,9256,Terminal LS - Efectivo TPV,"144650,01",0,"4354582,59"
01/04/2024,11866,,,Terminal LS - Tarjeta TPV,872489,0,"5227071,59"
01/04/2024,11856,,,Terminal LS - Efectivo TPV,312800,0,"5539871,59"
01/04/2024,12270,,9196,Terminal LS - Efectivo TPV,"30000,01",0,"5569871,6"
01/04/2024,11856,,,Terminal LS - Efectivo TPV,0,312800,"5257071,6"
01/04/2024,12280,,9261,Terminal LS - Efectivo TPV,167200,0,"5424271,6"
01/04/2024,12279,,9260,Terminal LS - Efectivo TPV,"131120,01",0,"5555391,61"
01/04/2024,12272,,9226,Terminal LS - Efectivo TPV,"163350,01",0,"5718741,62"
01/05/2024,12281,,,Terminal LS - Efectivo TPV,1161500,0,"6880241,62"
01/05/2024,12312,,,Terminal LS - Transferencia TPV,2307477,0,"9187718,62"
01/05/2024,12281,,,Terminal LS - Efectivo TPV,0,1161500,"8026218,62"
01/05/2024,12292,,,Terminal LS - Tarjeta TPV,968649,0,"8994867,62"
01/05/2024,12790,,9342,Terminal LS - Efectivo TPV,"14499,99",0,"8987368,03"
01/06/2024,12837,,,Terminal LS - Transferencia TPV,2699538,0,"11686906,03"
01/06/2024,13531,,9455,Terminal LS - Efectivo TPV,"94050,01",0,"11780956,04"
01/06/2024,13525,,9397,Terminal LS - Efectivo TPV,"128150,02",0,"11909106,06"
01/06/2024,13532,,9457,Terminal LS - Efectivo TPV,206114,0,"12115220,06"
01/06/2024,13524,,9394,Terminal LS - Efectivo TPV,53900,0,"12169120,06"
01/06/2024,13529,,9443,Terminal LS - Efectivo TPV,"88000,02",0,"12257120,08"
01/06/2024,13534,,9488,Terminal LS - Efectivo TPV,"132549,99",0,"12389670,07"
01/06/2024,13523,,9391,Terminal LS - Efectivo TPV,52000,0,"12405670,07"
01/06/2024,13535,,9490,Terminal LS - Efectivo TPV,68500,0,"12474170,07"
01/06/2024,13530,,9444,Terminal LS - Efectivo TPV,"57500,01",0,"12531670,08"
01/06/2024,13528,,9435,Terminal LS - Efectivo TPV,"74800,01",0,"12606470,09"
01/06/2024,13527,,9416,Terminal LS - Efectivo TPV,125950,0,"12732420,09"
01/06/2024,13533,,9486,Terminal LS - Efectivo TPV,42000,0,"12774420,09"
01/06/2024,13536,,9498,Terminal LS - Efectivo TPV,"61700,01",0,"12836120,1"
01/06/2024,13522,,9381,Terminal LS - Efectivo TPV,73800,0,"12909920,1"
01/06/2024,13526,,9407,Terminal LS - Efectivo TPV,8800,0,"12918720,1"
01/07/2024,14392,,9592,Terminal LS - Efectivo TPV,"69300,01",0,"12988020,11"
01/07/2024,14401,,9641,Terminal LS - Efectivo TPV,"97700,01",0,"13085720,12"
01/07/2024,14393,,9596,Terminal LS - Efectivo TPV,48400,0,"13134120,12"
01/07/2024,14396,,9603,Terminal LS - Efectivo TPV,"119900,01",0,"13254020,13"
01/07/2024,14394,,9598,Terminal LS - Efectivo TPV,105000,0,"13359020,13"
01/07/2024,14386,,9501,Terminal LS - Efectivo TPV,177500,0,"13536520,13"
01/07/2024,14387,,9515,Terminal LS - Efectivo TPV,"53499,99",0,"13590020,12"
01/07/2024,14388,,9553,Terminal LS - Efectivo TPV,50500,0,"13616520,12"
01/07/2024,14395,,9600,Terminal LS - Efectivo TPV,63650,0,"13680170,12"
01/07/2024,13557,,,Terminal LS - Tarjeta TPV,1869574,0,"15549744,12"
01/07/2024,13537,,,Terminal LS - Efectivo TPV,1267900,0,"16817644,12"
01/07/2024,13585,,,Terminal LS - Transferencia TPV,2621364,0,"19439008,12"
01/07/2024,13537,,,Terminal LS - Efectivo TPV,0,1267900,"18171108,12"
01/07/2024,14398,,9607,Terminal LS - Efectivo TPV,75130,0,"18246238,12"
01/07/2024,14391,,9585,Terminal LS - Efectivo TPV,"142670,02",0,"18388908,14"
01/07/2024,14389,,9566,Terminal LS - Efectivo TPV,53350,0,"18442258,14"
01/07/2024,14399,,9620,Terminal LS - Efectivo TPV,"56000,01",0,"18498258,15"
01/07/2024,14400,,9620,Terminal LS - Efectivo TPV,5600,0,"18503858,15"
01/07/2024,14390,,9567,Terminal LS - Efectivo TPV,"139000,01",0,"18642858,16"
01/07/2024,14385,,9499,Terminal LS - Efectivo TPV,5000,0,"18647858,16"
01/07/2024,14397,,9606,Terminal LS - Efectivo TPV,"189750,02",0,"18837608,18"
01/08/2024,14903,,9722,Terminal LS - Efectivo TPV,"84200,01",0,"18921808,19"
01/08/2024,14905,,9727,Terminal LS - Efectivo TPV,38740,0,"18960548,19"
01/08/2024,14902,,9719,Terminal LS - Efectivo TPV,"207350,01",0,"19167898,2"
01/08/2024,14896,,9678,Terminal LS - Efectivo TPV,34250,0,"19202148,2"
01/08/2024,14895,,9677,Terminal LS - Efectivo TPV,150000,0,"19352148,2"
01/08/2024,14897,,9680,Terminal LS - Efectivo TPV,"151999,99",0,"19504148,19"
01/08/2024,14892,,9646,Terminal LS - Efectivo TPV,"171100,01",0,"19675248,2"
01/08/2024,14900,,9714,Terminal LS - Efectivo TPV,80000,0,"19755248,2"
01/08/2024,14891,,9645,Terminal LS - Efectivo TPV,52000,0,"19807248,2"
01/08/2024,14893,,9663,Terminal LS - Efectivo TPV,9500,0,"19816748,2"
01/08/2024,14906,,9731,Terminal LS - Efectivo TPV,4000,0,"19820748,2"
01/08/2024,14899,,9692,Terminal LS - Efectivo TPV,103000,0,"19923748,2"
01/08/2024,14894,,9669,Terminal LS - Efectivo TPV,"24970,01",0,"19948718,21"
01/08/2024,14901,,9716,Terminal LS - Efectivo TPV,"63250,01",0,"20011968,22"
01/08/2024,14433,,,Terminal LS - Transferencia TPV,1130849,0,"21142817,22"
01/08/2024,14844,,9648,Terminal SE - Efectivo TPV,88330,0,"21231147,22"
01/08/2024,14845,,9649,Terminal SE - Efectivo TPV,16946,0,"21248093,22"
01/08/2024,14846,,9650,Terminal SE - Efectivo TPV,"106700,01",0,"21354793,23"
01/08/2024,14843,,9647,Terminal SE - Efectivo TPV,74114,0,"21428907,23"
01/08/2024,14402,,,Terminal LS - Efectivo TPV,1452000,0,"22873807,23"
01/08/2024,14890,,9642,Terminal LS - Efectivo TPV,"60020,01",0,"22933827,24"
01/08/2024,14419,,,Terminal LS - Tarjeta TPV,1533475,0,"24467302,24"
01/08/2024,14848,,9653,Terminal SE - Efectivo TPV,"23399,99",0,"24490702,23"
01/08/2024,14402,,,Terminal LS - Efectivo TPV,0,1452000,"23038702,23"
01/08/2024,14904,,9723,Terminal LS - Efectivo TPV,"73150,01",0,"23111852,24"
01/09/2024,15119,,9757,Terminal LS - Tarjeta TPV,"211750,01",0,"23323602,25"
01/09/2024,15112,,9735,Terminal LS - Tarjeta TPV,69300,0,"23392902,25"
01/09/2024,15108,,9763,Terminal LS - Efectivo TPV,"66070,01",0,"23458972,26"
01/09/2024,14922,,,Terminal LS - Tarjeta TPV,1735656,0,"25194628,26"
01/09/2024,14907,,,Terminal LS - Efectivo TPV,1357550,0,"26552178,26"
01/09/2024,15104,,9753,Terminal LS - Efectivo TPV,69850,0,"26622028,26"
01/09/2024,15103,,9752,Terminal LS - Efectivo TPV,71225,0,"26693253,26"
01/09/2024,15102,,9747,Terminal LS - Efectivo TPV,"52000,01",0,"26745253,27"
01/09/2024,15098,,9734,Terminal LS - Efectivo TPV,"57750,01",0,"26803003,28"
01/09/2024,15105,,9756,Terminal LS - Efectivo TPV,240000,0,"27043003,28"
01/09/2024,15110,,9732,Terminal LS - Tarjeta TPV,70730,0,"27113733,28"
01/09/2024,15118,,9756,Terminal LS - Tarjeta TPV,28400,0,"27142133,28"
01/09/2024,14940,,,Terminal LS - Transferencia TPV,1565180,0,"28707313,28"
01/09/2024,14907,,,Terminal LS - Efectivo TPV,0,1357550,"27239063,28"
01/09/2024,15107,,9760,Terminal LS - Efectivo TPV,99935,0,"17453783,33"
01/09/2024,15106,,9759,Terminal LS - Efectivo TPV,35000,0,"16976176,51"
01/09/2024,15115,,9743,Terminal LS - Tarjeta TPV,"251020,01",0,"17227196,52"
01/09/2024,15122,,9764,Terminal LS - Tarjeta TPV,"73259,99",0,"17300456,51"
01/09/2024,15117,,9755,Terminal LS - Tarjeta TPV,116050,0,"17416506,51"
01/09/2024,15111,,9733,Terminal LS - Tarjeta TPV,176000,0,"17592506,51"
01/09/2024,15113,,9736,Terminal LS - Tarjeta TPV,65450,0,"17657956,51"
01/09/2024,15120,,9761,Terminal LS - Tarjeta TPV,"126346,01",0,"17784302,52"
01/09/2024,15121,,9762,Terminal LS - Tarjeta TPV,"38342,01",0,"17822644,53"
01/09/2024,15101,,9745,Terminal LS - Efectivo TPV,68200,0,"17890844,53"
01/09/2024,15100,,9741,Terminal LS - Efectivo TPV,"156750,01",0,"18047594,54"
01/09/2024,15114,,9740,Terminal LS - Tarjeta TPV,"65450,01",0,"18113044,55"
01/09/2024,15116,,9748,Terminal LS - Tarjeta TPV,"138599,99",0,"18251644,54"
01/09/2024,15099,,9737,Terminal LS - Efectivo TPV,143000,0,"18394644,54"
01/10/2024,15305,,9795,Terminal LS - Efectivo TPV,0,5000,"18389644,54"
01/10/2024,15293,,9767,Terminal LS - Efectivo TPV,60000,0,"18449644,54"
01/10/2024,15300,,9780,Terminal LS - Efectivo TPV,4000,0,"18453644,54"
01/10/2024,15303,,9790,Terminal LS - Efectivo TPV,92275,0,"18545919,54"
01/10/2024,15296,,9774,Terminal LS - Efectivo TPV,68750,0,"18614669,54"
01/10/2024,15297,,9776,Terminal LS - Efectivo TPV,97500,0,"18712169,54"
01/10/2024,15137,,,Terminal LS - Transferencia TPV,935380,0,"19606589,54"
01/10/2024,15295,,9770,Terminal LS - Efectivo TPV,"90000,01",0,"19626589,55"
01/10/2024,15294,,9769,Terminal LS - Efectivo TPV,22000,0,"19648589,55"
01/10/2024,15304,,9792,Terminal LS - Efectivo TPV,272030,0,"19920619,55"
01/10/2024,15307,,9766,Terminal LS - Tarjeta TPV,74250,0,"19994869,55"
01/10/2024,15298,,9778,Terminal LS - Efectivo TPV,24500,0,"20019369,55"
01/10/2024,15299,,9779,Terminal LS - Efectivo TPV,"130000,01",0,"20149369,56"
01/10/2024,15301,,9781,Terminal LS - Efectivo TPV,"72649,99",0,"20222019,55"
01/10/2024,15124,,,Terminal LS - Tarjeta TPV,1567315,0,"21789334,55"
01/10/2024,15109,,,Terminal LS - Efectivo TPV,1059800,0,"22849134,55"
01/10/2024,15302,,9785,Terminal LS - Efectivo TPV,60000,0,"22909134,55"
01/10/2024,15109,,,Terminal LS - Efectivo TPV,0,1059800,"21849334,55"
01/11/2024,15568,,9844,Terminal SE - Transferencia TPV,"256849,99",0,"22106184,54"
01/11/2024,15306,,,Terminal LS - Efectivo TPV,0,988750,"21117434,54"
01/11/2024,15326,,,Terminal LS - Transferencia TPV,1133602,0,"22251036,54"
01/11/2024,15573,,9809,Terminal LS - Efectivo TPV,67000,0,"22318036,54"
01/11/2024,15574,,9810,Terminal LS - Efectivo TPV,58000,0,"22376036,54"
01/11/2024,15575,,9812,Terminal LS - Efectivo TPV,169500,0,"22545536,54"
01/11/2024,15576,,9819,Terminal LS - Efectivo TPV,154990,0,"22700526,54"
01/11/2024,15577,,9829,Terminal LS - Efectivo TPV,61500,0,"22762026,54"
01/11/2024,15578,,9831,Terminal LS - Efectivo TPV,"65999,99",0,"22828026,53"
01/11/2024,15569,,9846,Terminal SE - Transferencia TPV,47000,0,"22875026,53"
01/11/2024,15571,,9846,Terminal SE - Transferencia TPV,42300,0,"22917326,53"
01/11/2024,15317,,,Terminal LS - Tarjeta TPV,1060801,0,"23978127,53"
01/11/2024,15306,,,Terminal LS - Efectivo TPV,988750,0,"24966877,53"
01/11/2024,15570,,9846,Terminal SE - Transferencia TPV,50400,0,"25017277,53"
01/12/2024,16003,,9867,Terminal LS - Efectivo TPV,65000,0,"25082277,53"
01/12/2024,15604,,,Terminal LS - Transferencia TPV,1114809,0,"26197086,53"
01/12/2024,16005,,9885,Terminal LS - Efectivo TPV,"65482,01",0,"26262568,54"
01/12/2024,16008,,9914,Terminal LS - Efectivo TPV,60300,0,"26322868,54"
01/12/2024,16007,,9907,Terminal LS - Efectivo TPV,"111000,01",0,"26433868,55"
01/12/2024,15579,,,Terminal LS - Efectivo TPV,577000,0,"27004868,55"
01/12/2024,15593,,,Terminal LS - Tarjeta TPV,1289837,0,"28294705,55"
01/12/2024,16006,,9891,Terminal LS - Efectivo TPV,150400,0,"28445105,55"
01/12/2024,15579,,,Terminal LS - Efectivo TPV,0,577000,"27868105,55"
01/12/2024,16004,,9883,Terminal LS - Efectivo TPV,60500,0,"27913605,55"
01/13/2024,16059,,,Terminal LS - Transferencia TPV,4716451,0,"32546296,55"
01/13/2024,16715,,10033,Terminal LS - Efectivo TPV,88550,0,"32634846,55"
01/13/2024,16706,,9982,Terminal LS - Efectivo TPV,135850,0,"32770696,55"
01/13/2024,16699,,9955,Terminal LS - Efectivo TPV,11500,0,"32782196,55"
01/13/2024,16713,,10018,Terminal LS - Efectivo TPV,"197889,99",0,"32980086,54"
01/13/2024,16712,,10013,Terminal LS - Efectivo TPV,"213289,98",0,"33193376,52"
01/13/2024,16716,,10038,Terminal LS - Efectivo TPV,"268938,01",0,"33462314,53"
01/13/2024,16704,,9978,Terminal LS - Efectivo TPV,"79299,99",0,"33541614,52"
01/13/2024,16718,,10042,Terminal LS - Efectivo TPV,168300,0,"33709914,52"
01/13/2024,16710,,9999,Terminal LS - Efectivo TPV,12330,0,"33722244,52"
01/13/2024,16705,,9980,Terminal LS - Efectivo TPV,"141109,99",0,"33863354,51"
01/13/2024,16711,,10006,Terminal LS - Efectivo TPV,"86899,99",0,"33950254,5"
01/13/2024,16714,,10023,Terminal LS - Efectivo TPV,"140524,99",0,"34090779,49"
01/13/2024,16707,,9983,Terminal LS - Efectivo TPV,80960,0,"34171739,49"
01/13/2024,16717,,10040,Terminal LS - Efectivo TPV,"128479,99",0,"34300219,48"
01/13/2024,16009,,,Terminal LS - Efectivo TPV,0,512700,"33787519,48"
01/13/2024,16709,,9997,Terminal LS - Efectivo TPV,77550,0,"33865069,48"
01/13/2024,16708,,9991,Terminal LS - Efectivo TPV,18049,0,"33883118,48"
01/13/2024,16703,,9974,Terminal LS - Efectivo TPV,72600,0,"33955718,48"
01/13/2024,16700,,9957,Terminal LS - Efectivo TPV,75900,0,"34031618,48"
01/13/2024,16009,,,Terminal LS - Efectivo TPV,512700,0,"34544318,48"
01/13/2024,16025,,,Terminal LS - Tarjeta TPV,1617700,0,"36162018,48"
01/13/2024,16701,,9964,Terminal LS - Efectivo TPV,69300,0,"36231318,48"
01/13/2024,16702,,9969,Terminal LS - Efectivo TPV,86020,0,"36317338,48"
01/14/2024,17344,,10130,Terminal LS - Efectivo TPV,"77219,99",0,"36394558,47"
01/14/2024,16761,,,Terminal LS - Transferencia TPV,2152469,0,"38547027,47"
01/14/2024,16719,,,Terminal LS - Efectivo TPV,2153350,0,"40700377,47"
01/14/2024,17341,,10112,Terminal LS - Efectivo TPV,"83710,01",0,"40784087,48"
01/14/2024,17342,,10127,Terminal LS - Efectivo TPV,176000,0,"40960087,48"
01/14/2024,17348,,10147,Terminal LS - Efectivo TPV,"215159,99",0,"41175247,47"
01/14/2024,17347,,10140,Terminal LS - Efectivo TPV,129800,0,"41305047,47"
01/14/2024,17346,,10139,Terminal LS - Efectivo TPV,"79749,99",0,"41384797,46"
01/14/2024,17345,,10131,Terminal LS - Efectivo TPV,92840,0,"41477637,46"
01/14/2024,17337,,10053,Terminal LS - Efectivo TPV,"69296,99",0,"41546934,45"
01/14/2024,17338,,10066,Terminal LS - Efectivo TPV,61000,0,"41607934,45"
01/14/2024,17343,,10129,Terminal LS - Efectivo TPV,85800,0,"41693734,45"
01/14/2024,16719,,,Terminal LS - Efectivo TPV,0,2153350,"39540384,45"
01/14/2024,16741,,,Terminal LS - Tarjeta TPV,2294126,0,"41834510,45"
01/14/2024,17339,,10070,Terminal LS - Efectivo TPV,"97019,98",0,"41931530,43"
01/14/2024,17340,,10083,Terminal LS - Efectivo TPV,142065,0,"42073595,43"
01/15/2024,17361,,,Terminal LS - Tarjeta TPV,1492947,0,"43566542,43"
01/15/2024,17349,,,Terminal LS - Efectivo TPV,0,1309700,"42256842,43"
01/15/2024,17336,,,Terminal LS - Transferencia TPV,2392574,0,"44649416,43"
01/15/2024,17349,,,Terminal LS - Efectivo TPV,1309700,0,"45959116,43"
01/16/2024,17460,,10165,Terminal LS - Efectivo TPV,3330,0,"45486065,43"
01/16/2024,17457,,10152,Terminal LS - Efectivo TPV,101000,0,"45587065,43"
01/16/2024,17461,,10167,Terminal LS - Efectivo TPV,75460,0,"45609525,43"
01/16/2024,17458,,10153,Terminal LS - Efectivo TPV,175010,0,"45784535,43"
01/16/2024,17459,,10163,Terminal LS - Efectivo TPV,76450,0,"41860985,43"
01/17/2024,17469,,,Terminal LS - Tarjeta TPV,976676,0,"42837661,43"
01/17/2024,17462,,,Terminal LS - Efectivo TPV,0,432450,"42405211,43"
01/17/2024,17479,,,Terminal LS - Transferencia TPV,1167734,0,"43572945,43"
01/17/2024,17592,,10189,Terminal LS - Efectivo TPV,"114529,99",0,"43687475,42"
01/17/2024,17591,,10188,Terminal LS - Efectivo TPV,41703,0,"43729178,42"
01/17/2024,17590,,10182,Terminal LS - Efectivo TPV,77550,0,"43806728,42"
01/17/2024,17589,,10180,Terminal LS - Efectivo TPV,78430,0,"43885158,42"
01/17/2024,17588,,10176,Terminal LS - Efectivo TPV,52000,0,"43937158,42"
01/17/2024,17587,,10175,Terminal LS - Efectivo TPV,49000,0,"43986158,42"
01/17/2024,17462,,,Terminal LS - Efectivo TPV,432450,0,"44418608,42"
01/18/2024,17841,,10233,Terminal LS - Tarjeta TPV,67980,0,"44336588,27"
01/18/2024,17840,,10232,Terminal LS - Tarjeta TPV,"272052,01",0,"44608640,28"
01/18/2024,17845,,10240,Terminal LS - Tarjeta TPV,69465,0,"44678105,28"
01/18/2024,17593,,,Terminal LS - Efectivo TPV,0,413350,"44264755,28"
01/18/2024,17576,,,Terminal LS - Tarjeta TPV,736725,0,"45001480,28"
01/18/2024,17586,,,Terminal LS - Transferencia TPV,1010606,0,"46012086,28"
01/18/2024,17826,,10203,Terminal LS - Efectivo TPV,105820,0,"46117906,28"
01/18/2024,17849,,10215,Terminal LS - Transferencia TPV,89100,0,"46207006,28"
01/18/2024,17844,,10236,Terminal LS - Tarjeta TPV,49000,0,"46256006,28"
01/18/2024,17831,,10226,Terminal LS - Efectivo TPV,"448622,01",0,"46704628,29"
01/18/2024,17843,,10235,Terminal LS - Tarjeta TPV,160000,0,"46864628,29"
01/18/2024,17827,,10205,Terminal LS - Efectivo TPV,"153999,99",0,"47018628,28"
01/18/2024,17828,,10213,Terminal LS - Efectivo TPV,"107000,01",0,"47125628,29"
01/18/2024,17829,,10218,Terminal LS - Efectivo TPV,"81999,99",0,"47207628,28"
01/18/2024,17593,,,Terminal LS - Efectivo TPV,413350,0,"47620978,28"
01/18/2024,17848,,10210,Terminal LS - Transferencia TPV,88330,0,"47709308,28"
01/18/2024,17842,,10234,Terminal LS - Tarjeta TPV,78870,0,"47788178,28"
01/18/2024,17832,,10235,Terminal LS - Efectivo TPV,"118739,98",0,"47906918,26"
01/18/2024,17830,,10221,Terminal LS - Efectivo TPV,"102519,99",0,"48009438,25"
01/18/2024,17847,,10208,Terminal LS - Transferencia TPV,22120,0,"48031558,25"
01/19/2024,18336,,10261,Terminal LS - Efectivo TPV,70075,0,"48101633,25"
01/19/2024,18331,,10249,Terminal LS - Efectivo TPV,"59999,99",0,"48161633,24"
01/19/2024,18333,,10257,Terminal LS - Efectivo TPV,"100760,01",0,"48262393,25"
01/19/2024,17861,,,Terminal LS - Transferencia TPV,1578771,0,"49841164,25"
01/19/2024,17833,,,Terminal LS - Efectivo TPV,0,1118750,"48722414,25"
01/19/2024,18338,,10277,Terminal LS - Efectivo TPV,5800,0,"48728214,25"
01/19/2024,18340,,10320,Terminal LS - Efectivo TPV,110995,0,"48839209,25"
01/19/2024,18337,,10275,Terminal LS - Efectivo TPV,90970,0,"48930179,25"
01/19/2024,17833,,,Terminal LS - Efectivo TPV,1118750,0,"50048929,25"
01/19/2024,17846,,,Terminal LS - Tarjeta TPV,1191715,0,"51240644,25"
01/19/2024,18332,,10254,Terminal LS - Efectivo TPV,10000,0,"51235644,25"
01/19/2024,18335,,10260,Terminal LS - Efectivo TPV,"65999,99",0,"51301644,24"
01/19/2024,18334,,10258,Terminal LS - Efectivo TPV,54000,0,"51355644,24"
01/19/2024,17846,,,Terminal LS - Tarjeta TPV,0,1191715,"50163929,24"
01/19/2024,18341,,10326,Terminal LS - Efectivo TPV,"96470,01",0,"50260399,25"
01/19/2024,18339,,10294,Terminal LS - Efectivo TPV,126000,0,"50386399,25"
01/20/2024,19140,,10390,Terminal LS - Efectivo TPV,90420,0,"50476819,25"
01/20/2024,19142,,10420,Terminal LS - Efectivo TPV,267850,0,"50744669,25"
01/20/2024,19141,,10409,Terminal LS - Efectivo TPV,"106700,01",0,"50851369,26"
01/20/2024,19144,,10437,Terminal LS - Efectivo TPV,83050,0,"50934419,26"
01/20/2024,19135,,10354,Terminal LS - Efectivo TPV,66550,0,"51000969,26"
01/20/2024,19133,,10333,Terminal LS - Efectivo TPV,77000,0,"51077969,26"
01/20/2024,18342,,,Terminal LS - Efectivo TPV,791100,0,"51869069,26"
01/20/2024,18374,,,Terminal LS - Transferencia TPV,3691051,0,"55560120,26"
01/20/2024,19147,,10463,Terminal LS - Efectivo TPV,50500,0,"55610620,26"
01/20/2024,19145,,10443,Terminal LS - Efectivo TPV,"19999,97",0,"55630620,23"
01/20/2024,18342,,,Terminal LS - Efectivo TPV,0,791100,"54839520,23"
01/20/2024,19138,,10371,Terminal LS - Efectivo TPV,100000,0,"54932020,23"
01/20/2024,19143,,10431,Terminal LS - Efectivo TPV,"254759,99",0,"55186780,22"
01/20/2024,19136,,10358,Terminal LS - Efectivo TPV,5800,0,"55192580,22"
01/20/2024,19139,,10380,Terminal LS - Efectivo TPV,5000,0,"55197580,22"
01/20/2024,19134,,10337,Terminal LS - Efectivo TPV,82000,0,"55279580,22"
01/20/2024,19137,,10366,Terminal LS - Efectivo TPV,7600,0,"55287180,22"
01/20/2024,19146,,10451,Terminal LS - Efectivo TPV,70510,0,"55357690,22"
01/21/2024,19148,,,Terminal LS - Efectivo TPV,0,1287700,"54069990,22"
01/21/2024,19166,,,Terminal LS - Tarjeta TPV,1692591,0,"55762581,22"
01/21/2024,19202,,,Terminal LS - Transferencia TPV,4331846,0,"60094427,22"
01/21/2024,19742,,10559,Terminal LS - Efectivo TPV,"59999,99",0,"60154427,21"
01/21/2024,19738,,10523,Terminal LS - Efectivo TPV,"166000,01",0,"60270427,22"
01/21/2024,19744,,10571,Terminal LS - Efectivo TPV,"163900,01",0,"60434327,23"
01/21/2024,19743,,10562,Terminal LS - Efectivo TPV,29120,0,"60448447,23"
01/21/2024,19148,,,Terminal LS - Efectivo TPV,1287700,0,"61736147,23"
01/21/2024,19741,,10547,Terminal LS - Efectivo TPV,97570,0,"61833717,23"
01/21/2024,19739,,10529,Terminal LS - Efectivo TPV,118000,0,"61951717,23"
01/21/2024,19745,,10577,Terminal LS - Efectivo TPV,119900,0,"62071617,23"
01/21/2024,19740,,10542,Terminal LS - Efectivo TPV,163000,0,"62234617,23"
01/22/2024,19746,,,Terminal LS - Efectivo TPV,917500,0,"63152117,23"
01/22/2024,19746,,,Terminal LS - Efectivo TPV,0,917500,"62234617,23"
01/22/2024,19783,,,Terminal LS - Transferencia TPV,1727500,0,"63962117,23"
01/22/2024,19765,,,Terminal LS - Tarjeta TPV,1683984,0,"65646101,23"
01/23/2024,19937,,10580,Terminal LS - Efectivo TPV,"84150,01",0,"65713251,25"
01/23/2024,19936,,10578,Terminal LS - Efectivo TPV,"94599,99",0,"65807851,24"
01/23/2024,19938,,10581,Terminal LS - Efectivo TPV,7600,0,"65773571,24"
01/23/2024,19940,,10592,Terminal LS - Efectivo TPV,"217360,01",0,"65627555,62"
01/23/2024,19939,,10585,Terminal LS - Efectivo TPV,"59579,99",0,"65687135,61"
01/24/2024,19950,,,Terminal LS - Tarjeta TPV,946595,0,"66389959,82"
01/24/2024,19962,,,Terminal LS - Transferencia TPV,773120,0,"67163079,82"
01/24/2024,19941,,,Terminal LS - Efectivo TPV,0,463350,"66699729,82"
01/24/2024,19941,,,Terminal LS - Efectivo TPV,463350,0,"67152839,82"
01/25/2024,20438,,10659,Terminal LS - Efectivo TPV,63000,0,"67207439,82"
01/25/2024,20439,,10663,Terminal LS - Efectivo TPV,"105000,98",0,"67312440,8"
01/25/2024,20444,,10682,Terminal LS - Efectivo TPV,89920,0,"67402360,8"
01/25/2024,20443,,10680,Terminal LS - Efectivo TPV,35500,0,"67437860,8"
01/25/2024,20442,,10679,Terminal LS - Efectivo TPV,24000,0,"67461860,8"
01/25/2024,20445,,10683,Terminal LS - Efectivo TPV,8000,0,"67469860,8"
01/25/2024,20441,,10672,Terminal LS - Efectivo TPV,"342964,98",0,"67812825,78"
01/25/2024,20440,,10669,Terminal LS - Efectivo TPV,173722,0,"67986547,78"
01/25/2024,20435,,10630,Terminal LS - Efectivo TPV,15200,0,"68001747,78"
01/25/2024,20437,,10654,Terminal LS - Efectivo TPV,84676,0,"68086423,78"
01/25/2024,20436,,10643,Terminal LS - Efectivo TPV,9800,0,"68096223,78"
01/26/2024,20842,,10685,Terminal LS - Efectivo TPV,10400,0,"68106623,78"
01/26/2024,20845,,10719,Terminal LS - Efectivo TPV,"46708,99",0,"68153332,77"
01/26/2024,20843,,10690,Terminal LS - Efectivo TPV,63370,0,"68216702,77"
01/26/2024,20847,,10726,Terminal LS - Efectivo TPV,61000,0,"68277702,77"
01/26/2024,20446,,,Terminal LS - Efectivo TPV,0,951800,"67325902,77"
01/26/2024,20844,,10707,Terminal LS - Efectivo TPV,150000,0,"67475902,77"
01/26/2024,20467,,,Terminal LS - Transferencia TPV,2219519,0,"69667921,77"
01/26/2024,20446,,,Terminal LS - Efectivo TPV,951800,0,"70619721,77"
01/26/2024,20479,,,Terminal LS - Tarjeta TPV,1394978,0,"72014699,77"
01/26/2024,20841,,10684,Terminal LS - Efectivo TPV,"130000,01",0,"72144699,78"
01/26/2024,20846,,10725,Terminal LS - Efectivo TPV,"66999,99",0,"72211699,77"
01/27/2024,21533,,10866,Terminal LS - Efectivo TPV,103687,0,"69315386,77"
01/27/2024,21481,,10872,Terminal SE - Transferencia TPV,"144550,24",0,"69437787,01"
01/27/2024,21485,,10884,Terminal SE - Transferencia TPV,"85440,99",0,69523228
01/27/2024,21480,,10871,Terminal SE - Transferencia TPV,65883,0,69589111
01/27/2024,21527,,10823,Terminal LS - Efectivo TPV,"107292,99",0,"69696403,99"
01/27/2024,21531,,10839,Terminal LS - Efectivo TPV,64463,0,"69760866,99"
01/27/2024,21517,,10764,Terminal LS - Efectivo TPV,7600,0,"69768466,99"
01/27/2024,21525,,10817,Terminal LS - Efectivo TPV,"51999,99",0,"69820466,98"
01/27/2024,21537,,10889,Terminal LS - Efectivo TPV,66757,0,"69887223,98"
01/27/2024,21528,,10824,Terminal LS - Efectivo TPV,51352,0,"69938575,98"
01/27/2024,21532,,10854,Terminal LS - Efectivo TPV,"84020,01",0,"70022595,99"
01/27/2024,21523,,10811,Terminal LS - Efectivo TPV,78557,0,"70101152,99"
01/27/2024,21535,,10875,Terminal LS - Efectivo TPV,"325426,98",0,"70426579,97"
01/27/2024,21529,,10827,Terminal LS - Efectivo TPV,"140179,99",0,"70476810,24"
01/27/2024,21484,,10883,Terminal SE - Transferencia TPV,59400,0,"70536210,24"
01/27/2024,21518,,10766,Terminal LS - Efectivo TPV,103796,0,"70640006,24"
01/27/2024,21522,,10810,Terminal LS - Efectivo TPV,57000,0,"70697006,24"
01/27/2024,21536,,10886,Terminal LS - Efectivo TPV,85769,0,"70782775,24"
01/27/2024,21519,,10776,Terminal LS - Efectivo TPV,"119499,99",0,"70902275,23"
01/27/2024,21521,,10803,Terminal LS - Efectivo TPV,7600,0,"70909875,23"
01/27/2024,21534,,10867,Terminal LS - Efectivo TPV,189700,0,"71099575,23"
01/27/2024,21479,,10870,Terminal SE - Transferencia TPV,91778,0,"71191353,23"
01/27/2024,21520,,10787,Terminal LS - Efectivo TPV,59904,0,"71251257,23"
01/27/2024,21530,,10832,Terminal LS - Efectivo TPV,5000,0,"71256257,23"
01/27/2024,21524,,10814,Terminal LS - Efectivo TPV,170000,0,"71426257,23"
01/27/2024,21526,,10822,Terminal LS - Efectivo TPV,"80305,99",0,"71506563,22"
01/27/2024,21482,,10876,Terminal SE - Transferencia TPV,65000,0,"71571563,22"
01/27/2024,21483,,10883,Terminal SE - Transferencia TPV,120000,0,"71691563,22"
01/28/2024,21486,,,Terminal SE - Transferencia TPV,0,5906246,"65785317,22"
01/28/2024,21992,,10971,Terminal LS - Efectivo TPV,"9999,99",0,"65780317,21"
01/28/2024,21990,,10967,Terminal LS - Efectivo TPV,"85768,99",0,"65866086,2"
01/28/2024,21486,,,Terminal SE - Transferencia TPV,5906246,0,"71772332,2"
01/28/2024,21991,,10970,Terminal LS - Efectivo TPV,198306,0,"71970638,2"
01/28/2024,21985,,10894,Terminal LS - Efectivo TPV,"100955,99",0,"72071594,19"
01/28/2024,21986,,10896,Terminal LS - Efectivo TPV,67000,0,"72138594,19"
01/28/2024,21538,,,Terminal LS - Efectivo TPV,0,2459950,"69678644,19"
01/28/2024,21581,,,Terminal LS - Transferencia TPV,2278611,0,"71957255,19"
01/28/2024,21487,,,Terminal SE - Transferencia TPV,0,"6731,41","71950523,78"
01/28/2024,21487,,,Terminal SE - Transferencia TPV,"6731,41",0,"71957255,19"
01/28/2024,21558,,,Terminal LS - Tarjeta TPV,2033440,0,"73990695,19"
01/28/2024,21538,,,Terminal LS - Efectivo TPV,2459950,0,"76450645,19"
01/28/2024,21993,,10973,Terminal LS - Efectivo TPV,76481,0,"76527126,19"
01/28/2024,21988,,10952,Terminal LS - Efectivo TPV,44000,0,"76571126,19"
01/28/2024,21989,,10953,Terminal LS - Efectivo TPV,75028,0,"76646154,19"
01/28/2024,21987,,10921,Terminal LS - Efectivo TPV,278065,0,"76924219,19"
01/29/2024,22004,,,Terminal LS - Tarjeta TPV,1068578,0,"77992797,19"
01/29/2024,21994,,,Terminal LS - Efectivo TPV,935650,0,"78928447,19"
01/29/2024,21994,,,Terminal LS - Efectivo TPV,0,935650,"77992797,19"
01/29/2024,22016,,,Terminal LS - Transferencia TPV,1027622,0,"79020419,19"
01/30/2024,22188,,10997,Terminal LS - Efectivo TPV,"81944,01",0,"79102363,2"
01/30/2024,22187,,10992,Terminal LS - Efectivo TPV,114000,0,"79208963,2"
01/30/2024,22189,,10999,Terminal LS - Efectivo TPV,"230637,99",0,"79439601,19"
01/30/2024,22186,,10988,Terminal LS - Efectivo TPV,130000,0,"79550901,49"
01/30/2024,22185,,10987,Terminal LS - Efectivo TPV,229000,0,"79779901,49"
01/30/2024,22184,,10982,Terminal LS - Efectivo TPV,76481,0,"79856382,49"
01/31/2024,22362,,11011,Terminal LS - Efectivo TPV,"79430,99",0,"79935813,48"
01/31/2024,22361,,11010,Terminal LS - Efectivo TPV,"62799,99",0,"79998613,47"
01/31/2024,22190,,,Terminal LS - Efectivo TPV,0,862063,"79132050,47"
01/31/2024,22198,,,Terminal LS - Tarjeta TPV,795516,0,"79757566,47"
01/31/2024,22190,,,Terminal LS - Efectivo TPV,862063,0,"80329626,37"
01/31/2024,22210,,,Terminal LS - Transferencia TPV,1008638,0,"81027309,01"
01/31/2024,22366,,11022,Terminal LS - Efectivo TPV,190111,0,"81217420,01"
01/31/2024,22365,,11019,Terminal LS - Efectivo TPV,82054,0,"81299474,01"
01/31/2024,22364,,11015,Terminal LS - Efectivo TPV,16000,0,"81315474,01"
01/31/2024,22363,,11012,Terminal LS - Efectivo TPV,"111444,01",0,"81426918,02"
02/01/2024,22367,,,Terminal LS - Efectivo TPV,0,541850,"80885068,02"
02/01/2024,22578,,11039,Terminal LS - Efectivo TPV,73313,0,"80958381,02"
02/01/2024,22367,,,Terminal LS - Efectivo TPV,541850,0,"81500231,02"
02/01/2024,22375,,,Terminal LS - Tarjeta TPV,810464,0,"82310695,02"
02/01/2024,22583,,11070,Terminal LS - Efectivo TPV,45280,0,"82355975,02"
02/01/2024,22580,,11044,Terminal LS - Efectivo TPV,238404,0,"82594379,02"
02/01/2024,22582,,11069,Terminal LS - Efectivo TPV,9800,0,"82604179,02"
02/01/2024,22581,,11067,Terminal LS - Efectivo TPV,"154382,99",0,"82758562,01"
02/01/2024,22386,,,Terminal LS - Transferencia TPV,2383664,0,"85142226,01"
02/01/2024,22577,,11032,Terminal LS - Efectivo TPV,66500,0,"85208726,01"
02/01/2024,22579,,11041,Terminal LS - Efectivo TPV,71565,0,"85280291,01"
02/02/2024,23002,,11107,Terminal LS - Efectivo TPV,"79212,99",0,85359504
02/02/2024,22588,,,Terminal LS - Tarjeta TPV,811127,0,86170631
02/02/2024,23008,,11147,Terminal LS - Efectivo TPV,63370,0,86234001
02/02/2024,23003,,11108,Terminal LS - Efectivo TPV,83146,0,82317147
02/02/2024,22610,,,Terminal LS - Transferencia TPV,1727260,0,84044407
02/02/2024,22999,,11091,Terminal LS - Efectivo TPV,114000,0,84143407
02/02/2024,22995,,11081,Terminal LS - Efectivo TPV,91500,0,84234907
02/02/2024,22998,,11090,Terminal LS - Efectivo TPV,"125800,01",0,"84360707,01"
02/02/2024,23004,,11130,Terminal LS - Efectivo TPV,7600,0,"84368307,01"
02/02/2024,22584,,,Terminal LS - Efectivo TPV,0,659250,"83709057,01"
02/02/2024,23005,,11133,Terminal LS - Efectivo TPV,81000,0,"83790057,01"
02/02/2024,22996,,11082,Terminal LS - Efectivo TPV,"94836,99",0,83884894
02/02/2024,23007,,11145,Terminal LS - Efectivo TPV,99426,0,83984320
02/02/2024,23006,,11143,Terminal LS - Efectivo TPV,"84675,99",0,"88068995,99"
02/02/2024,22584,,,Terminal LS - Efectivo TPV,659250,0,"88728245,99"
02/02/2024,22997,,11085,Terminal LS - Efectivo TPV,129500,0,"88857745,99"
02/02/2024,23000,,11104,Terminal LS - Efectivo TPV,64000,0,"88921745,99"
02/02/2024,23001,,11105,Terminal LS - Efectivo TPV,251078,0,"89172823,99"
02/03/2024,23743,,11268,Terminal LS - Efectivo TPV,"264516,98",0,"89437340,97"
02/03/2024,23024,,,Terminal LS - Tarjeta TPV,2442053,0,"91879393,97"
02/03/2024,23009,,,Terminal LS - Efectivo TPV,1369200,0,"93248593,97"
02/03/2024,23731,,11191,Terminal LS - Efectivo TPV,"73899,99",0,"93322493,96"
02/03/2024,23739,,11246,Terminal LS - Efectivo TPV,"341435,01",0,"93663928,97"
02/03/2024,23737,,11240,Terminal LS - Efectivo TPV,7600,0,"93671528,97"
02/03/2024,23733,,11208,Terminal LS - Efectivo TPV,"249977,96",0,"93921506,93"
02/03/2024,23049,,,Terminal LS - Transferencia TPV,2537884,0,"96459390,93"
02/03/2024,23009,,,Terminal LS - Efectivo TPV,0,1369200,"95090190,93"
02/03/2024,23729,,11186,Terminal LS - Efectivo TPV,22000,0,"95112190,93"
02/03/2024,23728,,11183,Terminal LS - Efectivo TPV,"150599,99",0,"95262790,92"
02/03/2024,23741,,11261,Terminal LS - Efectivo TPV,"99753,99",0,"95182394,91"
02/03/2024,23730,,11187,Terminal LS - Efectivo TPV,63000,0,"95245394,91"
02/03/2024,23732,,11202,Terminal LS - Efectivo TPV,118000,0,"95363394,91"
02/03/2024,23725,,11155,Terminal LS - Efectivo TPV,"227477,98",0,"95590872,89"
02/03/2024,23736,,11234,Terminal LS - Efectivo TPV,174269,0,"95765141,89"
02/03/2024,23738,,11244,Terminal LS - Efectivo TPV,105435,0,"95870576,89"
02/03/2024,23740,,11255,Terminal LS - Efectivo TPV,81398,0,"95951974,89"
02/03/2024,23742,,11262,Terminal LS - Efectivo TPV,70035,0,"96022009,89"
02/03/2024,23727,,11179,Terminal LS - Efectivo TPV,89593,0,"96111602,89"
02/03/2024,23734,,11215,Terminal LS - Efectivo TPV,"147718,99",0,"96259321,88"
02/03/2024,23735,,11229,Terminal LS - Efectivo TPV,"154656,2",0,"96413978,08"
02/03/2024,23726,,11169,Terminal LS - Efectivo TPV,142700,0,"96556678,08"
02/04/2024,24255,,11301,Terminal SE - Transferencia TPV,"54059,99",0,"96610738,07"
02/04/2024,24323,,11300,Terminal LS - Efectivo TPV,10000,0,"96613738,07"
02/04/2024,24328,,11332,Terminal LS - Efectivo TPV,"56814,99",0,"96670553,06"
02/04/2024,24329,,11342,Terminal LS - Efectivo TPV,"84675,99",0,"96755229,05"
02/04/2024,24324,,11306,Terminal LS - Efectivo TPV,61000,0,"96816229,05"
02/04/2024,23744,,,Terminal LS - Efectivo TPV,0,2584100,"94232129,05"
02/04/2024,24251,,11284,Terminal SE - Transferencia TPV,74609,0,"94306738,05"
02/04/2024,24253,,11298,Terminal SE - Transferencia TPV,"391818,99",0,"94698557,04"
02/04/2024,24327,,11320,Terminal LS - Efectivo TPV,118500,0,"94817057,04"
02/04/2024,24326,,11316,Terminal LS - Efectivo TPV,"127068,99",0,"94944126,03"
02/04/2024,24256,,11302,Terminal SE - Transferencia TPV,"75000,01",0,"95019126,04"
02/04/2024,24254,,11299,Terminal SE - Transferencia TPV,"143675,99",0,"95162802,03"
02/04/2024,23744,,,Terminal LS - Efectivo TPV,2584100,0,"97744211,44"
02/04/2024,23763,,,Terminal LS - Tarjeta TPV,2325207,0,"100069418,44"
02/04/2024,23785,,,Terminal LS - Transferencia TPV,2795534,0,"102864952,44"
02/04/2024,24250,,11283,Terminal SE - Transferencia TPV,10160,0,"102875112,44"
02/04/2024,24330,,11354,Terminal LS - Efectivo TPV,4000,0,"102879112,44"
02/04/2024,24252,,11297,Terminal SE - Transferencia TPV,74406,0,"102953518,44"
02/04/2024,24331,,11355,Terminal LS - Efectivo TPV,"192077,99",0,"103145596,43"
02/04/2024,24325,,11306,Terminal LS - Efectivo TPV,"61370,01",0,"103206966,44"
02/05/2024,24310,,,Terminal LS - Transferencia TPV,2667473,0,"105874439,44"
02/05/2024,24322,,,Terminal LS - Tarjeta TPV,1444773,0,"107300212,44"
02/05/2024,24332,,,Terminal LS - Efectivo TPV,715400,0,"108015612,44"
02/05/2024,24332,,,Terminal LS - Efectivo TPV,0,715400,"107300212,44"
02/08/2024,24396,,11358,Terminal SE - Efectivo TPV,88000,0,"107331982,45"
02/13/2024,25340,,11511,Terminal LS - Efectivo TPV,"136901,99",0,"106238134,77"
02/13/2024,25342,,11514,Terminal LS - Efectivo TPV,65000,0,"106303134,77"
02/13/2024,25341,,11512,Terminal LS - Efectivo TPV,90248,0,"106139154,36"
02/13/2024,25337,,11507,Terminal LS - Efectivo TPV,24300,0,"106095704,39"
02/13/2024,25338,,11508,Terminal LS - Efectivo TPV,52500,0,"106148204,39"
02/13/2024,25339,,11510,Terminal LS - Efectivo TPV,60500,0,"106208704,39"
02/14/2024,25343,,,Terminal LS - Efectivo TPV,0,429500,"105779204,39"
02/14/2024,25343,,,Terminal LS - Efectivo TPV,429500,0,"106208704,39"
02/14/2024,25336,,,Terminal LS - Transferencia TPV,1896753,0,"108105457,39"
02/14/2024,25473,,11530,Terminal LS - Efectivo TPV,227500,0,"108332957,39"
02/14/2024,25470,,11524,Terminal LS - Efectivo TPV,64500,0,"108397457,39"
02/14/2024,25471,,11525,Terminal LS - Efectivo TPV,112000,0,"108509457,39"
02/14/2024,25472,,11529,Terminal LS - Efectivo TPV,102922,0,"108612379,39"
02/14/2024,25474,,11531,Terminal LS - Efectivo TPV,113000,0,"108725379,39"
02/14/2024,25475,,11544,Terminal LS - Efectivo TPV,"191942,99",0,"108917322,38"
02/14/2024,25476,,11546,Terminal LS - Efectivo TPV,198056,0,"109115378,38"
02/14/2024,25477,,11550,Terminal LS - Efectivo TPV,"127505,99",0,"109242884,37"
02/14/2024,25478,,11551,Terminal LS - Efectivo TPV,177109,0,"109419993,37"
02/15/2024,25479,,,Terminal LS - Efectivo TPV,0,1314550,"108074943,37"
02/15/2024,25660,,11564,Terminal LS - Efectivo TPV,"128926,01",0,"93203869,38"
02/15/2024,25661,,11568,Terminal LS - Efectivo TPV,5800,0,"93209669,38"
02/15/2024,25662,,11571,Terminal LS - Efectivo TPV,61000,0,"93270669,38"
02/15/2024,25663,,11572,Terminal LS - Efectivo TPV,5800,0,"93276469,38"
02/15/2024,25664,,11576,Terminal LS - Efectivo TPV,114176,0,"93390645,38"
02/15/2024,25659,,11563,Terminal LS - Efectivo TPV,101000,0,"93491645,38"
02/15/2024,25658,,11562,Terminal LS - Efectivo TPV,93963,0,"93585608,38"
02/15/2024,25657,,11561,Terminal LS - Efectivo TPV,55500,0,"93641108,38"
02/15/2024,25656,,11556,Terminal LS - Efectivo TPV,4000,0,"93645108,38"
02/15/2024,25502,,,Terminal LS - Transferencia TPV,1007239,0,"94652347,38"
02/15/2024,25491,,,Terminal LS - Tarjeta TPV,869487,0,"95521834,38"
02/15/2024,25479,,,Terminal LS - Efectivo TPV,1314550,0,"96836384,38"
02/15/2024,25667,,11589,Terminal LS - Efectivo TPV,86861,0,"96923245,38"
02/15/2024,25666,,11588,Terminal LS - Efectivo TPV,"5000,99",0,"96928246,37"
02/15/2024,25665,,11578,Terminal LS - Efectivo TPV,45000,0,"96973246,37"
02/16/2024,26070,,11632,Terminal LS - Efectivo TPV,"89668,99",0,"96806464,68"
02/16/2024,26081,,11661,Terminal LS - Efectivo TPV,66648,0,"96873112,68"
02/16/2024,26082,,11666,Terminal LS - Efectivo TPV,90139,0,"96963251,68"
02/16/2024,26075,,11647,Terminal LS - Efectivo TPV,"28296,01",0,"96991547,69"
02/16/2024,25687,,,Terminal LS - Transferencia TPV,998786,0,"96249716,69"
02/16/2024,26065,,11608,Terminal LS - Efectivo TPV,"111116,99",0,"94279437,68"
02/16/2024,26085,,11673,Terminal LS - Efectivo TPV,"99425,99",0,"94378863,67"
02/16/2024,25679,,,Terminal LS - Tarjeta TPV,1169933,0,"94644609,67"
02/16/2024,26066,,11613,Terminal LS - Efectivo TPV,63000,0,"91892513,67"
02/16/2024,26074,,11646,Terminal LS - Efectivo TPV,"108931,01",0,"92001444,68"
02/16/2024,26083,,11667,Terminal LS - Efectivo TPV,75498,0,"92076942,68"
02/16/2024,25668,,,Terminal LS - Efectivo TPV,707000,0,"92079396,68"
02/16/2024,25668,,,Terminal LS - Efectivo TPV,0,707000,"91372396,68"
02/16/2024,26077,,11652,Terminal LS - Efectivo TPV,78994,0,"91451390,68"
02/16/2024,26084,,11668,Terminal LS - Efectivo TPV,182681,0,"91634071,68"
02/16/2024,26064,,11602,Terminal LS - Efectivo TPV,47000,0,"91681071,68"
02/16/2024,26076,,11651,Terminal LS - Efectivo TPV,"97786,99",0,"91778858,67"
02/16/2024,26080,,11660,Terminal LS - Efectivo TPV,74624,0,"91853482,67"
02/16/2024,26068,,11617,Terminal LS - Efectivo TPV,"44249,99",0,"91897732,66"
02/16/2024,26069,,11624,Terminal LS - Efectivo TPV,"104342,99",0,"91926175,65"
02/16/2024,26078,,11654,Terminal LS - Efectivo TPV,68800,0,"91994975,65"
02/16/2024,26071,,11638,Terminal LS - Efectivo TPV,93514,0,"92088489,65"
02/16/2024,26079,,11655,Terminal LS - Efectivo TPV,"152099,99",0,"92240589,64"
02/16/2024,26067,,11615,Terminal LS - Efectivo TPV,"84129,99",0,"92324719,63"
02/16/2024,26072,,11639,Terminal LS - Efectivo TPV,"84129,99",0,"92408849,62"
02/16/2024,26063,,11594,Terminal LS - Efectivo TPV,59000,0,"92467849,62"
02/16/2024,26073,,11640,Terminal LS - Efectivo TPV,79759,0,"92547608,62"
02/17/2024,26839,,11806,Terminal LS - Efectivo TPV,4000,0,"92551608,62"
02/17/2024,26824,,11740,Terminal LS - Efectivo TPV,"80086,99",0,"92631695,61"
02/17/2024,26833,,11790,Terminal LS - Efectivo TPV,20400,0,"92592095,61"
02/17/2024,26086,,,Terminal LS - Efectivo TPV,1983900,0,"94380816,28"
02/17/2024,26102,,,Terminal LS - Tarjeta TPV,1955409,0,"96336225,28"
02/17/2024,26086,,,Terminal LS - Efectivo TPV,0,1983900,"94352325,28"
02/17/2024,26837,,11795,Terminal LS - Efectivo TPV,"90247,99",0,"94442573,27"
02/17/2024,26820,,11697,Terminal LS - Efectivo TPV,97787,0,"94540360,27"
02/17/2024,26827,,11759,Terminal LS - Efectivo TPV,"89373,99",0,"94629734,26"
02/17/2024,26831,,11778,Terminal LS - Efectivo TPV,84130,0,"94713864,26"
02/17/2024,26830,,11769,Terminal LS - Efectivo TPV,"137000,01",0,"94850864,27"
02/17/2024,26817,,11677,Terminal LS - Efectivo TPV,"274240,98",0,"95125105,25"
02/17/2024,26818,,11690,Terminal LS - Efectivo TPV,47000,0,"95172105,25"
02/17/2024,26825,,11750,Terminal LS - Efectivo TPV,59328,0,"95231433,25"
02/17/2024,26823,,11729,Terminal LS - Efectivo TPV,"9999,99",0,"95241433,24"
02/17/2024,26838,,11803,Terminal LS - Efectivo TPV,"219946,01",0,"95461379,25"
02/17/2024,26121,,,Terminal LS - Transferencia TPV,2067650,0,"97529029,25"
02/17/2024,26826,,11753,Terminal LS - Efectivo TPV,12700,0,"97541729,25"
02/17/2024,26835,,11793,Terminal LS - Efectivo TPV,93744,0,"97635473,25"
02/17/2024,26822,,11719,Terminal LS - Efectivo TPV,"92105,99",0,"97727579,24"
02/17/2024,26836,,11794,Terminal LS - Efectivo TPV,"169745,99",0,"97897325,23"
02/17/2024,26821,,11711,Terminal LS - Efectivo TPV,80633,0,"97977958,23"
02/17/2024,26832,,11780,Terminal LS - Efectivo TPV,81835,0,"98059793,23"
02/17/2024,26834,,11791,Terminal LS - Efectivo TPV,124228,0,"98184021,23"
02/17/2024,26829,,11766,Terminal LS - Efectivo TPV,154056,0,"98338077,23"
02/17/2024,26828,,11763,Terminal LS - Efectivo TPV,"88000,99",0,"98426078,22"
02/17/2024,26816,,11676,Terminal LS - Efectivo TPV,"112499,99",0,"98538578,21"
02/17/2024,26819,,11691,Terminal LS - Efectivo TPV,81944,0,"98620522,21"
02/18/2024,26840,,,Terminal LS - Efectivo TPV,2305100,0,"100925622,21"
02/18/2024,27314,,11889,Terminal LS - Efectivo TPV,"80305,99",0,"101005928,2"
02/18/2024,27312,,11882,Terminal LS - Efectivo TPV,61000,0,"101066928,2"
02/18/2024,26864,,,Terminal LS - Tarjeta TPV,2724771,0,"103784274,18"
02/18/2024,27309,,11807,Terminal LS - Efectivo TPV,49000,0,"103833274,18"
02/18/2024,26893,,,Terminal LS - Transferencia TPV,3388915,0,"107222189,18"
02/18/2024,27313,,11888,Terminal LS - Efectivo TPV,96148,0,"107318337,18"
02/18/2024,27315,,11901,Terminal LS - Efectivo TPV,"155256,99",0,"107473594,17"
02/18/2024,27311,,11850,Terminal LS - Efectivo TPV,"103249,99",0,"107576844,16"
02/18/2024,27310,,11814,Terminal LS - Efectivo TPV,66600,0,"107643444,16"
02/18/2024,26840,,,Terminal LS - Efectivo TPV,0,2305100,"105338344,16"
02/19/2024,27336,,,Terminal LS - Tarjeta TPV,1817862,0,"107135706,16"
02/19/2024,27353,,,Terminal LS - Transferencia TPV,1486154,0,"108621860,16"
02/19/2024,27316,,,Terminal LS - Efectivo TPV,0,611600,"108010260,16"
02/19/2024,27316,,,Terminal LS - Efectivo TPV,611600,0,"108621860,16"
02/20/2024,27513,,11914,Terminal LS - Efectivo TPV,86315,0,"108708175,16"
02/20/2024,27515,,11923,Terminal LS - Efectivo TPV,230360,0,"108938535,16"
02/20/2024,27516,,11926,Terminal LS - Efectivo TPV,161000,0,"109099535,16"
02/20/2024,27517,,11928,Terminal LS - Efectivo TPV,101611,0,"109201146,16"
02/20/2024,27512,,11913,Terminal LS - Efectivo TPV,52000,0,"109235146,16"
02/20/2024,27514,,11918,Terminal LS - Efectivo TPV,"193607,01",0,"109428753,17"
02/21/2024,27607,,11937,Terminal LS - Efectivo TPV,77246,0,"109490999,17"
02/21/2024,27610,,11945,Terminal LS - Efectivo TPV,76000,0,"109566999,17"
02/21/2024,27606,,11936,Terminal LS - Efectivo TPV,29281,0,"109596280,17"
02/21/2024,27518,,,Terminal LS - Efectivo TPV,824900,0,"110421180,17"
02/21/2024,27609,,11943,Terminal LS - Efectivo TPV,70000,0,"110491180,17"
02/21/2024,27535,,,Terminal LS - Transferencia TPV,906167,0,"111397347,17"
02/21/2024,27612,,11947,Terminal LS - Efectivo TPV,58000,0,"111455347,17"
02/21/2024,27518,,,Terminal LS - Efectivo TPV,0,824900,"110630447,17"
02/21/2024,27525,,,Terminal LS - Tarjeta TPV,840639,0,"111471086,17"
02/21/2024,27611,,11946,Terminal LS - Efectivo TPV,18705,0,"111489791,17"
02/21/2024,27608,,11939,Terminal LS - Efectivo TPV,57500,0,"111547291,17"
02/21/2024,27604,,11931,Terminal LS - Efectivo TPV,"107000,01",0,"111654291,18"
02/21/2024,27605,,11933,Terminal LS - Efectivo TPV,76044,0,"111730335,18"
02/22/2024,27792,,11957,Terminal LS - Efectivo TPV,58000,0,"111555835,61"
02/22/2024,27791,,11953,Terminal LS - Efectivo TPV,"7999,99",0,"111563835,6"
02/22/2024,27793,,11964,Terminal LS - Efectivo TPV,96750,0,"111660585,6"
02/22/2024,27797,,11977,Terminal LS - Efectivo TPV,85659,0,"111746244,6"
02/22/2024,27777,,11961,Terminal SE - Transferencia TPV,92433,0,"111838677,6"
02/22/2024,27778,,11965,Terminal SE - Transferencia TPV,"75700,01",0,"111914377,61"
02/22/2024,27779,,11966,Terminal SE - Transferencia TPV,"96584,99",0,"112010962,6"
02/22/2024,27800,,11984,Terminal LS - Efectivo TPV,190985,0,"112201947,6"
02/22/2024,27774,,11956,Terminal SE - Efectivo TPV,70000,0,"112256947,6"
02/22/2024,27773,,11955,Terminal SE - Efectivo TPV,75607,0,"112332554,6"
02/22/2024,27776,,11960,Terminal SE - Transferencia TPV,70035,0,"112402589,6"
02/22/2024,27801,,11985,Terminal LS - Efectivo TPV,25000,0,"112427589,6"
02/22/2024,27794,,11971,Terminal LS - Efectivo TPV,57000,0,"112484589,6"
02/22/2024,27798,,11979,Terminal LS - Efectivo TPV,26222,0,"112510811,6"
02/22/2024,27795,,11972,Terminal LS - Efectivo TPV,94500,0,"112605311,6"
02/22/2024,27796,,11973,Terminal LS - Efectivo TPV,98880,0,"112701291,6"
02/22/2024,27628,,,Terminal LS - Transferencia TPV,503739,0,"113205030,6"
02/22/2024,27621,,,Terminal LS - Tarjeta TPV,932425,0,"114091030,6"
02/22/2024,27613,,,Terminal LS - Efectivo TPV,570000,0,"114661030,6"
02/22/2024,27613,,,Terminal LS - Efectivo TPV,0,570000,"114091030,6"
02/23/2024,28180,,12022,Terminal LS - Efectivo TPV,"78120,01",0,"114169150,61"
02/23/2024,27775,,,Terminal SE - Efectivo TPV,145600,0,"114314750,61"
02/23/2024,28197,,12035,Terminal LS - Tarjeta TPV,"426177,01",0,"114740927,62"
02/23/2024,28189,,12061,Terminal LS - Efectivo TPV,"77246,01",0,"114818173,63"
02/23/2024,28179,,12018,Terminal LS - Efectivo TPV,"39333,01",0,"114857506,64"
02/23/2024,28184,,12042,Terminal LS - Efectivo TPV,93854,0,"114951360,64"
02/23/2024,27816,,,Terminal LS - Tarjeta TPV,1002757,0,"115954117,64"
02/23/2024,28186,,12055,Terminal LS - Efectivo TPV,90139,0,"116044256,64"
02/23/2024,28201,,12045,Terminal LS - Tarjeta TPV,"121277,98",0,"116165534,62"
02/23/2024,28178,,12017,Terminal LS - Efectivo TPV,90685,0,"116256219,62"
02/23/2024,28192,,12008,Terminal LS - Tarjeta TPV,"97786,99",0,"116354006,61"
02/23/2024,28200,,12040,Terminal LS - Tarjeta TPV,"105216,99",0,"116459223,6"
02/23/2024,28175,,12006,Terminal LS - Efectivo TPV,120000,0,"116579223,6"
02/23/2024,28196,,12033,Terminal LS - Tarjeta TPV,97787,0,"116677010,6"
02/23/2024,27775,,,Terminal SE - Efectivo TPV,0,145600,"116531410,6"
02/23/2024,28188,,12060,Terminal LS - Efectivo TPV,84894,0,"116616304,6"
02/23/2024,28181,,12026,Terminal LS - Efectivo TPV,105000,0,"116721304,6"
02/23/2024,28182,,12034,Terminal LS - Efectivo TPV,78700,0,"116800004,6"
02/23/2024,27826,,,Terminal LS - Transferencia TPV,800476,0,"117600480,6"
02/23/2024,28194,,12030,Terminal LS - Tarjeta TPV,"335425,99",0,"117935906,59"
02/23/2024,28198,,12038,Terminal LS - Tarjeta TPV,287789,0,"118223695,59"
02/23/2024,27802,,,Terminal LS - Efectivo TPV,809700,0,"119033395,59"
02/23/2024,27802,,,Terminal LS - Efectivo TPV,0,809700,"118223695,59"
02/23/2024,28199,,12039,Terminal LS - Tarjeta TPV,"203746,5",0,"118427442,09"
02/23/2024,28193,,12025,Terminal LS - Tarjeta TPV,167768,0,"118595210,09"
02/23/2024,28195,,12031,Terminal LS - Tarjeta TPV,145643,0,"118740853,09"
02/23/2024,28187,,12058,Terminal LS - Efectivo TPV,"188472,01",0,"118929325,1"
02/23/2024,28183,,12041,Terminal LS - Efectivo TPV,"168696,01",0,"119098021,11"
02/23/2024,28185,,12044,Terminal LS - Efectivo TPV,139633,0,"119237654,11"
02/23/2024,28177,,12016,Terminal LS - Efectivo TPV,99972,0,"119337626,11"
02/23/2024,28174,,12000,Terminal LS - Efectivo TPV,4000,0,"119341626,11"
02/23/2024,28176,,12010,Terminal LS - Efectivo TPV,129500,0,"119471126,11"
02/23/2024,28191,,11994,Terminal LS - Tarjeta TPV,94509,0,"119565635,11"
02/24/2024,28209,,,Terminal LS - Tarjeta TPV,3608021,0,"123173656,11"
02/24/2024,28890,,12158,Terminal LS - Efectivo TPV,20435,0,"123194091,11"
02/24/2024,28190,,,Terminal LS - Efectivo TPV,1589200,0,"124727611,11"
02/24/2024,28190,,,Terminal LS - Efectivo TPV,0,1589200,"123138411,11"
02/24/2024,28896,,12179,Terminal LS - Efectivo TPV,208904,0,"123347315,11"
02/24/2024,28884,,12130,Terminal LS - Efectivo TPV,76700,0,"123424015,11"
02/24/2024,28881,,12110,Terminal LS - Efectivo TPV,"80305,99",0,"123504321,1"
02/24/2024,28889,,12153,Terminal LS - Efectivo TPV,15800,0,"123520121,1"
02/24/2024,28883,,12120,Terminal LS - Efectivo TPV,"108931,01",0,"123629052,11"
02/24/2024,28886,,12140,Terminal LS - Efectivo TPV,82491,0,"123711543,11"
02/24/2024,28879,,12101,Terminal LS - Efectivo TPV,37148,0,"123748691,11"
02/24/2024,28892,,12160,Terminal LS - Efectivo TPV,54000,0,"123802691,11"
02/24/2024,28898,,12186,Terminal LS - Efectivo TPV,70000,0,"123872691,11"
02/24/2024,28885,,12139,Terminal LS - Efectivo TPV,105981,0,"123978672,11"
02/24/2024,28891,,12159,Terminal LS - Efectivo TPV,"110351,99",0,"124089024,1"
02/24/2024,28875,,12080,Terminal LS - Efectivo TPV,"91996,01",0,"124181020,11"
02/24/2024,28882,,12112,Terminal LS - Efectivo TPV,"51844,01",0,"124232864,12"
02/24/2024,28877,,12099,Terminal LS - Efectivo TPV,155500,0,"124388364,12"
02/24/2024,28880,,12103,Terminal LS - Efectivo TPV,61000,0,"124449364,12"
02/24/2024,28894,,12173,Terminal LS - Efectivo TPV,45000,0,"124494364,12"
02/24/2024,28893,,12172,Terminal LS - Efectivo TPV,122589,0,"124616953,12"
02/24/2024,28876,,12087,Terminal LS - Efectivo TPV,67522,0,"124684475,12"
02/24/2024,28897,,12183,Terminal LS - Efectivo TPV,"78666,99",0,"124763142,11"
02/24/2024,28895,,12177,Terminal LS - Efectivo TPV,123463,0,"124886605,11"
02/24/2024,28899,,12187,Terminal LS - Efectivo TPV,"247691,01",0,"125134296,12"
02/24/2024,28888,,12145,Terminal LS - Efectivo TPV,155694,0,"125289990,12"
02/24/2024,28878,,12100,Terminal LS - Efectivo TPV,113302,0,"125403292,12"
02/24/2024,28230,,,Terminal LS - Transferencia TPV,2269566,0,"127672858,12"
02/24/2024,28887,,12143,Terminal LS - Efectivo TPV,59000,0,"127731858,12"
02/25/2024,28947,,,Terminal LS - Transferencia TPV,3438201,0,"131170059,12"
02/25/2024,28900,,,Terminal LS - Efectivo TPV,0,2344400,"128825659,12"
02/25/2024,29398,,12190,Terminal LS - Efectivo TPV,56000,0,"128881659,12"
02/25/2024,29404,,12239,Terminal LS - Efectivo TPV,91013,0,"128972672,12"
02/25/2024,29405,,12250,Terminal LS - Efectivo TPV,"175999,99",0,"129148672,11"
02/25/2024,29406,,12264,Terminal LS - Efectivo TPV,"202457,01",0,"129351129,12"
02/25/2024,29407,,12275,Terminal LS - Efectivo TPV,"103999,99",0,"129455129,11"
02/25/2024,29403,,12235,Terminal LS - Efectivo TPV,166511,0,"129621640,11"
02/25/2024,29401,,12229,Terminal LS - Efectivo TPV,"128600,01",0,"129750240,12"
02/25/2024,28900,,,Terminal LS - Efectivo TPV,2344400,0,"132094640,12"
02/25/2024,29399,,12195,Terminal LS - Efectivo TPV,5000,0,"132099640,12"
02/25/2024,29402,,12234,Terminal LS - Efectivo TPV,50006,0,"132149646,12"
02/25/2024,28919,,,Terminal LS - Tarjeta TPV,2868129,0,"135017775,12"
02/25/2024,29400,,12228,Terminal LS - Efectivo TPV,61000,0,"135078775,12"
02/26/2024,29408,,,Terminal LS - Efectivo TPV,1040700,0,"136119475,12"
02/26/2024,29408,,,Terminal LS - Efectivo TPV,0,1040700,"135078775,12"
02/26/2024,29417,,,Terminal LS - Tarjeta TPV,773553,0,"135852328,12"
02/26/2024,29435,,,Terminal LS - Transferencia TPV,1954039,0,"137806367,12"
02/27/2024,29573,,12282,Terminal LS - Efectivo TPV,85222,0,"137891589,12"
02/27/2024,29577,,12290,Terminal LS - Efectivo TPV,90000,0,"137956588,29"
02/27/2024,29576,,12287,Terminal LS - Efectivo TPV,"96694,01",0,"138053282,3"
02/27/2024,29575,,12284,Terminal LS - Efectivo TPV,18050,0,"138071332,3"
02/27/2024,29574,,12283,Terminal LS - Efectivo TPV,54000,0,"138125332,3"
02/28/2024,29714,,12303,Terminal LS - Efectivo TPV,"292377,98",0,"138373710,28"
02/28/2024,29716,,12322,Terminal LS - Efectivo TPV,103733,0,"138477443,28"
02/29/2024,29717,,,Terminal LS - Efectivo TPV,466300,0,"138717243,77"
02/29/2024,29960,,12351,Terminal LS - Efectivo TPV,15400,0,"138732643,77"
02/29/2024,29959,,12343,Terminal LS - Efectivo TPV,53500,0,"138786143,77"
02/29/2024,29958,,12341,Terminal LS - Efectivo TPV,"230534,98",0,"139016678,75"
02/29/2024,29957,,12340,Terminal LS - Efectivo TPV,"167166,98",0,"139183845,73"
02/29/2024,29740,,,Terminal LS - Transferencia TPV,1624880,0,"140808725,73"
02/29/2024,29717,,,Terminal LS - Efectivo TPV,0,466300,"140342425,73"
02/29/2024,29725,,,Terminal LS - Tarjeta TPV,1237935,0,"141580360,73"
02/29/2024,29961,,12357,Terminal LS - Efectivo TPV,"76590,99",0,"141656951,72"
02/29/2024,29962,,12361,Terminal LS - Efectivo TPV,"102922,01",0,"141759873,73"
02/29/2024,29963,,12367,Terminal LS - Efectivo TPV,228048,0,"141987921,73"
03/01/2024,30385,,12376,Terminal LS - Efectivo TPV,"157879,98",0,"142145801,71"
03/01/2024,29993,,,Terminal LS - Transferencia TPV,1530279,0,"143676080,71"
03/01/2024,29984,,,Terminal LS - Tarjeta TPV,2269861,0,"145945941,71"
03/01/2024,30384,,12372,Terminal LS - Efectivo TPV,"35946,01",0,"145926207,72"
03/01/2024,30391,,12437,Terminal LS - Efectivo TPV,"170225,99",0,"146096433,71"
03/01/2024,30392,,12440,Terminal LS - Efectivo TPV,84000,0,"146180433,71"
03/01/2024,30387,,12410,Terminal LS - Efectivo TPV,172000,0,"146352433,71"
03/01/2024,30389,,12418,Terminal LS - Efectivo TPV,"82708,99",0,"146435142,7"
03/01/2024,30386,,12399,Terminal LS - Efectivo TPV,64463,0,"146499605,7"
03/01/2024,30390,,12428,Terminal LS - Efectivo TPV,"591419,98",0,"147091025,68"
03/01/2024,30388,,12413,Terminal LS - Efectivo TPV,"54999,99",0,"147146025,67"
03/01/2024,29964,,,Terminal LS - Efectivo TPV,0,874200,"146271825,67"
03/01/2024,29964,,,Terminal LS - Efectivo TPV,874200,0,"147146025,67"
03/01/2024,30393,,12442,Terminal LS - Efectivo TPV,173176,0,"147319201,67"
03/02/2024,31053,,12562,Terminal LS - Efectivo TPV,"87999,99",0,"147407201,66"
03/02/2024,31047,,12519,Terminal LS - Efectivo TPV,"379675,98",0,"147786877,64"
03/02/2024,31049,,12536,Terminal LS - Efectivo TPV,9000,0,"147795877,64"
03/02/2024,31048,,12523,Terminal LS - Efectivo TPV,86861,0,"147882738,64"
03/02/2024,31045,,12513,Terminal LS - Efectivo TPV,7600,0,"147890338,64"
03/02/2024,31037,,12454,Terminal LS - Efectivo TPV,161922,0,"148052260,64"
03/02/2024,31051,,12544,Terminal LS - Efectivo TPV,82491,0,"148134751,64"
03/02/2024,31040,,12496,Terminal LS - Efectivo TPV,135481,0,"148270232,64"
03/02/2024,30442,,,Terminal LS - Transferencia TPV,2895673,0,"151165905,64"
03/02/2024,30394,,,Terminal LS - Efectivo TPV,0,1586500,"149579405,64"
03/02/2024,30409,,,Terminal LS - Tarjeta TPV,1972961,0,"151552366,64"
03/02/2024,30394,,,Terminal LS - Efectivo TPV,1586500,0,"153138866,64"
03/02/2024,31046,,12518,Terminal LS - Efectivo TPV,86315,0,"153225181,64"
03/02/2024,31054,,12563,Terminal LS - Efectivo TPV,"107484,99",0,"153332666,63"
03/02/2024,31041,,12499,Terminal LS - Efectivo TPV,91231,0,"153387897,63"
03/02/2024,31043,,12501,Terminal LS - Efectivo TPV,"74405,99",0,"153462303,62"
03/02/2024,31050,,12540,Terminal LS - Efectivo TPV,147609,0,"153609912,62"
03/02/2024,31044,,12504,Terminal LS - Efectivo TPV,139524,0,"153749436,62"
03/02/2024,31039,,12489,Terminal LS - Efectivo TPV,77600,0,"153827036,62"
03/02/2024,31042,,12500,Terminal LS - Efectivo TPV,135044,0,"153962080,62"
03/02/2024,31052,,12551,Terminal LS - Efectivo TPV,105000,0,"154067080,62"
03/02/2024,31038,,12474,Terminal LS - Efectivo TPV,61500,0,"154128580,62"
03/02/2024,31036,,12452,Terminal LS - Efectivo TPV,72985,0,"154201565,62"
03/03/2024,31091,,,Terminal LS - Transferencia TPV,2410319,0,"156611884,62"
03/03/2024,31055,,,Terminal LS - Efectivo TPV,0,2049750,"154562134,62"
03/03/2024,31055,,,Terminal LS - Efectivo TPV,2049750,0,"156611884,62"
03/03/2024,31477,,12623,Terminal LS - Efectivo TPV,"110849,99",0,"156722734,61"
03/03/2024,31476,,12621,Terminal LS - Efectivo TPV,94509,0,"156817243,61"
03/03/2024,31475,,12613,Terminal LS - Efectivo TPV,57000,0,"156874243,61"
03/03/2024,31474,,12595,Terminal LS - Efectivo TPV,10400,0,"156884643,61"
03/03/2024,31473,,12581,Terminal LS - Efectivo TPV,"75443,99",0,"156960087,6"
03/03/2024,31471,,12571,Terminal LS - Efectivo TPV,5400,0,"156965487,6"
03/03/2024,31472,,12574,Terminal LS - Efectivo TPV,"100000,99",0,"157050488,59"
03/03/2024,31479,,12641,Terminal LS - Efectivo TPV,64000,0,"157114488,59"
03/03/2024,31064,,,Terminal LS - Tarjeta TPV,897129,0,"158011617,59"
03/03/2024,31478,,12640,Terminal LS - Efectivo TPV,62500,0,"158074117,59"
03/04/2024,31486,,,Terminal LS - Tarjeta TPV,501977,0,"158576094,59"
03/04/2024,31480,,,Terminal LS - Efectivo TPV,580150,0,"159156244,59"
03/04/2024,31500,,,Terminal LS - Transferencia TPV,1148504,0,"160304748,59"
03/04/2024,31480,,,Terminal LS - Efectivo TPV,0,580150,"159724598,59"
03/05/2024,31628,,12652,Terminal LS - Efectivo TPV,63000,0,"159787598,59"
03/05/2024,31626,,12646,Terminal LS - Efectivo TPV,45050,0,"159812098,59"
03/05/2024,31627,,12651,Terminal LS - Efectivo TPV,64244,0,"159876342,59"
03/06/2024,31646,,,Terminal LS - Transferencia TPV,222264,0,"160098606,59"
03/06/2024,31643,,,Terminal LS - Tarjeta TPV,1092875,0,"161191481,59"
03/06/2024,31754,,12682,Terminal LS - Efectivo TPV,113848,0,"161259329,59"
03/06/2024,31753,,12679,Terminal LS - Efectivo TPV,"150831,99",0,"161410161,58"
03/06/2024,31752,,12673,Terminal LS - Efectivo TPV,78120,0,"161488281,58"
03/06/2024,31751,,12669,Terminal LS - Efectivo TPV,"75716,99",0,"161563998,57"
03/06/2024,31629,,,Terminal LS - Efectivo TPV,172300,0,"161736298,57"
03/06/2024,31629,,,Terminal LS - Efectivo TPV,0,172300,"161563998,57"
03/07/2024,31886,,12692,Terminal LS - Efectivo TPV,"73999,99",0,"161637998,56"
03/07/2024,31760,,,Terminal LS - Tarjeta TPV,347403,0,"161985401,56"
03/07/2024,31755,,,Terminal LS - Efectivo TPV,418550,0,"162403951,56"
03/07/2024,31885,,12687,Terminal LS - Efectivo TPV,64244,0,"162468195,56"
03/07/2024,31755,,,Terminal LS - Efectivo TPV,0,418550,"162049645,56"
03/07/2024,31772,,,Terminal LS - Transferencia TPV,1770023,0,"163819668,56"
03/07/2024,31887,,12696,Terminal LS - Efectivo TPV,81944,0,"163901612,56"
03/08/2024,32297,,12774,Terminal LS - Efectivo TPV,88063,0,"163989675,56"
03/08/2024,32291,,12750,Terminal LS - Efectivo TPV,71600,0,"164061275,56"
03/08/2024,32293,,12760,Terminal LS - Efectivo TPV,301000,0,"164362275,56"
03/08/2024,31894,,,Terminal LS - Tarjeta TPV,622230,0,"164984505,56"
03/08/2024,32296,,12768,Terminal LS - Efectivo TPV,50000,0,"165034505,56"
03/08/2024,31905,,,Terminal LS - Transferencia TPV,1029461,0,"166023286,56"
03/08/2024,32286,,12715,Terminal LS - Efectivo TPV,245132,0,"166268418,56"
03/08/2024,32294,,12762,Terminal LS - Efectivo TPV,76044,0,"166344462,56"
03/08/2024,32285,,12713,Terminal LS - Efectivo TPV,"281178,99",0,"166610641,55"
03/08/2024,31888,,,Terminal LS - Efectivo TPV,0,220200,"166390441,55"
03/08/2024,32288,,12728,Terminal LS - Efectivo TPV,"92870,01",0,"166483311,56"
03/08/2024,32299,,12783,Terminal LS - Efectivo TPV,"11999,99",0,"166495311,55"
03/08/2024,32298,,12776,Terminal LS - Efectivo TPV,131548,0,"166626859,55"
03/08/2024,31888,,,Terminal LS - Efectivo TPV,220200,0,"166847059,55"
03/08/2024,32295,,12766,Terminal LS - Efectivo TPV,107074,0,"166954133,55"
03/08/2024,32287,,12725,Terminal LS - Efectivo TPV,67000,0,"167021133,55"
03/08/2024,32284,,12710,Terminal LS - Efectivo TPV,47000,0,"167068133,55"
03/08/2024,32290,,12740,Terminal LS - Efectivo TPV,"89046,01",0,"167157179,56"
03/08/2024,32292,,12755,Terminal LS - Efectivo TPV,89046,0,"167246225,56"
03/08/2024,32289,,12736,Terminal LS - Efectivo TPV,"67303,99",0,"167313529,55"
03/08/2024,32300,,12784,Terminal LS - Efectivo TPV,77137,0,"167390666,55"
03/09/2024,32339,,,Terminal LS - Transferencia TPV,1437773,0,"168828439,55"
03/09/2024,32800,,12804,Terminal LS - Efectivo TPV,160393,0,"168988832,55"
03/09/2024,32802,,12814,Terminal LS - Efectivo TPV,6000,0,"168994832,55"
03/09/2024,32807,,12865,Terminal LS - Efectivo TPV,"116142,98",0,"169084975,53"
03/09/2024,32324,,,Terminal LS - Tarjeta TPV,2266237,0,"171351212,53"
03/09/2024,32301,,,Terminal LS - Efectivo TPV,0,1893050,"169458162,53"
03/09/2024,32799,,12795,Terminal LS - Efectivo TPV,47000,0,"169505162,53"
03/09/2024,32806,,12850,Terminal LS - Efectivo TPV,60094,0,"169542981,97"
03/09/2024,32805,,12845,Terminal LS - Efectivo TPV,"84999,99",0,"169627981,96"
03/09/2024,32804,,12839,Terminal LS - Efectivo TPV,18290,0,"169646271,96"
03/09/2024,32803,,12832,Terminal LS - Efectivo TPV,87407,0,"169733678,96"
03/09/2024,32301,,,Terminal LS - Efectivo TPV,1893050,0,"171626728,96"
03/09/2024,32801,,12807,Terminal LS - Efectivo TPV,67000,0,"171653048,96"
03/10/2024,33168,,12897,Terminal LS - Efectivo TPV,75607,0,"171725165,96"
03/10/2024,33169,,12899,Terminal LS - Efectivo TPV,5800,0,"171730965,96"
03/10/2024,33170,,12931,Terminal LS - Efectivo TPV,101000,0,"171831965,96"
03/10/2024,33171,,12940,Terminal LS - Efectivo TPV,"64999,99",0,"171896965,95"
03/10/2024,33174,,12956,Terminal LS - Efectivo TPV,92543,0,"171852508,95"
03/10/2024,33172,,12942,Terminal LS - Efectivo TPV,82000,0,"171978965,95"
03/10/2024,33175,,12967,Terminal LS - Efectivo TPV,"145849,99",0,"171998358,94"
03/10/2024,32824,,,Terminal LS - Tarjeta TPV,2359778,0,"174358136,94"
03/10/2024,32808,,,Terminal LS - Efectivo TPV,0,647250,"173710886,94"
03/10/2024,32843,,,Terminal LS - Transferencia TPV,2783021,0,"176493907,94"
03/10/2024,32808,,,Terminal LS - Efectivo TPV,647250,0,"177141157,94"
03/10/2024,33173,,12948,Terminal LS - Efectivo TPV,"75716,99",0,"177216874,93"
03/11/2024,33176,,,Terminal LS - Efectivo TPV,643550,0,"177860424,93"
03/11/2024,33200,,,Terminal LS - Transferencia TPV,461762,0,"178322186,93"
03/11/2024,33176,,,Terminal LS - Efectivo TPV,0,643550,"177616336,93"
03/11/2024,33192,,,Terminal LS - Tarjeta TPV,1303973,0,"178912409,93"
03/13/2024,33452,,12990,Terminal LS - Efectivo TPV,9800,0,"178752209,93"
03/13/2024,33453,,12994,Terminal LS - Efectivo TPV,74600,0,"178826809,93"
03/13/2024,33454,,13000,Terminal LS - Efectivo TPV,"162577,99",0,"178989387,92"
03/14/2024,33463,,,Terminal LS - Tarjeta TPV,674401,0,"179463795,62"
03/14/2024,33455,,,Terminal LS - Efectivo TPV,247000,0,"179710795,62"
03/14/2024,33665,,13021,Terminal LS - Efectivo TPV,102922,0,"179813717,62"
03/14/2024,33664,,13014,Terminal LS - Efectivo TPV,108000,0,"179921717,62"
03/14/2024,33472,,,Terminal LS - Transferencia TPV,744690,0,"180666407,62"
03/14/2024,33667,,13040,Terminal LS - Efectivo TPV,180000,0,"180846407,62"
03/14/2024,33455,,,Terminal LS - Efectivo TPV,0,247000,"180599407,62"
03/14/2024,33666,,13036,Terminal LS - Efectivo TPV,"169679,99",0,"180641727,61"
03/15/2024,34030,,13056,Terminal LS - Efectivo TPV,"60799,99",0,"180702527,6"
03/15/2024,34029,,13052,Terminal LS - Efectivo TPV,79322,0,"180781849,6"
03/15/2024,34035,,13101,Terminal LS - Efectivo TPV,"233268,99",0,"181015118,59"
03/15/2024,34036,,13106,Terminal LS - Efectivo TPV,9000,0,"181024118,59"
03/15/2024,34034,,13092,Terminal LS - Efectivo TPV,"78666,99",0,"181102785,58"
03/15/2024,34033,,13084,Terminal LS - Efectivo TPV,168587,0,"181271372,58"
03/15/2024,33668,,,Terminal LS - Efectivo TPV,0,1060950,"180210422,58"
03/15/2024,33668,,,Terminal LS - Efectivo TPV,1060950,0,"181271372,58"
03/15/2024,33691,,,Terminal LS - Transferencia TPV,1707337,0,"182978709,58"
03/15/2024,33676,,,Terminal LS - Tarjeta TPV,761959,0,"183740668,58"
03/15/2024,34031,,13063,Terminal LS - Efectivo TPV,81726,0,"183822394,58"
03/15/2024,34032,,13068,Terminal LS - Efectivo TPV,"131000,01",0,"183953394,59"
03/16/2024,34037,,,Terminal LS - Efectivo TPV,0,842500,"183110894,59"
03/16/2024,34037,,,Terminal LS - Efectivo TPV,842500,0,"183953394,59"
03/16/2024,34665,,13219,Terminal LS - Efectivo TPV,"227805,99",0,"184164200,58"
03/16/2024,34657,,13164,Terminal LS - Efectivo TPV,"74799,99",0,"184239000,57"
03/16/2024,34660,,13174,Terminal LS - Efectivo TPV,83037,0,"184322037,57"
03/16/2024,34650,,13128,Terminal LS - Efectivo TPV,73750,0,"184395787,57"
03/16/2024,34658,,13165,Terminal LS - Efectivo TPV,"79540,99",0,"184475328,56"
03/16/2024,34656,,13156,Terminal LS - Efectivo TPV,84676,0,"184560004,56"
03/16/2024,34649,,13127,Terminal LS - Efectivo TPV,"153999,99",0,"184714004,55"
03/16/2024,34653,,13137,Terminal LS - Efectivo TPV,"107000,01",0,"184821004,56"
03/16/2024,34659,,13166,Terminal LS - Efectivo TPV,151870,0,"184972874,56"
03/16/2024,34663,,13206,Terminal LS - Efectivo TPV,166000,0,"185138874,56"
03/16/2024,34654,,13148,Terminal LS - Efectivo TPV,165637,0,"185304511,56"
03/16/2024,34662,,13197,Terminal LS - Efectivo TPV,"167166,99",0,"185471678,55"
03/16/2024,34661,,13176,Terminal LS - Efectivo TPV,"65499,99",0,"185537178,54"
03/16/2024,34651,,13129,Terminal LS - Efectivo TPV,17481,0,"185554659,54"
03/16/2024,34655,,13153,Terminal LS - Efectivo TPV,60500,0,"185600159,54"
03/16/2024,34652,,13135,Terminal LS - Efectivo TPV,152635,0,"185752794,54"
03/16/2024,34664,,13218,Terminal LS - Efectivo TPV,200000,0,"185952794,54"
03/16/2024,34059,,,Terminal LS - Tarjeta TPV,2203159,0,"188155953,54"
03/16/2024,34085,,,Terminal LS - Transferencia TPV,3070548,0,"191196501,54"
03/17/2024,35415,,13345,Terminal LS - Efectivo TPV,"95055,99",0,"191291557,53"
03/17/2024,35410,,13226,Terminal LS - Efectivo TPV,4000,0,"191295557,53"
03/17/2024,34681,,,Terminal LS - Tarjeta TPV,1599224,0,"192894781,53"
03/17/2024,34666,,,Terminal LS - Efectivo TPV,2031700,0,"194926481,53"
03/17/2024,35418,,13354,Terminal LS - Efectivo TPV,83400,0,"195009881,53"
03/17/2024,35412,,13291,Terminal LS - Efectivo TPV,111007,0,"195120888,53"
03/17/2024,34666,,,Terminal LS - Efectivo TPV,0,2031700,"193089188,53"
03/17/2024,35413,,13307,Terminal LS - Efectivo TPV,213602,0,"193302790,53"
03/17/2024,35414,,13342,Terminal LS - Efectivo TPV,91231,0,"193394021,53"
03/17/2024,35417,,13351,Terminal LS - Efectivo TPV,81500,0,"193475521,53"
03/17/2024,35416,,13348,Terminal LS - Efectivo TPV,128380,0,"193603901,53"
03/17/2024,35411,,13243,Terminal LS - Efectivo TPV,"68942,99",0,"193672844,52"
03/17/2024,34704,,,Terminal LS - Transferencia TPV,3204987,0,"196877831,52"
03/18/2024,35430,,,Terminal LS - Tarjeta TPV,1323661,0,"198201492,52"
03/18/2024,35444,,,Terminal LS - Transferencia TPV,1266798,0,"199468290,52"
03/18/2024,35419,,,Terminal LS - Efectivo TPV,0,877500,"198590790,52"
03/18/2024,35419,,,Terminal LS - Efectivo TPV,877500,0,"199468290,52"
03/19/2024,35573,,13365,Terminal LS - Efectivo TPV,60500,0,"199483989,68"
03/19/2024,35572,,13364,Terminal LS - Efectivo TPV,59000,0,"199542989,68"
03/19/2024,35575,,13376,Terminal LS - Efectivo TPV,"159627,99",0,"199646937,67"
03/19/2024,35576,,13377,Terminal LS - Efectivo TPV,157934,0,"199804871,67"
03/19/2024,35577,,13380,Terminal LS - Efectivo TPV,"174923,99",0,"199979795,66"
03/19/2024,35578,,13381,Terminal LS - Efectivo TPV,49800,0,"200029595,66"
03/19/2024,35571,,13358,Terminal LS - Efectivo TPV,61000,0,"200090595,66"
03/19/2024,35570,,13356,Terminal LS - Efectivo TPV,9500,0,"200100095,66"
03/19/2024,35574,,13368,Terminal LS - Efectivo TPV,6700,0,"200106795,66"
03/20/2024,35579,,,Terminal LS - Efectivo TPV,739000,0,"200805795,66"
03/20/2024,35579,,,Terminal LS - Efectivo TPV,0,739000,"200066795,66"
03/20/2024,35678,,13392,Terminal LS - Efectivo TPV,76809,0,"200143604,66"
03/20/2024,35677,,13391,Terminal LS - Efectivo TPV,86970,0,"200230574,66"
03/20/2024,35682,,13399,Terminal LS - Efectivo TPV,74000,0,"200304574,66"
03/20/2024,35680,,13395,Terminal LS - Efectivo TPV,61895,0,"200366469,66"
03/20/2024,35609,,,Terminal LS - Transferencia TPV,2129770,0,"202496239,66"
03/20/2024,35588,,,Terminal LS - Tarjeta TPV,869773,0,"203366012,66"
03/20/2024,35681,,13397,Terminal LS - Efectivo TPV,100000,0,"203466012,66"
03/20/2024,35679,,13393,Terminal LS - Efectivo TPV,85400,0,"203536412,66"
03/20/2024,35683,,13404,Terminal LS - Efectivo TPV,"127068,99",0,"203663481,65"
03/21/2024,35684,,,Terminal LS - Efectivo TPV,612200,0,"204275681,65"
03/21/2024,35687,,,Terminal LS - Tarjeta TPV,504231,0,"204779912,65"
03/21/2024,35834,,13436,Terminal LS - Efectivo TPV,61895,0,"204841807,65"
03/21/2024,35684,,,Terminal LS - Efectivo TPV,0,612200,"204229607,65"
03/21/2024,35694,,,Terminal LS - Transferencia TPV,617003,0,"204846610,65"
03/21/2024,35833,,13419,Terminal LS - Efectivo TPV,78557,0,"204925167,65"
03/22/2024,36193,,13494,Terminal LS - Efectivo TPV,120000,0,"205045167,65"
03/22/2024,36185,,13448,Terminal LS - Efectivo TPV,4000,0,"205049167,65"
03/22/2024,36190,,13478,Terminal LS - Efectivo TPV,"70099,99",0,"205119267,64"
03/22/2024,36191,,13486,Terminal LS - Efectivo TPV,11000,0,"205130267,64"
03/22/2024,36187,,13457,Terminal LS - Efectivo TPV,"82490,99",0,"205212758,63"
03/22/2024,36194,,13501,Terminal LS - Efectivo TPV,77902,0,"205290660,63"
03/22/2024,36186,,13449,Terminal LS - Efectivo TPV,20515,0,"205311175,63"
03/22/2024,36195,,13507,Terminal LS - Efectivo TPV,32000,0,"205343175,63"
03/22/2024,36196,,13508,Terminal LS - Efectivo TPV,210215,0,"205553390,63"
03/22/2024,36188,,13463,Terminal LS - Efectivo TPV,"91668,99",0,"205645059,62"
03/22/2024,36197,,13515,Terminal LS - Efectivo TPV,58000,0,"205703059,62"
03/22/2024,35835,,,Terminal LS - Efectivo TPV,0,140500,"205562559,62"
03/22/2024,35839,,,Terminal LS - Tarjeta TPV,328543,0,"205891102,62"
03/22/2024,35835,,,Terminal LS - Efectivo TPV,140500,0,"206031602,62"
03/22/2024,36192,,13487,Terminal LS - Efectivo TPV,68000,0,"206099602,62"
03/22/2024,36189,,13477,Terminal LS - Efectivo TPV,69489,0,"206169091,62"
03/23/2024,36216,,,Terminal LS - Tarjeta TPV,2264525,0,"208172256,24"
03/23/2024,36198,,,Terminal LS - Efectivo TPV,915400,0,"209087656,24"
03/23/2024,36198,,,Terminal LS - Efectivo TPV,0,915400,"208172256,24"
03/23/2024,36243,,,Terminal LS - Transferencia TPV,2269880,0,"210442136,24"
03/24/2024,37307,,13663,Terminal LS - Efectivo TPV,"74623,99",0,"210501760,23"
03/24/2024,37308,,13673,Terminal LS - Efectivo TPV,180824,0,"210682584,23"
03/24/2024,37309,,13680,Terminal LS - Efectivo TPV,51000,0,"210733584,23"
03/24/2024,37310,,13685,Terminal LS - Efectivo TPV,130000,0,"210863584,23"
03/24/2024,37311,,13693,Terminal LS - Efectivo TPV,72548,0,"210936132,23"
03/24/2024,37305,,13603,Terminal LS - Efectivo TPV,"77901,99",0,"211014034,22"
03/24/2024,37306,,13619,Terminal LS - Efectivo TPV,3200,0,"211017234,22"
03/25/2024,37676,,13777,Terminal LS - Efectivo TPV,"115815,01",0,"211133049,23"
03/25/2024,37675,,13776,Terminal LS - Efectivo TPV,93307,0,"211226356,23"
03/25/2024,37674,,13762,Terminal LS - Efectivo TPV,"371918,99",0,"211598275,22"
03/25/2024,37312,,,Terminal LS - Efectivo TPV,0,590100,"211008175,22"
03/25/2024,37312,,,Terminal LS - Efectivo TPV,590100,0,"211598275,22"
03/25/2024,37321,,,Terminal LS - Tarjeta TPV,795924,0,"212394199,22"
03/25/2024,37673,,13744,Terminal LS - Efectivo TPV,115000,0,"212509199,22"
03/25/2024,37337,,,Terminal LS - Transferencia TPV,1542252,0,"214051451,22"
03/25/2024,37672,,13716,Terminal LS - Efectivo TPV,104889,0,"214156340,22"
03/26/2024,39311,,13790,Terminal LS - Efectivo TPV,"49999,99",0,"214206340,21"
03/26/2024,39314,,13794,Terminal LS - Efectivo TPV,"99999,99",0,"214306340,2"
03/26/2024,37677,,,Terminal LS - Efectivo TPV,800950,0,"215107290,2"
03/26/2024,37677,,,Terminal LS - Efectivo TPV,0,800950,"214306340,2"
03/26/2024,37691,,,Terminal LS - Transferencia TPV,901639,0,"215207979,2"
03/26/2024,37682,,,Terminal LS - Tarjeta TPV,483149,0,"215691128,2"
03/26/2024,39315,,13796,Terminal LS - Efectivo TPV,88417,0,"215779545,2"
03/26/2024,39308,,13785,Terminal LS - Efectivo TPV,80852,0,"215860397,2"
03/26/2024,39309,,13786,Terminal LS - Efectivo TPV,81398,0,"215941795,2"
03/26/2024,39310,,13789,Terminal LS - Efectivo TPV,89374,0,"216031169,2"
03/26/2024,39312,,13791,Terminal LS - Efectivo TPV,68000,0,"216099169,2"
03/26/2024,39313,,13792,Terminal LS - Efectivo TPV,"64999,99",0,"216164169,19"
03/27/2024,39664,,13798,Terminal LS - Efectivo TPV,2800,0,"216166969,19"
03/27/2024,39320,,,Terminal LS - Tarjeta TPV,263833,0,"214954368,45"
03/27/2024,39316,,,Terminal LS - Efectivo TPV,0,623050,"214331318,45"
03/27/2024,39316,,,Terminal LS - Efectivo TPV,623050,0,"214954368,45"
03/27/2024,39668,,13829,Terminal LS - Efectivo TPV,13000,0,"214967368,45"
03/27/2024,39669,,13833,Terminal LS - Efectivo TPV,98661,0,"215066029,45"
03/27/2024,39670,,13835,Terminal LS - Efectivo TPV,61000,0,"215127029,45"
03/27/2024,39671,,13840,Terminal LS - Efectivo TPV,"82490,99",0,"215209520,44"
03/27/2024,39667,,13820,Terminal LS - Efectivo TPV,85113,0,"215294633,44"
03/27/2024,39666,,13818,Terminal LS - Efectivo TPV,61000,0,"215355633,44"
03/27/2024,39665,,13810,Terminal LS - Efectivo TPV,45050,0,"215400683,44"
03/28/2024,40276,,13933,Terminal LS - Efectivo TPV,79322,0,"215480005,44"
03/28/2024,40283,,13965,Terminal LS - Efectivo TPV,88500,0,"215568505,44"
03/28/2024,40274,,13917,Terminal LS - Efectivo TPV,72000,0,"215640505,44"
03/28/2024,40277,,13935,Terminal LS - Efectivo TPV,150000,0,"215790505,44"
03/28/2024,40278,,13936,Terminal LS - Efectivo TPV,91000,0,"215866505,44"
03/28/2024,40273,,13909,Terminal LS - Efectivo TPV,70000,0,"215936505,44"
03/28/2024,40272,,13892,Terminal LS - Efectivo TPV,4000,0,"215940505,44"
03/28/2024,40271,,13888,Terminal LS - Efectivo TPV,7000,0,"215947505,44"
03/28/2024,39672,,,Terminal LS - Efectivo TPV,0,449200,"215498305,44"
03/28/2024,40280,,13955,Terminal LS - Efectivo TPV,79541,0,"215577846,44"
03/28/2024,39700,,,Terminal LS - Transferencia TPV,3045345,0,"218623191,44"
03/28/2024,40282,,13960,Terminal LS - Efectivo TPV,9800,0,"218632991,44"
03/28/2024,40279,,13940,Terminal LS - Efectivo TPV,238076,0,"218871067,44"
03/28/2024,40275,,13918,Terminal LS - Efectivo TPV,"85331,01",0,"218956398,45"
03/28/2024,40281,,13957,Terminal LS - Efectivo TPV,"154383,02",0,"219110781,47"
03/29/2024,40958,,14089,Terminal LS - Efectivo TPV,118000,0,"219228781,47"
03/29/2024,40949,,14046,Terminal LS - Efectivo TPV,230900,0,"219459681,47"
03/29/2024,40940,,14001,Terminal LS - Efectivo TPV,62500,0,"219522181,47"
03/29/2024,40944,,14026,Terminal LS - Efectivo TPV,66000,0,"219588181,47"
03/29/2024,40953,,14076,Terminal LS - Efectivo TPV,128600,0,"219716781,47"
03/29/2024,40956,,14084,Terminal LS - Efectivo TPV,"79431,01",0,"219796212,48"
03/29/2024,40948,,14044,Terminal LS - Efectivo TPV,84894,0,"219881106,48"
03/29/2024,40957,,14088,Terminal LS - Efectivo TPV,88281,0,"219969387,48"
03/29/2024,40955,,14082,Terminal LS - Efectivo TPV,"105999,99",0,"220075387,47"
03/29/2024,40947,,14041,Terminal LS - Efectivo TPV,54000,0,"220129387,47"
03/29/2024,40946,,14035,Terminal LS - Efectivo TPV,"93416,99",0,"220222804,46"
03/29/2024,40284,,,Terminal LS - Efectivo TPV,0,1129050,"219093754,46"
03/29/2024,40317,,,Terminal LS - Transferencia TPV,2541351,0,"221594425,46"
03/29/2024,40954,,14079,Terminal LS - Efectivo TPV,36694,0,"221631119,46"
03/29/2024,40945,,14028,Terminal LS - Efectivo TPV,161540,0,"221792659,46"
03/29/2024,40951,,14068,Terminal LS - Efectivo TPV,"76590,99",0,"221869250,45"
03/29/2024,40941,,14006,Terminal LS - Efectivo TPV,101000,0,"221970250,45"
03/29/2024,40950,,14061,Terminal LS - Efectivo TPV,64026,0,"222034276,45"
03/29/2024,40942,,14007,Terminal LS - Efectivo TPV,55500,0,"222089776,45"
03/29/2024,40952,,14069,Terminal LS - Efectivo TPV,100191,0,"222189967,45"
03/29/2024,40943,,14022,Terminal LS - Efectivo TPV,67000,0,"222256967,45"
03/30/2024,41666,,14162,Terminal LS - Efectivo TPV,"87407,01",0,"222344374,46"
03/30/2024,40971,,,Terminal LS - Tarjeta TPV,1090687,0,"223435061,46"
03/30/2024,41668,,14181,Terminal LS - Efectivo TPV,118546,0,"223553607,46"
03/30/2024,41663,,14095,Terminal LS - Efectivo TPV,112428,0,"223666035,46"
03/30/2024,41670,,14193,Terminal LS - Efectivo TPV,"89592,99",0,"223755628,45"
03/30/2024,41662,,14092,Terminal LS - Efectivo TPV,59000,0,"223814628,45"
03/30/2024,41664,,14142,Terminal LS - Efectivo TPV,64500,0,"223879128,45"
03/30/2024,41672,,14217,Terminal LS - Efectivo TPV,218737,0,"224097865,45"
03/30/2024,41669,,14191,Terminal LS - Efectivo TPV,100000,0,"224197865,45"
03/30/2024,40959,,,Terminal LS - Efectivo TPV,0,1774600,"222423265,45"
03/30/2024,40959,,,Terminal LS - Efectivo TPV,1774600,0,"224197865,45"
03/30/2024,41667,,14171,Terminal LS - Efectivo TPV,"151323,99",0,"224249189,44"
03/30/2024,41665,,14159,Terminal LS - Efectivo TPV,7600,0,"224256789,44"
03/30/2024,41671,,14215,Terminal LS - Efectivo TPV,107000,0,"224363789,44"
03/31/2024,41930,,14221,Terminal LS - Efectivo TPV,37367,0,"224401156,44"
03/31/2024,41931,,14222,Terminal LS - Efectivo TPV,23381,0,"224424537,44"
03/31/2024,41933,,14247,Terminal LS - Efectivo TPV,64000,0,"224488537,44"
03/31/2024,41707,,,Terminal LS - Transferencia TPV,3218944,0,"227707481,44"
03/31/2024,41936,,14265,Terminal LS - Efectivo TPV,104343,0,"227811824,44"
03/31/2024,41935,,14262,Terminal LS - Efectivo TPV,57815,0,"227869639,44"
03/31/2024,41934,,14252,Terminal LS - Efectivo TPV,"207701,99",0,"228077341,43"
03/31/2024,41932,,14234,Terminal LS - Efectivo TPV,"284620,01",0,"228361961,44"
03/31/2024,41673,,,Terminal LS - Efectivo TPV,0,1116050,"227245911,44"
03/31/2024,41937,,14272,Terminal LS - Efectivo TPV,"159955,99",0,"227405867,43"
04/01/2024,41953,,,Terminal LS - Transferencia TPV,1481898,0,"228887765,43"
04/01/2024,41938,,,Terminal LS - Efectivo TPV,0,938800,"227948965,43"
04/02/2024,42053,,14288,Terminal LS - Efectivo TPV,"78666,99",0,"228015632,42"
04/02/2024,42054,,14289,Terminal LS - Efectivo TPV,67000,0,"228062332,76"
04/03/2024,42135,,14301,Terminal LS - Efectivo TPV,30265,0,"228072797,76"
04/03/2024,42130,,14293,Terminal LS - Efectivo TPV,50000,0,"228122797,76"
04/03/2024,42063,,,Terminal LS - Tarjeta TPV,630255,0,"228753052,76"
04/03/2024,42055,,,Terminal LS - Efectivo TPV,145700,0,"228581053,4"
04/03/2024,42134,,14300,Terminal LS - Efectivo TPV,155257,0,"228736310,4"
04/03/2024,42133,,14297,Terminal LS - Efectivo TPV,"139999,99",0,"228876310,39"
04/03/2024,42132,,14296,Terminal LS - Efectivo TPV,73859,0,"228950169,39"
04/03/2024,42131,,14294,Terminal LS - Efectivo TPV,"59999,99",0,"229010169,38"
04/03/2024,42138,,14305,Terminal LS - Efectivo TPV,22000,0,"229032169,38"
04/03/2024,42137,,14303,Terminal LS - Efectivo TPV,62250,0,"229094419,38"
04/03/2024,42136,,14302,Terminal LS - Efectivo TPV,101900,0,"229196319,38"
04/03/2024,42055,,,Terminal LS - Efectivo TPV,0,145700,"229050619,38"
04/04/2024,42258,,14310,Terminal LS - Efectivo TPV,59000,0,"229109619,38"
04/04/2024,42260,,14313,Terminal LS - Efectivo TPV,105700,0,"229215319,38"
04/04/2024,42261,,14319,Terminal LS - Efectivo TPV,"76999,99",0,"229292319,37"
04/04/2024,42262,,14324,Terminal LS - Efectivo TPV,160720,0,"229453039,37"
04/04/2024,42263,,14325,Terminal LS - Efectivo TPV,78000,0,"229531039,37"
04/04/2024,42264,,14326,Terminal LS - Efectivo TPV,"80099,99",0,"229611139,36"
04/04/2024,42265,,14327,Terminal LS - Efectivo TPV,56700,0,"229667839,36"
04/04/2024,42266,,14328,Terminal LS - Efectivo TPV,134100,0,"229801939,36"
04/04/2024,42141,,,Terminal LS - Tarjeta TPV,29869,0,"229831808,36"
04/04/2024,42139,,,Terminal LS - Efectivo TPV,0,695550,"229136258,36"
04/04/2024,42139,,,Terminal LS - Efectivo TPV,695550,0,"229831808,36"
04/04/2024,42267,,14329,Terminal LS - Efectivo TPV,10000,0,"229826808,36"
04/04/2024,42259,,14311,Terminal LS - Efectivo TPV,132750,0,"229959558,36"
04/05/2024,42268,,,Terminal LS - Efectivo TPV,0,894200,"229065358,36"
04/05/2024,42571,,14394,Terminal LS - Efectivo TPV,91559,0,"229156917,36"
04/05/2024,42570,,14393,Terminal LS - Efectivo TPV,"116999,98",0,"229273917,34"
04/05/2024,42569,,14390,Terminal LS - Efectivo TPV,137448,0,"229411365,34"
04/05/2024,42568,,14373,Terminal LS - Efectivo TPV,100409,0,"229511774,34"
04/05/2024,42567,,14367,Terminal LS - Efectivo TPV,"100000,01",0,"229611774,35"
04/05/2024,42566,,14356,Terminal LS - Efectivo TPV,40000,0,"229651774,35"
04/05/2024,42565,,14354,Terminal LS - Efectivo TPV,173613,0,"229825387,35"
04/05/2024,42564,,14346,Terminal LS - Efectivo TPV,"130500,01",0,"229955887,36"
04/05/2024,42563,,14340,Terminal LS - Efectivo TPV,4000,0,"229959887,36"
04/05/2024,42561,,14331,Terminal LS - Efectivo TPV,136082,0,"230095969,36"
04/05/2024,42278,,,Terminal LS - Transferencia TPV,672659,0,"230768628,36"
04/05/2024,42562,,14334,Terminal LS - Efectivo TPV,60366,0,"230828994,36"
04/06/2024,42572,,,Terminal LS - Efectivo TPV,0,1091200,"229737794,36"
04/06/2024,43227,,14416,Terminal LS - Efectivo TPV,42400,0,"229780194,36"
04/06/2024,43239,,14507,Terminal LS - Efectivo TPV,89593,0,"229869787,36"
04/06/2024,43229,,14434,Terminal LS - Efectivo TPV,"277846,02",0,"230147633,38"
04/06/2024,43237,,14495,Terminal LS - Efectivo TPV,"257141,99",0,"230404775,37"
04/06/2024,43228,,14428,Terminal LS - Efectivo TPV,"248674,01",0,"230653449,38"
04/06/2024,43231,,14441,Terminal LS - Efectivo TPV,55250,0,"230708699,38"
04/06/2024,43232,,14442,Terminal LS - Efectivo TPV,70130,0,"230778829,38"
04/06/2024,43226,,14408,Terminal LS - Efectivo TPV,59000,0,"230837829,38"
04/06/2024,43235,,14468,Terminal LS - Efectivo TPV,"168805,98",0,"231006635,36"
04/06/2024,42601,,,Terminal LS - Transferencia TPV,2158793,0,"233165428,36"
04/06/2024,43234,,14458,Terminal LS - Efectivo TPV,181370,0,"233346798,36"
04/06/2024,43238,,14506,Terminal LS - Efectivo TPV,74159,0,"233420957,36"
04/06/2024,43230,,14436,Terminal LS - Efectivo TPV,215250,0,"233636207,36"
04/06/2024,43233,,14453,Terminal LS - Efectivo TPV,147172,0,"233783379,36"
04/06/2024,43236,,14493,Terminal LS - Efectivo TPV,"163999,99",0,"233947379,35"
04/07/2024,43657,,14527,Terminal LS - Efectivo TPV,15000,0,"233962379,35"
04/07/2024,43661,,14577,Terminal LS - Efectivo TPV,92343,0,"234054722,35"
04/07/2024,43658,,14556,Terminal LS - Efectivo TPV,"145642,99",0,"234200365,34"
04/07/2024,43198,,,Terminal LS - Tarjeta TPV,2828763,0,"237029128,34"
04/07/2024,43240,,,Terminal LS - Efectivo TPV,0,2050800,"234978328,34"
04/07/2024,43654,,14508,Terminal LS - Efectivo TPV,4000,0,"234982328,34"
04/07/2024,43655,,14516,Terminal LS - Efectivo TPV,2800,0,"234985128,34"
04/07/2024,43656,,14526,Terminal LS - Efectivo TPV,62500,0,"235047628,34"
04/07/2024,43659,,14565,Terminal LS - Efectivo TPV,71073,0,"235118701,34"
04/07/2024,43660,,14575,Terminal LS - Efectivo TPV,63500,0,"235182201,34"
04/07/2024,43224,,,Terminal LS - Transferencia TPV,3004249,0,"238186450,34"
04/08/2024,43662,,,Terminal LS - Efectivo TPV,0,456900,"237729550,34"
04/08/2024,43671,,,Terminal LS - Tarjeta TPV,1036705,0,"238766255,34"
04/08/2024,43662,,,Terminal LS - Efectivo TPV,456900,0,"239223155,34"
04/09/2024,43733,,14592,Terminal LS - Efectivo TPV,47000,0,"239236155,85"
04/10/2024,43734,,,Terminal LS - Efectivo TPV,47000,0,"239198176,19"
04/10/2024,43788,,14606,Terminal LS - Efectivo TPV,88655,0,"239246331,19"
04/10/2024,43734,,,Terminal LS - Efectivo TPV,0,47000,"239199331,19"
04/11/2024,43974,,14648,Terminal LS - Efectivo TPV,16000,0,"239170331,19"
04/11/2024,43973,,14641,Terminal LS - Efectivo TPV,"157224,01",0,"239327555,2"
04/11/2024,43972,,14627,Terminal LS - Efectivo TPV,4000,0,"239331555,2"
04/11/2024,43789,,,Terminal LS - Efectivo TPV,0,88700,"238849365,45"
04/11/2024,43789,,,Terminal LS - Efectivo TPV,88700,0,"238938065,45"
04/11/2024,43976,,14653,Terminal LS - Efectivo TPV,55000,0,"238993065,45"
04/11/2024,43977,,14653,Terminal LS - Efectivo TPV,"40085,03",0,"239033150,48"
04/11/2024,43971,,14618,Terminal LS - Efectivo TPV,5800,0,"239038950,48"
04/11/2024,43796,,,Terminal LS - Tarjeta TPV,776882,0,"239815832,48"
04/11/2024,43975,,14652,Terminal LS - Efectivo TPV,"205680,99",0,"240021513,47"
04/12/2024,44323,,14655,Terminal LS - Efectivo TPV,"69217,99",0,"240090731,46"
04/12/2024,43978,,,Terminal LS - Efectivo TPV,0,483800,"239606931,46"
04/12/2024,44332,,14704,Terminal LS - Efectivo TPV,106528,0,"239713459,46"
04/12/2024,44331,,14695,Terminal LS - Efectivo TPV,211581,0,"239925040,46"
04/12/2024,44325,,14663,Terminal LS - Efectivo TPV,175250,0,"240100290,46"
04/12/2024,44326,,14681,Terminal LS - Efectivo TPV,23054,0,"240123344,46"
04/12/2024,44324,,14657,Terminal LS - Efectivo TPV,5800,0,"240129144,46"
04/12/2024,44327,,14689,Terminal LS - Efectivo TPV,4000,0,"240133144,46"
04/12/2024,44333,,14706,Terminal LS - Efectivo TPV,123572,0,"240256716,46"
04/12/2024,44334,,14710,Terminal LS - Efectivo TPV,4000,0,"240260716,46"
04/12/2024,44330,,14692,Terminal LS - Efectivo TPV,97241,0,"240357957,46"
04/12/2024,44003,,,Terminal LS - Transferencia TPV,1885745,0,"242243702,46"
04/12/2024,44328,,14690,Terminal LS - Efectivo TPV,209300,0,"242453002,46"
04/12/2024,44329,,14691,Terminal LS - Efectivo TPV,169844,0,"242622846,46"
04/13/2024,44872,,14816,Terminal LS - Efectivo TPV,"157606,01",0,"242780452,47"
04/13/2024,44868,,14793,Terminal LS - Efectivo TPV,"150699,99",0,"242931152,46"
04/13/2024,44853,,14721,Terminal LS - Efectivo TPV,"75388,99",0,"243006541,45"
04/13/2024,44855,,14728,Terminal LS - Efectivo TPV,5800,0,"243012341,45"
04/13/2024,44860,,14747,Terminal LS - Efectivo TPV,75000,0,"243087341,45"
04/13/2024,44866,,14788,Terminal LS - Efectivo TPV,"152499,99",0,"243239841,44"
04/13/2024,44859,,14746,Terminal LS - Efectivo TPV,5800,0,"243245641,44"
04/13/2024,44857,,14734,Terminal LS - Efectivo TPV,"347280,98",0,"243592922,42"
04/13/2024,44871,,14814,Terminal LS - Efectivo TPV,14000,0,"243606922,42"
04/13/2024,44864,,14763,Terminal LS - Efectivo TPV,"93438,01",0,"243700360,43"
04/13/2024,44863,,14758,Terminal LS - Efectivo TPV,47000,0,"243747360,43"
04/13/2024,44355,,,Terminal LS - Tarjeta TPV,2134311,0,"245881671,43"
04/13/2024,44335,,,Terminal LS - Efectivo TPV,0,1199400,"244682271,43"
04/13/2024,44335,,,Terminal LS - Efectivo TPV,1199400,0,"245881671,43"
04/13/2024,44867,,14792,Terminal LS - Efectivo TPV,109587,0,"245991258,43"
04/13/2024,44870,,14805,Terminal LS - Efectivo TPV,78339,0,"246059597,43"
04/13/2024,44861,,14749,Terminal LS - Efectivo TPV,89647,0,"246149244,43"
04/13/2024,44854,,14723,Terminal LS - Efectivo TPV,78230,0,"246227474,43"
04/13/2024,44862,,14751,Terminal LS - Efectivo TPV,85058,0,"246312532,43"
04/13/2024,44865,,14772,Terminal LS - Efectivo TPV,10707,0,"246323239,43"
04/13/2024,44869,,14800,Terminal LS - Efectivo TPV,0,23200,"246300039,43"
04/13/2024,44856,,14732,Terminal LS - Efectivo TPV,5800,0,"246305839,43"
04/13/2024,44858,,14743,Terminal LS - Efectivo TPV,"234200,01",0,"246540039,44"
04/14/2024,45355,,14906,Terminal LS - Efectivo TPV,"41358,99",0,"246566398,43"
04/14/2024,45356,,14907,Terminal LS - Efectivo TPV,89702,0,"246615420,43"
04/14/2024,44873,,,Terminal LS - Efectivo TPV,0,1792750,"244822670,43"
04/14/2024,45352,,14884,Terminal LS - Efectivo TPV,97000,0,"244919670,43"
04/14/2024,45353,,14886,Terminal LS - Efectivo TPV,163288,0,"245082958,43"
04/14/2024,44912,,,Terminal LS - Transferencia TPV,2515554,0,"247598512,43"
04/14/2024,45351,,14880,Terminal LS - Efectivo TPV,66000,0,"247664512,43"
04/14/2024,45350,,14827,Terminal LS - Efectivo TPV,99000,0,"247763512,43"
04/14/2024,45354,,14904,Terminal LS - Efectivo TPV,"174268,99",0,"247937781,42"
04/15/2024,45381,,,Terminal LS - Transferencia TPV,1347668,0,"249285449,42"
04/15/2024,45357,,,Terminal LS - Efectivo TPV,0,730650,"248554799,42"
04/16/2024,45517,,14916,Terminal LS - Efectivo TPV,76263,0,"248623162,42"
04/16/2024,45520,,14921,Terminal LS - Efectivo TPV,273722,0,"248896884,42"
04/16/2024,45516,,14915,Terminal LS - Efectivo TPV,"80632,99",0,"248977517,41"
04/16/2024,45521,,14924,Terminal LS - Efectivo TPV,42631,0,"249020148,41"
04/16/2024,45515,,14914,Terminal LS - Efectivo TPV,"78229,99",0,"249098378,4"
04/16/2024,45518,,14917,Terminal LS - Efectivo TPV,"358643,99",0,"249457022,39"
04/16/2024,45519,,14918,Terminal LS - Efectivo TPV,14000,0,"249471022,39"
04/17/2024,45522,,,Terminal LS - Efectivo TPV,0,924200,"248546822,39"
04/17/2024,45615,,14937,Terminal LS - Efectivo TPV,67000,0,"248613822,39"
04/17/2024,45614,,14936,Terminal LS - Efectivo TPV,6600,0,"248620422,39"
04/17/2024,45613,,14932,Terminal LS - Efectivo TPV,41650,0,"248662072,39"
04/17/2024,45526,,,Terminal LS - Tarjeta TPV,489809,0,"248117914,93"
04/17/2024,45522,,,Terminal LS - Efectivo TPV,924200,0,"249042114,93"
04/18/2024,45785,,14984,Terminal LS - Efectivo TPV,81726,0,"249123840,93"
04/18/2024,45616,,,Terminal LS - Efectivo TPV,0,115250,"249008590,93"
04/18/2024,45635,,,Terminal LS - Transferencia TPV,694116,0,"249702706,93"
04/18/2024,45783,,14978,Terminal LS - Efectivo TPV,82491,0,"249719197,93"
04/18/2024,45784,,14979,Terminal LS - Efectivo TPV,"168368,98",0,"249851566,91"
04/18/2024,45781,,14962,Terminal LS - Efectivo TPV,24583,0,"249876149,91"
04/18/2024,45782,,14976,Terminal LS - Efectivo TPV,68500,0,"249944649,91"
04/19/2024,46083,,14990,Terminal LS - Efectivo TPV,55250,0,"249999899,91"
04/19/2024,46093,,15035,Terminal LS - Efectivo TPV,191014,0,"250190913,91"
04/19/2024,46090,,15010,Terminal LS - Efectivo TPV,118109,0,"250309022,91"
04/19/2024,46094,,15040,Terminal LS - Efectivo TPV,170000,0,"250479022,91"
04/19/2024,46095,,15041,Terminal LS - Efectivo TPV,200000,0,"250679022,91"
04/19/2024,46085,,14995,Terminal LS - Efectivo TPV,119420,0,"250798442,91"
04/19/2024,46084,,14992,Terminal LS - Efectivo TPV,119000,0,"250917442,91"
04/19/2024,46081,,14988,Terminal LS - Efectivo TPV,"111990,99",0,"251029433,9"
04/19/2024,46091,,15025,Terminal LS - Efectivo TPV,111281,0,"251140714,9"
04/19/2024,45786,,,Terminal LS - Efectivo TPV,0,425700,"250715014,9"
04/19/2024,46088,,15002,Terminal LS - Efectivo TPV,"114311,99",0,"250829326,89"
04/19/2024,46082,,14989,Terminal LS - Efectivo TPV,2800,0,"250832126,89"
04/19/2024,46092,,15027,Terminal LS - Efectivo TPV,"366110,01",0,"251198236,9"
04/19/2024,46087,,15001,Terminal LS - Efectivo TPV,"78448,01",0,"251276684,91"
04/19/2024,46086,,14996,Terminal LS - Efectivo TPV,75600,0,"251352284,91"
04/19/2024,46089,,15004,Terminal LS - Efectivo TPV,71346,0,"251423630,91"
04/19/2024,45795,,,Terminal LS - Transferencia TPV,606985,0,"252030615,91"
04/20/2024,46566,,15117,Terminal LS - Efectivo TPV,"162358,99",0,"252152974,9"
04/20/2024,46563,,15102,Terminal LS - Efectivo TPV,169500,0,"252322474,9"
04/20/2024,46565,,15115,Terminal LS - Efectivo TPV,"86861,01",0,"252409335,91"
04/20/2024,46562,,15087,Terminal LS - Efectivo TPV,"75716,99",0,"252485052,9"
04/20/2024,46555,,15049,Terminal LS - Efectivo TPV,"58499,99",0,"252543552,89"
04/20/2024,46557,,15054,Terminal LS - Efectivo TPV,"65992,99",0,"252609545,88"
04/20/2024,46558,,15061,Terminal LS - Efectivo TPV,72000,0,"252681545,88"
04/20/2024,46561,,15080,Terminal LS - Efectivo TPV,"90138,99",0,"252771684,87"
04/20/2024,46567,,15136,Terminal LS - Efectivo TPV,26222,0,"252797906,87"
04/20/2024,46568,,15143,Terminal LS - Efectivo TPV,85769,0,"252855685,88"
04/20/2024,46560,,15072,Terminal LS - Efectivo TPV,150450,0,"253006135,88"
04/20/2024,46096,,,Terminal LS - Efectivo TPV,1904700,0,"254910835,88"
04/20/2024,46096,,,Terminal LS - Efectivo TPV,0,1904700,"253006135,88"
04/20/2024,46564,,15114,Terminal LS - Efectivo TPV,68615,0,"253074750,88"
04/20/2024,46559,,15065,Terminal LS - Efectivo TPV,"83999,99",0,"253158750,87"
04/20/2024,46556,,15053,Terminal LS - Efectivo TPV,91559,0,"253250309,87"
04/21/2024,47063,,15192,Terminal LS - Efectivo TPV,113000,0,"253363309,87"
04/21/2024,46569,,,Terminal LS - Efectivo TPV,1287700,0,"254651009,87"
04/21/2024,47065,,15209,Terminal LS - Efectivo TPV,66500,0,"254717509,87"
04/21/2024,47064,,15208,Terminal LS - Efectivo TPV,67000,0,"254784509,87"
04/21/2024,46569,,,Terminal LS - Efectivo TPV,0,1287700,"253496809,87"
04/21/2024,47062,,15188,Terminal LS - Efectivo TPV,13000,0,"253509809,87"
04/21/2024,47061,,15176,Terminal LS - Efectivo TPV,77793,0,"253587602,87"
04/21/2024,47060,,15174,Terminal LS - Efectivo TPV,71565,0,"253659167,87"
04/21/2024,46573,,,Terminal LS - Tarjeta TPV,479046,0,"254138213,87"
04/21/2024,47059,,15164,Terminal LS - Efectivo TPV,"95849,99",0,"254234063,86"
04/22/2024,47084,,,Terminal LS - Tarjeta TPV,2428238,0,"256633301,87"
04/22/2024,47066,,,Terminal LS - Efectivo TPV,504750,0,"257138051,87"
04/22/2024,47066,,,Terminal LS - Efectivo TPV,0,504750,"256633301,87"
04/23/2024,47178,,15225,Terminal LS - Efectivo TPV,4000,0,"256577116,37"
04/23/2024,47177,,15224,Terminal LS - Efectivo TPV,"104399,99",0,"256681516,36"
04/23/2024,47176,,15219,Terminal LS - Efectivo TPV,84130,0,"256765646,36"
04/23/2024,47179,,15226,Terminal LS - Efectivo TPV,"104670,02",0,"256870316,38"
04/24/2024,47294,,15244,Terminal LS - Efectivo TPV,64791,0,"256935107,38"
04/24/2024,47180,,,Terminal LS - Efectivo TPV,0,297200,"256637907,38"
04/24/2024,47180,,,Terminal LS - Efectivo TPV,297200,0,"256935107,38"
04/24/2024,47295,,15260,Terminal LS - Efectivo TPV,86588,0,"257021695,38"
04/24/2024,47187,,,Terminal LS - Tarjeta TPV,588612,0,"257590507,37"
04/24/2024,47293,,15240,Terminal LS - Efectivo TPV,"120840,99",0,"257661157,94"
04/25/2024,47472,,15294,Terminal LS - Efectivo TPV,98333,0,"257518182,55"
04/25/2024,47468,,15282,Terminal LS - Efectivo TPV,"218572,99",0,"257736755,54"
04/25/2024,47469,,15285,Terminal LS - Efectivo TPV,"219774,6",0,"257956530,14"
04/25/2024,47471,,15291,Terminal LS - Efectivo TPV,79213,0,"258035743,14"
04/25/2024,47305,,,Terminal LS - Transferencia TPV,587159,0,"258622902,14"
04/25/2024,47296,,,Terminal LS - Efectivo TPV,0,272250,"258350652,14"
04/25/2024,47467,,15275,Terminal LS - Efectivo TPV,90800,0,"258137072,14"
04/25/2024,47466,,15270,Terminal LS - Efectivo TPV,81398,0,"258218470,14"
04/25/2024,47465,,15269,Terminal LS - Efectivo TPV,51000,0,"258269470,14"
04/25/2024,47470,,15290,Terminal LS - Efectivo TPV,80000,0,"258349470,14"
04/25/2024,47464,,15262,Terminal LS - Efectivo TPV,90139,0,"258439609,14"
04/26/2024,47800,,15299,Terminal LS - Efectivo TPV,"88827,99",0,"258528437,13"
04/26/2024,47807,,15339,Terminal LS - Efectivo TPV,93307,0,"258621744,13"
04/26/2024,47802,,15318,Terminal LS - Efectivo TPV,"113643,01",0,"258735387,14"
04/26/2024,47803,,15319,Terminal LS - Efectivo TPV,7000,0,"258742387,14"
04/26/2024,47805,,15324,Terminal LS - Efectivo TPV,20700,0,"258763087,14"
04/26/2024,47480,,,Terminal LS - Tarjeta TPV,923623,0,"259686710,14"
04/26/2024,47473,,,Terminal LS - Efectivo TPV,0,1009300,"258677410,14"
04/26/2024,47798,,15295,Terminal LS - Efectivo TPV,80852,0,"258058262,14"
04/26/2024,47804,,15322,Terminal LS - Efectivo TPV,50000,0,"258108262,14"
04/26/2024,47473,,,Terminal LS - Efectivo TPV,1009300,0,"259117562,14"
04/26/2024,47809,,15350,Terminal LS - Efectivo TPV,"144484,79",0,"259262046,93"
04/26/2024,47801,,15307,Terminal LS - Efectivo TPV,"74951,99",0,"259336998,92"
04/26/2024,47810,,15357,Terminal LS - Efectivo TPV,"98879,99",0,"259435878,91"
04/26/2024,47811,,15358,Terminal LS - Efectivo TPV,"140616,99",0,"259576495,9"
04/26/2024,47808,,15342,Terminal LS - Efectivo TPV,"640914,98",0,"260217410,88"
04/26/2024,47806,,15333,Terminal LS - Efectivo TPV,77902,0,"260295312,88"
04/26/2024,47799,,15296,Terminal LS - Efectivo TPV,4000,0,"260299312,88"
04/27/2024,48310,,15424,Terminal LS - Efectivo TPV,63370,0,"260362682,88"
04/27/2024,48305,,15404,Terminal LS - Efectivo TPV,78503,0,"260441185,88"
04/27/2024,48301,,15375,Terminal LS - Efectivo TPV,65500,0,"260506685,88"
04/27/2024,47824,,,Terminal LS - Tarjeta TPV,1024748,0,"261531433,88"
04/27/2024,48308,,15417,Terminal LS - Efectivo TPV,20000,0,"261551433,88"
04/27/2024,48309,,15421,Terminal LS - Efectivo TPV,81289,0,"261632722,88"
04/27/2024,48300,,15364,Terminal LS - Efectivo TPV,81835,0,"261714557,88"
04/27/2024,48303,,15384,Terminal LS - Efectivo TPV,19300,0,"261733857,88"
04/27/2024,48302,,15380,Terminal LS - Efectivo TPV,70600,0,"261804457,88"
04/27/2024,48304,,15396,Terminal LS - Efectivo TPV,114000,0,"261918457,88"
04/27/2024,47812,,,Terminal LS - Efectivo TPV,1636100,0,"263554557,88"
04/27/2024,48307,,15410,Terminal LS - Efectivo TPV,7320,0,"263561877,88"
04/27/2024,47812,,,Terminal LS - Efectivo TPV,0,1636100,"261925777,88"
04/27/2024,48306,,15406,Terminal LS - Efectivo TPV,54000,0,"261979777,88"
04/28/2024,48311,,,Terminal LS - Efectivo TPV,0,655400,"261324377,88"
04/28/2024,48719,,15520,Terminal LS - Efectivo TPV,"115999,99",0,"261440377,87"
04/28/2024,48714,,15458,Terminal LS - Efectivo TPV,79431,0,"261519808,87"
04/28/2024,48718,,15518,Terminal LS - Efectivo TPV,120950,0,"261640758,87"
04/28/2024,48717,,15516,Terminal LS - Efectivo TPV,"101173,99",0,"261741932,86"
04/28/2024,48716,,15470,Terminal LS - Efectivo TPV,"169550,02",0,"261911482,88"
04/28/2024,48715,,15465,Terminal LS - Efectivo TPV,113000,0,"261924482,88"
04/28/2024,48345,,,Terminal LS - Transferencia TPV,2814837,0,"264739319,88"
04/28/2024,48713,,15447,Terminal LS - Efectivo TPV,"91316,99",0,"264830636,87"
04/29/2024,48755,,,Terminal LS - Transferencia TPV,3676298,0,"268506934,87"
04/29/2024,48720,,,Terminal LS - Efectivo TPV,0,791400,"267715534,87"
04/30/2024,48842,,15534,Terminal LS - Efectivo TPV,"81780,99",0,"267797315,86"
04/30/2024,48844,,15541,Terminal LS - Efectivo TPV,99772,0,"267897087,86"
04/30/2024,48839,,15529,Terminal LS - Efectivo TPV,"118999,99",0,"268016087,85"
04/30/2024,48838,,15528,Terminal LS - Efectivo TPV,183829,0,"268199916,85"
04/30/2024,48835,,15522,Terminal LS - Efectivo TPV,33000,0,"268232916,85"
04/30/2024,48837,,15525,Terminal LS - Efectivo TPV,60420,0,"268293336,85"
04/30/2024,48836,,15523,Terminal LS - Efectivo TPV,84270,0,"268371606,85"
04/30/2024,48840,,15532,Terminal LS - Efectivo TPV,201092,0,"268544698,85"
04/30/2024,48841,,15533,Terminal LS - Efectivo TPV,"59999,99",0,"268604698,84"
04/30/2024,48843,,15536,Terminal LS - Efectivo TPV,120500,0,"268725198,84"
05/01/2024,49316,,15560,Terminal LS - Efectivo TPV,"113629,99",0,"268838828,83"
05/01/2024,49323,,15623,Terminal LS - Efectivo TPV,89429,0,"268913257,83"
05/01/2024,49322,,15622,Terminal LS - Efectivo TPV,5800,0,"268919057,83"
05/01/2024,49321,,15619,Terminal LS - Efectivo TPV,77137,0,"268996194,83"
05/01/2024,49320,,15618,Terminal LS - Efectivo TPV,8500,0,"269004694,83"
05/01/2024,49319,,15612,Terminal LS - Efectivo TPV,105000,0,"269109694,83"
05/01/2024,49318,,15601,Terminal LS - Efectivo TPV,95000,0,"269204694,83"
05/01/2024,49317,,15580,Terminal LS - Efectivo TPV,11600,0,"269216294,83"
05/01/2024,48849,,,Terminal LS - Tarjeta TPV,317836,0,"269534130,83"
05/01/2024,48845,,,Terminal LS - Efectivo TPV,0,1043700,"268490430,83"
05/01/2024,48845,,,Terminal LS - Efectivo TPV,1043700,0,"269534130,83"
05/02/2024,49455,,15647,Terminal LS - Efectivo TPV,142474,0,"269676604,83"
05/02/2024,49324,,,Terminal LS - Efectivo TPV,0,506100,"269056504,81"
05/02/2024,49454,,15641,Terminal LS - Efectivo TPV,"21851,99",0,"269078356,8"
05/02/2024,49456,,15648,Terminal LS - Efectivo TPV,5800,0,"269084156,8"
05/02/2024,49453,,15637,Terminal LS - Efectivo TPV,235000,0,"269319156,8"
05/02/2024,49348,,,Terminal LS - Transferencia TPV,1766067,0,"271065223,48"
05/03/2024,49464,,,Terminal LS - Tarjeta TPV,700295,0,"271724919,16"
05/03/2024,49717,,15667,Terminal LS - Efectivo TPV,152526,0,"271877445,16"
05/03/2024,49718,,15675,Terminal LS - Efectivo TPV,83037,0,"271960482,16"
05/03/2024,49715,,15655,Terminal LS - Efectivo TPV,68178,0,"272028660,16"
05/03/2024,49716,,15660,Terminal LS - Efectivo TPV,78011,0,"272106671,16"
05/03/2024,49719,,15686,Terminal LS - Efectivo TPV,7600,0,"272114271,16"
05/03/2024,49720,,15691,Terminal LS - Efectivo TPV,94728,0,"272208999,16"
05/03/2024,49721,,15696,Terminal LS - Efectivo TPV,"93963,01",0,"272302962,17"
05/03/2024,49457,,,Terminal LS - Efectivo TPV,405150,0,"272708112,17"
05/03/2024,49457,,,Terminal LS - Efectivo TPV,0,405150,"272202776,07"
05/04/2024,50181,,15794,Terminal LS - Efectivo TPV,77574,0,"272280350,07"
05/04/2024,50180,,15786,Terminal LS - Efectivo TPV,174651,0,"272455001,07"
05/04/2024,49722,,,Terminal LS - Efectivo TPV,0,578100,"271876901,07"
05/04/2024,50174,,15758,Terminal LS - Efectivo TPV,69325,0,"271946226,07"
05/04/2024,50167,,15710,Terminal LS - Efectivo TPV,2700,0,"271948926,07"
05/04/2024,50169,,15723,Terminal LS - Efectivo TPV,14000,0,"271962926,07"
05/04/2024,50166,,15707,Terminal LS - Efectivo TPV,26000,0,"271988926,07"
05/04/2024,50176,,15772,Terminal LS - Efectivo TPV,65500,0,"272054426,07"
05/04/2024,49722,,,Terminal LS - Efectivo TPV,578100,0,"272632526,07"
05/04/2024,50172,,15741,Terminal LS - Efectivo TPV,2700,0,"272635226,07"
05/04/2024,50173,,15748,Terminal LS - Efectivo TPV,58000,0,"272602660,07"
05/04/2024,50178,,15779,Terminal LS - Efectivo TPV,92488,0,"272434598,09"
05/04/2024,50182,,15798,Terminal LS - Efectivo TPV,131220,0,"272565818,09"
05/04/2024,50168,,15712,Terminal LS - Efectivo TPV,4000,0,"272569818,09"
05/04/2024,50179,,15780,Terminal LS - Efectivo TPV,110850,0,"272630668,09"
05/04/2024,50171,,15735,Terminal LS - Efectivo TPV,69325,0,"272699993,09"
05/04/2024,50177,,15778,Terminal LS - Efectivo TPV,78448,0,"272738991,09"
05/04/2024,50175,,15767,Terminal LS - Efectivo TPV,"68999,99",0,"272807991,08"
05/04/2024,49714,,,Terminal LS - Tarjeta TPV,1584274,0,"274392265,08"
05/04/2024,50170,,15728,Terminal LS - Efectivo TPV,73531,0,"274465796,08"
05/05/2024,50606,,15861,Terminal LS - Efectivo TPV,95737,0,"274561533,08"
05/05/2024,50609,,15871,Terminal LS - Efectivo TPV,"124227,99",0,"274685761,07"
05/05/2024,50608,,15868,Terminal LS - Efectivo TPV,"106199,99",0,"274791961,06"
05/05/2024,50607,,15865,Terminal LS - Efectivo TPV,"92999,99",0,"274884961,05"
05/05/2024,50605,,15859,Terminal LS - Efectivo TPV,95274,0,"274980235,05"
05/05/2024,50604,,15839,Terminal LS - Efectivo TPV,"91777,99",0,"275072013,04"
05/05/2024,50603,,15837,Terminal LS - Efectivo TPV,"125999,99",0,"275198013,03"
05/05/2024,50601,,15825,Terminal LS - Efectivo TPV,53000,0,"275251013,03"
05/05/2024,50600,,15807,Terminal LS - Efectivo TPV,10000,0,"275261013,03"
05/05/2024,50599,,15800,Terminal LS - Efectivo TPV,4000,0,"275265013,03"
05/05/2024,50188,,,Terminal LS - Tarjeta TPV,394697,0,"275659710,03"
05/05/2024,50183,,,Terminal LS - Efectivo TPV,0,1119400,"274540310,03"
05/05/2024,50183,,,Terminal LS - Efectivo TPV,1119400,0,"275659710,03"
05/05/2024,50602,,15834,Terminal LS - Efectivo TPV,89000,0,"275748710,03"
05/06/2024,50632,,,Terminal LS - Transferencia TPV,2190436,0,"277939146,03"
05/06/2024,50610,,,Terminal LS - Efectivo TPV,0,888250,"277031795,07"
05/07/2024,50701,,15887,Terminal LS - Efectivo TPV,"8166,99",0,"277010262,06"
05/07/2024,50702,,15890,Terminal LS - Efectivo TPV,70500,0,"277080762,06"
05/07/2024,50700,,15886,Terminal LS - Efectivo TPV,"97053,99",0,"277177816,05"
05/07/2024,50699,,15885,Terminal LS - Efectivo TPV,18574,0,"277196390,05"
05/07/2024,50698,,15884,Terminal LS - Efectivo TPV,74132,0,"277270522,05"
05/07/2024,50697,,15880,Terminal LS - Efectivo TPV,"141053,99",0,"277411576,04"
05/07/2024,50696,,15877,Terminal LS - Efectivo TPV,59000,0,"277470576,04"
05/07/2024,50695,,15876,Terminal LS - Efectivo TPV,56300,0,"277526876,04"
05/08/2024,50710,,,Terminal LS - Tarjeta TPV,552077,0,"278045953,15"
05/08/2024,50703,,,Terminal LS - Efectivo TPV,0,524800,"277521153,15"
05/08/2024,50824,,15897,Terminal LS - Efectivo TPV,"131657,01",0,"277552809,78"
05/08/2024,50823,,15896,Terminal LS - Efectivo TPV,85400,0,"277638209,78"
05/08/2024,50703,,,Terminal LS - Efectivo TPV,524800,0,"278163009,78"
05/08/2024,50829,,15910,Terminal LS - Efectivo TPV,61000,0,"278224009,78"
05/08/2024,50826,,15904,Terminal LS - Efectivo TPV,"309313,02",0,"278533322,8"
05/08/2024,50830,,15913,Terminal LS - Efectivo TPV,51850,0,"278585172,8"
05/08/2024,50831,,15921,Terminal LS - Efectivo TPV,64000,0,"278649172,8"
05/08/2024,50827,,15907,Terminal LS - Efectivo TPV,"68000,01",0,"278717172,81"
05/08/2024,50825,,15902,Terminal LS - Efectivo TPV,87189,0,"278804361,81"
05/08/2024,50828,,15909,Terminal LS - Efectivo TPV,54000,0,"278858361,81"
05/09/2024,51048,,15924,Terminal LS - Efectivo TPV,59850,0,"278918211,81"
05/09/2024,50832,,,Terminal LS - Efectivo TPV,0,912500,"278005711,81"
05/09/2024,50850,,,Terminal LS - Transferencia TPV,1234679,0,"279225390,81"
05/09/2024,51058,,15966,Terminal LS - Efectivo TPV,"57954,01",0,"279276444,82"
05/09/2024,51057,,15964,Terminal LS - Efectivo TPV,105818,0,"279382262,82"
05/09/2024,51056,,15957,Terminal LS - Efectivo TPV,35509,0,"279417771,82"
05/09/2024,51054,,15947,Terminal LS - Efectivo TPV,13985,0,"279431756,82"
05/09/2024,51053,,15945,Terminal LS - Efectivo TPV,84130,0,"279515886,82"
05/09/2024,51052,,15939,Terminal LS - Efectivo TPV,"57850,01",0,"279573736,83"
05/09/2024,51051,,15937,Terminal LS - Efectivo TPV,18902,0,"279592638,83"
05/09/2024,51050,,15926,Terminal LS - Efectivo TPV,119000,0,"279711638,83"
05/09/2024,51049,,15925,Terminal LS - Efectivo TPV,2800,0,"279714438,83"
05/09/2024,51055,,15949,Terminal LS - Efectivo TPV,252,0,"279675210,83"
05/10/2024,51299,,16016,Terminal LS - Efectivo TPV,10160,0,"279685370,83"
05/10/2024,51297,,16000,Terminal LS - Efectivo TPV,31546,0,"279716916,83"
05/10/2024,51059,,,Terminal LS - Efectivo TPV,0,556100,"279160816,83"
05/10/2024,51089,,,Terminal LS - Transferencia TPV,1921133,0,"281081949,83"
05/10/2024,51301,,16018,Terminal LS - Efectivo TPV,"99753,99",0,"281181703,82"
05/10/2024,51298,,16006,Terminal LS - Efectivo TPV,110000,0,"281291703,82"
05/10/2024,51069,,,Terminal LS - Tarjeta TPV,782018,0,"282073721,82"
05/10/2024,51293,,15973,Terminal LS - Efectivo TPV,142474,0,"282216195,82"
05/10/2024,51294,,15976,Terminal LS - Efectivo TPV,77700,0,"282293895,82"
05/10/2024,51295,,15982,Terminal LS - Efectivo TPV,4000,0,"282297895,82"
05/10/2024,51296,,15990,Terminal LS - Efectivo TPV,71700,0,"282229695,82"
05/10/2024,51300,,16017,Terminal LS - Efectivo TPV,"103905,99",0,"282333601,81"
05/11/2024,51302,,,Terminal LS - Efectivo TPV,651250,0,"282984851,81"
05/11/2024,51874,,16108,Terminal LS - Efectivo TPV,147000,0,"283131851,81"
05/11/2024,51862,,16021,Terminal LS - Efectivo TPV,51850,0,"283183701,81"
05/11/2024,51865,,16042,Terminal LS - Efectivo TPV,10000,0,"283193701,81"
05/11/2024,51316,,,Terminal LS - Tarjeta TPV,1184243,0,"284377944,81"
05/11/2024,51870,,16081,Terminal LS - Efectivo TPV,123839,0,"284501783,81"
05/11/2024,51863,,16037,Terminal LS - Efectivo TPV,105000,0,"284606783,81"
05/11/2024,51872,,16102,Terminal LS - Efectivo TPV,74132,0,"284680915,81"
05/11/2024,51868,,16058,Terminal LS - Efectivo TPV,122480,0,"284803395,81"
05/11/2024,51873,,16106,Terminal LS - Efectivo TPV,61513,0,"284864908,81"
05/11/2024,51864,,16038,Terminal LS - Efectivo TPV,105763,0,"284970671,81"
05/11/2024,51871,,16088,Terminal LS - Efectivo TPV,205000,0,"285175671,81"
05/11/2024,51875,,16114,Terminal LS - Efectivo TPV,4000,0,"285179671,81"
05/11/2024,51302,,,Terminal LS - Efectivo TPV,0,651250,"284478421,81"
05/11/2024,51866,,16049,Terminal LS - Efectivo TPV,101119,0,"284579540,81"
05/11/2024,51869,,16067,Terminal LS - Efectivo TPV,"151870,01",0,"284731410,82"
05/11/2024,51867,,16057,Terminal LS - Efectivo TPV,113850,0,"284845260,82"
05/12/2024,52346,,16119,Terminal LS - Efectivo TPV,97000,0,"284942260,82"
05/12/2024,52347,,16130,Terminal LS - Efectivo TPV,275000,0,"285217260,82"
05/12/2024,52351,,16185,Terminal LS - Efectivo TPV,53000,0,"285211725,24"
05/12/2024,51876,,,Terminal LS - Efectivo TPV,0,1377500,"283834225,24"
05/12/2024,51920,,,Terminal LS - Transferencia TPV,2195131,0,"286029356,24"
05/12/2024,52350,,16175,Terminal LS - Efectivo TPV,4000,0,"286009356,24"
05/12/2024,52349,,16165,Terminal LS - Efectivo TPV,97787,0,"286107143,24"
05/12/2024,52348,,16149,Terminal LS - Efectivo TPV,7600,0,"286114743,24"
05/13/2024,52777,,16239,Terminal LS - Efectivo TPV,57650,0,"286172393,24"
05/13/2024,52778,,16242,Terminal LS - Efectivo TPV,83365,0,"286255758,24"
05/13/2024,52779,,16250,Terminal LS - Efectivo TPV,79000,0,"286334758,24"
05/13/2024,52780,,16254,Terminal LS - Efectivo TPV,82491,0,"286417249,24"
05/13/2024,52781,,16255,Terminal LS - Efectivo TPV,90139,0,"286507388,24"
05/13/2024,52782,,16271,Terminal LS - Efectivo TPV,91231,0,"286598619,24"
05/13/2024,52352,,,Terminal LS - Efectivo TPV,0,534400,"286064219,24"
05/13/2024,52783,,16272,Terminal LS - Efectivo TPV,"233599,99",0,"286297819,23"
05/13/2024,52784,,16276,Terminal LS - Efectivo TPV,153837,0,"286451656,23"
05/13/2024,52785,,16281,Terminal LS - Efectivo TPV,"91877,99",0,"286543534,22"
05/13/2024,52352,,,Terminal LS - Efectivo TPV,534400,0,"287077934,22"
05/13/2024,52774,,16192,Terminal LS - Efectivo TPV,"5599,99",0,"287083534,21"
05/13/2024,52775,,16211,Terminal LS - Efectivo TPV,78066,0,"287161600,21"
05/13/2024,52776,,16236,Terminal LS - Efectivo TPV,"81398,01",0,"287242998,22"
05/13/2024,52358,,,Terminal LS - Tarjeta TPV,612694,0,"287855692,22"
05/14/2024,52786,,,Terminal LS - Efectivo TPV,0,1128600,"286727092,22"
05/14/2024,52802,,,Terminal LS - Transferencia TPV,1024338,0,"287751430,22"
05/14/2024,52972,,16299,Terminal LS - Efectivo TPV,"129550,01",0,"287880980,23"
05/14/2024,52973,,16302,Terminal LS - Efectivo TPV,61000,0,"287941980,23"
05/14/2024,52971,,16293,Terminal LS - Efectivo TPV,61185,0,"288003165,23"
05/14/2024,52970,,16291,Terminal LS - Efectivo TPV,5800,0,"288008965,23"
05/15/2024,53175,,16326,Terminal LS - Efectivo TPV,76600,0,"288085565,23"
05/15/2024,52974,,,Terminal LS - Efectivo TPV,257550,0,"288343115,23"
05/15/2024,52974,,,Terminal LS - Efectivo TPV,0,257550,"288085565,23"
05/15/2024,52984,,,Terminal LS - Tarjeta TPV,1143513,0,"289229078,23"
05/15/2024,53177,,16341,Terminal LS - Efectivo TPV,85659,0,"289314737,23"
05/15/2024,53174,,16325,Terminal LS - Efectivo TPV,151915,0,"289466652,23"
05/15/2024,53172,,16309,Terminal LS - Efectivo TPV,62451,0,"289529103,23"
05/15/2024,53173,,16316,Terminal LS - Efectivo TPV,147500,0,"289676603,23"
05/15/2024,53176,,16331,Terminal LS - Efectivo TPV,76318,0,"289752921,23"
05/16/2024,53363,,16348,Terminal LS - Efectivo TPV,15300,0,"289768221,23"
05/16/2024,53195,,,Terminal LS - Transferencia TPV,1474191,0,"291242412,23"
05/16/2024,53178,,,Terminal LS - Efectivo TPV,0,600600,"290641812,23"
05/16/2024,53367,,16374,Terminal LS - Efectivo TPV,147937,0,"290789749,23"
05/16/2024,53368,,16376,Terminal LS - Efectivo TPV,145479,0,"290935228,23"
05/16/2024,53370,,16380,Terminal LS - Efectivo TPV,137000,0,"291072228,23"
05/16/2024,53369,,16377,Terminal LS - Efectivo TPV,313028,0,"291385256,23"
05/16/2024,53361,,16345,Terminal LS - Efectivo TPV,205500,0,"291590756,23"
05/16/2024,53362,,16346,Terminal LS - Efectivo TPV,69926,0,"291660682,23"
05/16/2024,53364,,16350,Terminal LS - Efectivo TPV,65500,0,"291726182,23"
05/16/2024,53365,,16357,Terminal LS - Efectivo TPV,64000,0,"291790182,23"
05/16/2024,53366,,16364,Terminal LS - Efectivo TPV,51850,0,"291842032,23"
05/17/2024,53747,,16437,Terminal LS - Efectivo TPV,"232066,98",0,"292074099,21"
05/17/2024,53371,,,Terminal LS - Efectivo TPV,0,1215600,"290858499,21"
05/17/2024,53746,,16411,Terminal LS - Efectivo TPV,"92105,99",0,"290950605,2"
05/17/2024,53745,,16400,Terminal LS - Efectivo TPV,"90466,99",0,"291041072,19"
05/17/2024,53388,,,Terminal LS - Transferencia TPV,1087272,0,"292128344,19"
05/17/2024,53743,,16390,Terminal LS - Efectivo TPV,"243648,01",0,"292371992,2"
05/17/2024,53742,,16389,Terminal LS - Efectivo TPV,"489099,99",0,"292861092,19"
05/17/2024,53744,,16396,Terminal LS - Efectivo TPV,83583,0,"292944675,19"
05/18/2024,54270,,16535,Terminal LS - Efectivo TPV,141650,0,"293086325,19"
05/18/2024,54264,,16471,Terminal LS - Efectivo TPV,4000,0,"293090325,19"
05/18/2024,54265,,16473,Terminal LS - Efectivo TPV,132750,0,"293223075,19"
05/18/2024,54271,,16540,Terminal LS - Efectivo TPV,68771,0,"293291846,19"
05/18/2024,54272,,16541,Terminal LS - Efectivo TPV,81726,0,"293373572,19"
05/18/2024,54273,,16545,Terminal LS - Efectivo TPV,77620,0,"293451192,19"
05/18/2024,54268,,16533,Terminal LS - Efectivo TPV,218245,0,"293669437,19"
05/18/2024,54269,,16534,Terminal LS - Efectivo TPV,188855,0,"293858292,19"
05/18/2024,54267,,16518,Terminal LS - Efectivo TPV,44704,0,"293902996,19"
05/18/2024,53761,,,Terminal LS - Tarjeta TPV,1210156,0,"295113152,19"
05/18/2024,54263,,16455,Terminal LS - Efectivo TPV,8000,0,"295121152,19"
05/18/2024,54266,,16517,Terminal LS - Efectivo TPV,"63499,99",0,"295184652,18"
05/18/2024,53748,,,Terminal LS - Efectivo TPV,0,1231050,"293953602,18"
05/18/2024,53748,,,Terminal LS - Efectivo TPV,1231050,0,"295184652,18"
05/19/2024,54730,,16616,Terminal LS - Efectivo TPV,"94836,99",0,"295279489,17"
05/19/2024,54274,,,Terminal LS - Efectivo TPV,1029850,0,"296309339,17"
05/19/2024,54723,,16555,Terminal LS - Efectivo TPV,2800,0,"296312139,17"
05/19/2024,54722,,16549,Terminal LS - Efectivo TPV,51850,0,"296363989,17"
05/19/2024,54729,,16614,Terminal LS - Efectivo TPV,"175850,01",0,"296539839,18"
05/19/2024,54728,,16613,Terminal LS - Efectivo TPV,66500,0,"296606339,18"
05/19/2024,54727,,16600,Terminal LS - Efectivo TPV,118000,0,"296724339,18"
05/19/2024,54726,,16596,Terminal LS - Efectivo TPV,"129035,01",0,"296853374,19"
05/19/2024,54725,,16587,Terminal LS - Efectivo TPV,61500,0,"296914874,19"
05/19/2024,54724,,16571,Terminal LS - Efectivo TPV,140500,0,"297055374,19"
05/19/2024,54274,,,Terminal LS - Efectivo TPV,0,1029850,"296025524,19"
05/19/2024,54731,,16627,Terminal LS - Efectivo TPV,42400,0,"296067924,19"
05/19/2024,54295,,,Terminal LS - Tarjeta TPV,2094987,0,"298162911,19"
05/20/2024,54732,,,Terminal LS - Efectivo TPV,0,883300,"297279611,19"
05/20/2024,54744,,,Terminal LS - Tarjeta TPV,1295706,0,"298575317,19"
05/20/2024,54732,,,Terminal LS - Efectivo TPV,883300,0,"299458617,19"
05/21/2024,54820,,16644,Terminal LS - Efectivo TPV,79541,0,"299538158,19"
05/21/2024,54819,,16642,Terminal LS - Efectivo TPV,70472,0,"299608630,19"
05/21/2024,54818,,16639,Terminal LS - Efectivo TPV,"137666,99",0,"299746297,18"
05/21/2024,54817,,16631,Terminal LS - Efectivo TPV,89210,0,"299835507,18"
05/22/2024,55055,,16649,Terminal LS - Efectivo TPV,2800,0,"299838307,18"
05/22/2024,55062,,16678,Terminal LS - Efectivo TPV,127950,0,"299966257,18"
05/22/2024,55061,,16676,Terminal LS - Efectivo TPV,"61999,99",0,"300028257,17"
05/22/2024,55060,,16674,Terminal LS - Efectivo TPV,81507,0,"300109764,17"
05/22/2024,55059,,16672,Terminal LS - Efectivo TPV,20552,0,"300130316,17"
05/22/2024,55058,,16659,Terminal LS - Efectivo TPV,"192949,99",0,"300323266,16"
05/22/2024,55057,,16658,Terminal LS - Efectivo TPV,51850,0,"300375116,16"
05/22/2024,54821,,,Terminal LS - Efectivo TPV,376900,0,"300752016,16"
05/22/2024,54826,,,Terminal LS - Tarjeta TPV,432291,0,"301184307,16"
05/22/2024,55054,,16645,Terminal LS - Efectivo TPV,11200,0,"301195507,16"
05/22/2024,55056,,16654,Terminal LS - Efectivo TPV,79500,0,"301275007,16"
05/22/2024,54821,,,Terminal LS - Efectivo TPV,0,376900,"300898107,16"
05/23/2024,55250,,16703,Terminal LS - Efectivo TPV,77902,0,"300976009,16"
05/23/2024,55068,,,Terminal LS - Tarjeta TPV,534204,0,"301510213,16"
05/23/2024,55063,,,Terminal LS - Efectivo TPV,0,630350,"300879863,16"
05/23/2024,55063,,,Terminal LS - Efectivo TPV,630350,0,"301510213,16"
05/23/2024,55256,,16727,Terminal LS - Efectivo TPV,4000,0,"301514213,16"
05/23/2024,55255,,16716,Terminal LS - Efectivo TPV,80306,0,"301594519,16"
05/23/2024,55254,,16711,Terminal LS - Efectivo TPV,104561,0,"301699080,16"
05/23/2024,55253,,16709,Terminal LS - Efectivo TPV,123463,0,"301822543,16"
05/23/2024,55252,,16707,Terminal LS - Efectivo TPV,68850,0,"301891393,16"
05/23/2024,55251,,16704,Terminal LS - Efectivo TPV,5400,0,"301896793,16"
05/23/2024,55249,,16698,Terminal LS - Efectivo TPV,51850,0,"301948643,16"
05/23/2024,55248,,16695,Terminal LS - Efectivo TPV,138300,0,"302086943,16"
05/23/2024,55247,,16693,Terminal LS - Efectivo TPV,"76999,99",0,"302163943,15"
05/23/2024,55246,,16687,Terminal LS - Efectivo TPV,123299,0,"302287242,15"
05/24/2024,55279,,,Terminal LS - Transferencia TPV,1290890,0,"303578132,15"
05/24/2024,55605,,16763,Terminal LS - Efectivo TPV,"206850,01",0,"303784982,16"
05/24/2024,55608,,16777,Terminal LS - Efectivo TPV,5800,0,"303790782,16"
05/24/2024,55610,,16792,Terminal LS - Efectivo TPV,"88827,99",0,"303879610,15"
05/24/2024,55613,,16806,Terminal LS - Efectivo TPV,10200,0,"303889810,15"
05/24/2024,55606,,16767,Terminal LS - Efectivo TPV,12700,0,"303902510,15"
05/24/2024,55611,,16795,Terminal LS - Efectivo TPV,"100955,99",0,"304003466,14"
05/24/2024,55612,,16797,Terminal LS - Efectivo TPV,172302,0,"304175768,14"
05/24/2024,55614,,16811,Terminal LS - Efectivo TPV,205000,0,"304380768,14"
05/24/2024,55602,,16754,Terminal LS - Efectivo TPV,"58499,99",0,"304439268,13"
05/24/2024,55609,,16785,Terminal LS - Efectivo TPV,"121823,99",0,"304561092,12"
05/24/2024,55257,,,Terminal LS - Efectivo TPV,0,855050,"303706042,12"
05/24/2024,55607,,16775,Terminal LS - Efectivo TPV,75225,0,"303781267,12"
05/24/2024,55604,,16756,Terminal LS - Efectivo TPV,"124000,01",0,"303905267,13"
05/24/2024,55603,,16755,Terminal LS - Efectivo TPV,74000,0,"303979267,13"
05/25/2024,56048,,16886,Terminal LS - Efectivo TPV,38500,0,"304017767,13"
05/25/2024,55666,,,Terminal LS - Transferencia TPV,3193444,0,"307211211,13"
05/25/2024,56046,,16862,Terminal LS - Efectivo TPV,68833,0,"307280044,13"
05/25/2024,56045,,16846,Terminal LS - Efectivo TPV,27964,0,"307308008,13"
05/25/2024,56044,,16817,Terminal LS - Efectivo TPV,51850,0,"307359858,13"
05/25/2024,56049,,16893,Terminal LS - Efectivo TPV,"76754,99",0,"307436613,12"
05/25/2024,56050,,16896,Terminal LS - Efectivo TPV,103850,0,"307540463,12"
05/25/2024,56052,,16900,Terminal LS - Efectivo TPV,34500,0,"307574963,12"
05/25/2024,56051,,16898,Terminal LS - Efectivo TPV,80906,0,"307655869,12"
05/25/2024,56047,,16875,Terminal LS - Efectivo TPV,51850,0,"307707719,12"
05/25/2024,55615,,,Terminal LS - Efectivo TPV,0,1256750,"306450969,12"
05/26/2024,56456,,16909,Terminal LS - Efectivo TPV,62988,0,"306513957,12"
05/26/2024,56462,,16976,Terminal LS - Efectivo TPV,"82499,99",0,"306596457,11"
05/26/2024,56461,,16974,Terminal LS - Efectivo TPV,"64500,01",0,"306660957,12"
05/26/2024,56459,,16955,Terminal LS - Efectivo TPV,"103468,98",0,"306764426,1"
05/26/2024,56458,,16953,Terminal LS - Efectivo TPV,"73000,01",0,"306837426,11"
05/26/2024,56457,,16943,Terminal LS - Efectivo TPV,88500,0,"306925926,11"
05/26/2024,56067,,,Terminal LS - Tarjeta TPV,1406147,0,"308332073,11"
05/26/2024,56460,,16960,Terminal LS - Efectivo TPV,81781,0,"308413854,11"
05/26/2024,56053,,,Terminal LS - Efectivo TPV,535100,0,"308948954,11"
05/26/2024,56053,,,Terminal LS - Efectivo TPV,0,535100,"308413854,11"
05/27/2024,56463,,,Terminal LS - Efectivo TPV,0,556800,"307857054,11"
05/27/2024,56484,,,Terminal LS - Transferencia TPV,1436861,0,"309293915,11"
05/28/2024,56569,,16986,Terminal LS - Efectivo TPV,35606,0,"309329521,11"
05/29/2024,56641,,16999,Terminal LS - Efectivo TPV,4000,0,"309333521,11"
05/29/2024,56570,,,Terminal LS - Efectivo TPV,0,35700,"309297821,11"
05/29/2024,56570,,,Terminal LS - Efectivo TPV,35700,0,"309333521,11"
05/29/2024,56574,,,Terminal LS - Tarjeta TPV,111766,0,"309445287,11"
05/29/2024,56643,,17004,Terminal LS - Efectivo TPV,72000,0,"309517287,11"
05/29/2024,56642,,17003,Terminal LS - Efectivo TPV,"99999,98",0,"309617287,09"
05/29/2024,56640,,16989,Terminal LS - Efectivo TPV,"54999,99",0,"309672287,08"
05/30/2024,56907,,17048,Terminal LS - Efectivo TPV,"31999,99",0,"309704287,07"
05/30/2024,56896,,17007,Terminal LS - Efectivo TPV,66648,0,"309770935,07"
05/30/2024,56906,,17040,Terminal LS - Efectivo TPV,65500,0,"309836435,07"
05/30/2024,56897,,17019,Terminal LS - Efectivo TPV,7500,0,"309843935,07"
05/30/2024,56898,,17021,Terminal LS - Efectivo TPV,2700,0,"309846635,07"
05/30/2024,56899,,17024,Terminal LS - Efectivo TPV,52500,0,"309899135,07"
05/30/2024,56900,,17027,Terminal LS - Efectivo TPV,81000,0,"309980135,07"
05/30/2024,56901,,17028,Terminal LS - Efectivo TPV,58000,0,"310038135,07"
05/30/2024,56902,,17033,Terminal LS - Efectivo TPV,"131767,01",0,"310169902,08"
05/30/2024,56644,,,Terminal LS - Efectivo TPV,0,231000,"309938902,08"
05/30/2024,56653,,,Terminal LS - Transferencia TPV,294357,0,"310233259,08"
05/30/2024,56903,,17035,Terminal LS - Efectivo TPV,97459,0,"310330718,08"
05/30/2024,56904,,17036,Terminal LS - Efectivo TPV,59800,0,"310390518,08"
05/30/2024,56905,,17039,Terminal LS - Efectivo TPV,88828,0,"310479346,08"
05/30/2024,56908,,17061,Terminal LS - Efectivo TPV,81507,0,"310560853,08"
05/31/2024,57416,,17130,Terminal LS - Efectivo TPV,98000,0,"310658853,08"
05/31/2024,57414,,17123,Terminal LS - Efectivo TPV,51850,0,"310710703,08"
05/31/2024,57412,,17097,Terminal LS - Efectivo TPV,"78065,99",0,"310788769,07"
05/31/2024,57417,,17154,Terminal LS - Efectivo TPV,"197104,01",0,"310985873,08"
05/31/2024,57420,,17164,Terminal LS - Efectivo TPV,4000,0,"310989873,08"
05/31/2024,57407,,17068,Terminal LS - Efectivo TPV,5800,0,"310995673,08"
05/31/2024,57409,,17083,Terminal LS - Efectivo TPV,64463,0,"311060136,08"
05/31/2024,57415,,17129,Terminal LS - Efectivo TPV,78667,0,"311138803,08"
05/31/2024,57419,,17162,Terminal LS - Efectivo TPV,65600,0,"311204403,08"
05/31/2024,57418,,17155,Terminal LS - Efectivo TPV,16500,0,"311220903,08"
05/31/2024,56944,,,Terminal LS - Transferencia TPV,2161846,0,"313382749,08"
05/31/2024,57411,,17087,Terminal LS - Efectivo TPV,116000,0,"313498749,08"
05/31/2024,57413,,17110,Terminal LS - Efectivo TPV,71400,0,"313570149,08"
05/31/2024,57408,,17080,Terminal LS - Efectivo TPV,50041,0,"313620190,08"
05/31/2024,56909,,,Terminal LS - Efectivo TPV,0,825400,"312794790,08"
05/31/2024,57410,,17086,Terminal LS - Efectivo TPV,"63499,99",0,"312858290,07"
