FECHA,N° DOC,TERCERO,DESCRIPCIÓN,ORIGEN,DEBITO,CREDITO,SALDO
01/04/2024,12187,,9200,Terminal SE - Transferencia TPV,27400,0,-2949812
01/04/2024,12203,,9230,Terminal SE - Transferencia TPV,"154990,01",0,"-2794821,99"
01/04/2024,12204,,9238,Terminal SE - Transferencia TPV,"198439,99",0,-2596382
01/04/2024,12186,,9200,Terminal SE - Transferencia TPV,73500,0,-2522882
01/04/2024,12184,,9197,Terminal SE - Transferencia TPV,230450,0,-2292432
01/04/2024,12190,,9203,Terminal SE - Transferencia TPV,"129689,99",0,"-2162742,01"
01/04/2024,12191,,9204,Terminal SE - Transferencia TPV,38250,0,"-2124492,01"
01/04/2024,12192,,9208,Terminal SE - Transferencia TPV,196500,0,"-1927992,01"
01/04/2024,12193,,9210,Terminal SE - Transferencia TPV,"79046,01",0,-1848946
01/04/2024,12194,,9211,Terminal SE - Transferencia TPV,60350,0,-1788596
01/04/2024,12196,,9213,Terminal SE - Transferencia TPV,"142999,99",0,"-1645596,01"
01/04/2024,12205,,9246,Terminal SE - Transferencia TPV,94600,0,"-2192546,01"
01/04/2024,12206,,9247,Terminal SE - Transferencia TPV,118800,0,"-2073746,01"
01/04/2024,12195,,9212,Terminal SE - Transferencia TPV,"46500,01",0,-2027246
01/04/2024,12201,,9223,Terminal SE - Transferencia TPV,"76500,01",0,"-1950745,99"
01/04/2024,12207,,9248,Terminal SE - Transferencia TPV,95260,0,"-1855485,99"
01/04/2024,12198,,9218,Terminal SE - Transferencia TPV,55000,0,"-1800485,99"
01/04/2024,12189,,9202,Terminal SE - Transferencia TPV,"93000,01",0,"-1707485,98"
01/04/2024,12200,,9222,Terminal SE - Transferencia TPV,"105890,01",0,"-1601595,97"
01/04/2024,12188,,9201,Terminal SE - Transferencia TPV,64700,0,"-1536895,97"
01/04/2024,12197,,9217,Terminal SE - Transferencia TPV,"190960,01",0,"-1345935,96"
01/04/2024,12185,,9199,Terminal SE - Transferencia TPV,135300,0,"-1210635,96"
01/04/2024,12208,,9250,Terminal SE - Transferencia TPV,248000,0,"-1133835,96"
01/04/2024,12209,,9254,Terminal SE - Transferencia TPV,98560,0,"-1035275,96"
01/04/2024,12202,,9225,Terminal SE - Transferencia TPV,38000,0,"-1431075,96"
01/04/2024,12199,,9219,Terminal SE - Transferencia TPV,"102000,01",0,"-1329075,95"
01/05/2024,12706,,9306,Terminal SE - Transferencia TPV,"79199,99",0,"-1249875,96"
01/05/2024,12707,,9313,Terminal SE - Transferencia TPV,"134327,01",0,"-1115548,95"
01/05/2024,12708,,9314,Terminal SE - Transferencia TPV,115940,0,"-999608,95"
01/05/2024,12210,,,Terminal SE - Transferencia TPV,2894779,0,"1895170,05"
01/05/2024,12695,,9272,Terminal SE - Transferencia TPV,"84810,01",0,"1979980,06"
01/05/2024,12692,,9267,Terminal SE - Transferencia TPV,"96250,02",0,"2076230,08"
01/05/2024,12693,,9269,Terminal SE - Transferencia TPV,"132880,01",0,"2209110,09"
01/05/2024,12802,,9315,Terminal LS - Tarjeta TPV,"167529,99",0,"2376640,08"
01/05/2024,12811,,9281,Terminal LS - Transferencia TPV,56000,0,"2432640,08"
01/05/2024,12812,,9282,Terminal LS - Transferencia TPV,"57080,84",0,"2489720,92"
01/05/2024,12791,,9349,Terminal LS - Efectivo TPV,"112200,01",0,"2601920,93"
01/05/2024,12808,,9359,Terminal LS - Tarjeta TPV,181600,0,"2783520,93"
01/05/2024,12794,,9357,Terminal LS - Efectivo TPV,67100,0,"2850620,93"
01/05/2024,12210,,,Terminal SE - Transferencia TPV,0,2894779,"-44158,07"
01/05/2024,12709,,9317,Terminal SE - Transferencia TPV,"71499,99",0,"27341,92"
01/05/2024,12716,,9339,Terminal SE - Transferencia TPV,45876,0,"73217,92"
01/05/2024,12717,,9345,Terminal SE - Transferencia TPV,84700,0,"157917,92"
01/05/2024,12718,,9346,Terminal SE - Transferencia TPV,"162250,01",0,"320167,93"
01/05/2024,12793,,9356,Terminal LS - Efectivo TPV,76450,0,"396617,93"
01/05/2024,12714,,9334,Terminal SE - Transferencia TPV,89100,0,"485717,93"
01/05/2024,12713,,9331,Terminal SE - Transferencia TPV,74184,0,"559901,93"
01/05/2024,12712,,9328,Terminal SE - Transferencia TPV,39500,0,"599401,93"
01/05/2024,12711,,9327,Terminal SE - Transferencia TPV,"152680,01",0,"752081,94"
01/05/2024,12710,,9319,Terminal SE - Transferencia TPV,"172000,02",0,"924081,96"
01/05/2024,12691,,9265,Terminal SE - Transferencia TPV,"75999,99",0,"1000081,95"
01/05/2024,12690,,9264,Terminal SE - Transferencia TPV,138000,0,"1138081,95"
01/05/2024,12694,,9271,Terminal SE - Transferencia TPV,62000,0,"1200081,95"
01/05/2024,12715,,9335,Terminal SE - Transferencia TPV,"164000,01",0,"1364081,96"
01/05/2024,12803,,9321,Terminal LS - Tarjeta TPV,"35849,99",0,"1399931,95"
01/05/2024,12800,,9309,Terminal LS - Tarjeta TPV,112200,0,"1512131,95"
01/05/2024,12801,,9310,Terminal LS - Tarjeta TPV,"70000,01",0,"1582131,96"
01/05/2024,12805,,9340,Terminal LS - Tarjeta TPV,"130899,99",0,"1713031,95"
01/05/2024,12807,,9354,Terminal LS - Tarjeta TPV,"125950,01",0,"1838981,96"
01/05/2024,12798,,9291,Terminal LS - Tarjeta TPV,9500,0,"1848481,96"
01/05/2024,12804,,9322,Terminal LS - Tarjeta TPV,79596,0,"1928077,96"
01/05/2024,12795,,9358,Terminal LS - Efectivo TPV,88550,0,"2016627,96"
01/05/2024,12792,,9350,Terminal LS - Efectivo TPV,79200,0,"2095827,96"
01/05/2024,12799,,9307,Terminal LS - Tarjeta TPV,"57199,99",0,"2153027,95"
01/05/2024,12813,,9283,Terminal LS - Transferencia TPV,"79750,01",0,"2232777,96"
01/05/2024,12810,,9266,Terminal LS - Transferencia TPV,71500,0,"1840877,96"
01/05/2024,12797,,9268,Terminal LS - Tarjeta TPV,375999,0,"2216876,96"
01/05/2024,12806,,9353,Terminal LS - Tarjeta TPV,152900,0,"2369776,96"
01/05/2024,12696,,9273,Terminal SE - Transferencia TPV,"128700,01",0,"2498476,97"
01/05/2024,12697,,9274,Terminal SE - Transferencia TPV,"69300,01",0,"2567776,98"
01/05/2024,12698,,9278,Terminal SE - Transferencia TPV,59400,0,"2627176,98"
01/05/2024,12699,,9292,Terminal SE - Transferencia TPV,43000,0,"2670176,98"
01/05/2024,12700,,9293,Terminal SE - Transferencia TPV,"53000,01",0,"2723176,99"
01/05/2024,12701,,9294,Terminal SE - Transferencia TPV,112000,0,"2835176,99"
01/05/2024,12702,,9297,Terminal SE - Transferencia TPV,96000,0,"2931176,99"
01/05/2024,12703,,9300,Terminal SE - Transferencia TPV,"140249,99",0,"3071426,98"
01/05/2024,12704,,9303,Terminal SE - Transferencia TPV,55000,0,"3126426,98"
01/05/2024,12705,,9305,Terminal SE - Transferencia TPV,81510,0,"3207936,98"
01/06/2024,13474,,9404,Terminal SE - Transferencia TPV,"51000,01",0,"3258936,99"
01/06/2024,12796,,,Terminal LS - Efectivo TPV,1460350,0,"4543174,99"
01/06/2024,12809,,,Terminal LS - Tarjeta TPV,1499221,0,"6042395,99"
01/06/2024,12796,,,Terminal LS - Efectivo TPV,0,1460350,"4582045,99"
01/06/2024,13499,,9469,Terminal SE - Transferencia TPV,123618,0,"4705663,99"
01/06/2024,13481,,9419,Terminal SE - Transferencia TPV,"242549,98",0,"4948213,97"
01/06/2024,13489,,9445,Terminal SE - Transferencia TPV,51000,0,"4999213,97"
01/06/2024,13470,,9392,Terminal SE - Transferencia TPV,"132000,01",0,"5131213,98"
01/06/2024,13483,,9421,Terminal SE - Transferencia TPV,"88000,02",0,5219214
01/06/2024,13468,,9388,Terminal SE - Transferencia TPV,"179410,01",0,"5398624,01"
01/06/2024,12719,,,Terminal SE - Transferencia TPV,0,2813355,"2585269,01"
01/06/2024,12719,,,Terminal SE - Transferencia TPV,2813355,0,"5398624,01"
01/06/2024,13472,,9402,Terminal SE - Transferencia TPV,56000,0,"5454624,01"
01/06/2024,13459,,9368,Terminal SE - Transferencia TPV,128700,0,"5583324,01"
01/06/2024,13466,,9383,Terminal SE - Transferencia TPV,56000,0,"5639324,01"
01/06/2024,13492,,9449,Terminal SE - Transferencia TPV,95000,0,"5734324,01"
01/06/2024,13496,,9466,Terminal SE - Transferencia TPV,"151800,01",0,"5886124,02"
01/06/2024,13463,,9377,Terminal SE - Transferencia TPV,69630,0,"5955754,02"
01/06/2024,13462,,9375,Terminal SE - Transferencia TPV,"107334,02",0,"6063088,04"
01/06/2024,13490,,9447,Terminal SE - Transferencia TPV,"54999,99",0,"6118088,03"
01/06/2024,13494,,9464,Terminal SE - Transferencia TPV,157300,0,"6275388,03"
01/06/2024,13506,,9481,Terminal SE - Transferencia TPV,77976,0,"6353364,03"
01/06/2024,13479,,9417,Terminal SE - Transferencia TPV,204996,0,"6558360,03"
01/06/2024,13473,,9403,Terminal SE - Transferencia TPV,"162000,02",0,"6720360,05"
01/06/2024,13502,,9474,Terminal SE - Transferencia TPV,163900,0,"6884260,05"
01/06/2024,13497,,9467,Terminal SE - Transferencia TPV,61380,0,"6945640,05"
01/06/2024,13465,,9382,Terminal SE - Transferencia TPV,74000,0,"7019640,05"
01/06/2024,13491,,9448,Terminal SE - Transferencia TPV,52000,0,"7071640,05"
01/06/2024,13493,,9462,Terminal SE - Transferencia TPV,126060,0,"7197700,05"
01/06/2024,13486,,9429,Terminal SE - Transferencia TPV,"94534,02",0,"7292234,07"
01/06/2024,13478,,9412,Terminal SE - Transferencia TPV,58000,0,"7350234,07"
01/06/2024,13480,,9418,Terminal SE - Transferencia TPV,118250,0,"7468484,07"
01/06/2024,13482,,9420,Terminal SE - Transferencia TPV,192595,0,"7661079,07"
01/06/2024,13476,,9409,Terminal SE - Transferencia TPV,63000,0,"7724079,07"
01/06/2024,13505,,9479,Terminal SE - Transferencia TPV,86130,0,"7810209,07"
01/06/2024,13488,,9439,Terminal SE - Transferencia TPV,"161999,99",0,"7972209,06"
01/06/2024,13484,,9424,Terminal SE - Transferencia TPV,"201800,02",0,"8174009,08"
01/06/2024,13471,,9401,Terminal SE - Transferencia TPV,65000,0,"8239009,08"
01/06/2024,13485,,9428,Terminal SE - Transferencia TPV,185214,0,"8424223,08"
01/06/2024,13504,,9477,Terminal SE - Transferencia TPV,"74734,01",0,"8498957,09"
01/06/2024,13464,,9378,Terminal SE - Transferencia TPV,124500,0,"8623457,09"
01/06/2024,13487,,9430,Terminal SE - Transferencia TPV,"151250,01",0,"8774707,1"
01/06/2024,13495,,9465,Terminal SE - Transferencia TPV,"279399,98",0,"9054107,08"
01/06/2024,13475,,9405,Terminal SE - Transferencia TPV,54000,0,"9021107,08"
01/06/2024,13469,,9389,Terminal SE - Transferencia TPV,"89650,01",0,"9110757,09"
01/06/2024,13500,,9472,Terminal SE - Transferencia TPV,"188276,01",0,"9299033,1"
01/06/2024,13503,,9475,Terminal SE - Transferencia TPV,"60939,99",0,"9359973,09"
01/06/2024,13460,,9370,Terminal SE - Transferencia TPV,"180400,02",0,"9540373,11"
01/06/2024,13501,,9473,Terminal SE - Transferencia TPV,"102500,01",0,"9642873,12"
01/06/2024,13498,,9468,Terminal SE - Transferencia TPV,"229900,02",0,"9872773,14"
01/06/2024,13477,,9410,Terminal SE - Transferencia TPV,61000,0,"9933773,14"
01/06/2024,13461,,9374,Terminal SE - Transferencia TPV,55000,0,"9988773,14"
01/06/2024,13467,,9387,Terminal SE - Transferencia TPV,83000,0,"10071773,14"
01/06/2024,13458,,9364,Terminal SE - Transferencia TPV,"91959,99",0,"10163733,13"
01/06/2024,12809,,,Terminal LS - Tarjeta TPV,0,1499221,"8664512,13"
01/07/2024,14348,,9562,Terminal SE - Transferencia TPV,"92400,01",0,"8756912,14"
01/07/2024,14354,,9577,Terminal SE - Transferencia TPV,69410,0,"8826322,14"
01/07/2024,14336,,9537,Terminal SE - Transferencia TPV,"155430,01",0,"8981752,15"
01/07/2024,14324,,9518,Terminal SE - Transferencia TPV,207627,0,"9189379,15"
01/07/2024,14382,,9640,Terminal SE - Transferencia TPV,187880,0,"9377259,15"
01/07/2024,14325,,9522,Terminal SE - Transferencia TPV,80300,0,"9457559,15"
01/07/2024,14351,,9569,Terminal SE - Transferencia TPV,82800,0,"9540359,15"
01/07/2024,14343,,9544,Terminal SE - Transferencia TPV,"86284,01",0,"9626643,16"
01/07/2024,14358,,9583,Terminal SE - Transferencia TPV,60500,0,"9687143,16"
01/07/2024,14342,,9543,Terminal SE - Transferencia TPV,"152900,02",0,"9840043,18"
01/07/2024,14356,,9581,Terminal SE - Transferencia TPV,"66963,99",0,"9907007,17"
01/07/2024,14332,,9530,Terminal SE - Transferencia TPV,80300,0,"9987307,17"
01/07/2024,14317,,9506,Terminal SE - Transferencia TPV,174350,0,"10161657,17"
01/07/2024,14346,,9548,Terminal SE - Transferencia TPV,"136290,01",0,"10297947,18"
01/07/2024,14344,,9545,Terminal SE - Transferencia TPV,"136509,99",0,"10434457,17"
01/07/2024,14373,,9625,Terminal SE - Transferencia TPV,"50850,01",0,"10485307,18"
01/07/2024,14365,,9614,Terminal SE - Transferencia TPV,86460,0,"10571767,18"
01/07/2024,14379,,9636,Terminal SE - Transferencia TPV,"56999,99",0,"10628767,17"
01/07/2024,14359,,9584,Terminal SE - Transferencia TPV,"161124,01",0,"10789891,18"
01/07/2024,14345,,9547,Terminal SE - Transferencia TPV,102000,0,"10891891,18"
01/07/2024,14350,,9568,Terminal SE - Transferencia TPV,217000,0,"11108891,18"
01/07/2024,14333,,9531,Terminal SE - Transferencia TPV,"112999,99",0,"11221891,17"
01/07/2024,14374,,9628,Terminal SE - Transferencia TPV,42000,0,"11263891,17"
01/07/2024,14376,,9631,Terminal SE - Transferencia TPV,50000,0,"11313891,17"
01/07/2024,14329,,9526,Terminal SE - Transferencia TPV,"214499,99",0,"11528391,16"
01/07/2024,14319,,9508,Terminal SE - Transferencia TPV,"59999,99",0,"11588391,15"
01/07/2024,14330,,9527,Terminal SE - Transferencia TPV,"85250,01",0,"11673641,16"
01/07/2024,14315,,9503,Terminal SE - Transferencia TPV,"89650,01",0,"11763291,17"
01/07/2024,14326,,9524,Terminal SE - Transferencia TPV,153610,0,"11916901,17"
01/07/2024,14327,,9524,Terminal SE - Transferencia TPV,"50000,01",0,"11966901,18"
01/07/2024,14334,,9536,Terminal SE - Transferencia TPV,100000,0,"12066901,18"
01/07/2024,14335,,9536,Terminal SE - Transferencia TPV,105700,0,"12172601,18"
01/07/2024,14337,,9538,Terminal SE - Transferencia TPV,78980,0,"12251581,18"
01/07/2024,14320,,9509,Terminal SE - Transferencia TPV,296000,0,"12547581,18"
01/07/2024,14318,,9507,Terminal SE - Transferencia TPV,"184250,01",0,"12731831,19"
01/07/2024,14328,,9525,Terminal SE - Transferencia TPV,"74800,01",0,"12806631,2"
01/07/2024,14323,,9516,Terminal SE - Transferencia TPV,134970,0,"12941601,2"
01/07/2024,14331,,9529,Terminal SE - Transferencia TPV,"78650,01",0,"13020251,21"
01/07/2024,14339,,9540,Terminal SE - Transferencia TPV,68750,0,"13089001,21"
01/07/2024,14322,,9514,Terminal SE - Transferencia TPV,"196349,99",0,"13285351,2"
01/07/2024,14353,,9576,Terminal SE - Transferencia TPV,"57477,01",0,"13342828,21"
01/07/2024,14340,,9541,Terminal SE - Transferencia TPV,"188912,01",0,"13531740,22"
01/07/2024,14347,,9552,Terminal SE - Transferencia TPV,"56100,01",0,"13587840,23"
01/07/2024,14371,,9622,Terminal SE - Transferencia TPV,"86600,01",0,"13674440,24"
01/07/2024,14366,,9615,Terminal SE - Transferencia TPV,185350,0,"13859790,24"
01/07/2024,14372,,9623,Terminal SE - Transferencia TPV,8500,0,"13868290,24"
01/07/2024,14355,,9578,Terminal SE - Transferencia TPV,151910,0,"14020200,24"
01/07/2024,14363,,9610,Terminal SE - Transferencia TPV,137600,0,"14157800,24"
01/07/2024,13507,,,Terminal SE - Transferencia TPV,5719726,0,"19877526,24"
01/07/2024,14361,,9608,Terminal SE - Transferencia TPV,284746,0,"20162272,24"
01/07/2024,14381,,9639,Terminal SE - Transferencia TPV,121330,0,"20283602,24"
01/07/2024,14369,,9619,Terminal SE - Transferencia TPV,"177100,01",0,"20460702,25"
01/07/2024,13507,,,Terminal SE - Transferencia TPV,0,5719726,"14740976,25"
01/07/2024,14368,,9618,Terminal SE - Transferencia TPV,78100,0,"14819076,25"
01/07/2024,14370,,9621,Terminal SE - Transferencia TPV,183546,0,"15002622,25"
01/07/2024,14364,,9611,Terminal SE - Transferencia TPV,"170060,01",0,"15172682,26"
01/07/2024,14375,,9630,Terminal SE - Transferencia TPV,"51000,01",0,"15223682,27"
01/07/2024,14316,,9505,Terminal SE - Transferencia TPV,127270,0,"15350952,27"
01/07/2024,14380,,9637,Terminal SE - Transferencia TPV,139000,0,"15489952,27"
01/07/2024,14352,,9573,Terminal SE - Transferencia TPV,"91300,01",0,"15581252,28"
01/07/2024,14377,,9632,Terminal SE - Transferencia TPV,"95000,01",0,"15676252,29"
01/07/2024,14321,,9510,Terminal SE - Transferencia TPV,83050,0,"15759302,29"
01/07/2024,14357,,9582,Terminal SE - Transferencia TPV,"61794,01",0,"15821096,3"
01/07/2024,14349,,9565,Terminal SE - Transferencia TPV,"67650,01",0,"15888746,31"
01/07/2024,14378,,9633,Terminal SE - Transferencia TPV,71000,0,"15959746,31"
01/07/2024,14360,,9597,Terminal SE - Transferencia TPV,45000,0,"16004746,31"
01/07/2024,14367,,9617,Terminal SE - Transferencia TPV,"31660,02",0,"16036406,33"
01/07/2024,14341,,9542,Terminal SE - Transferencia TPV,144210,0,"16180616,33"
01/07/2024,14338,,9539,Terminal SE - Transferencia TPV,"203499,99",0,"16384116,32"
01/07/2024,14362,,9609,Terminal SE - Transferencia TPV,"149599,99",0,"16533716,31"
01/08/2024,14873,,9671,Terminal SE - Transferencia TPV,57000,0,"16590716,31"
01/08/2024,14887,,9720,Terminal SE - Transferencia TPV,"142560,02",0,"16733276,33"
01/08/2024,14383,,,Terminal SE - Transferencia TPV,7858192,0,"24591468,33"
01/08/2024,14880,,9687,Terminal SE - Transferencia TPV,"75764,01",0,"22504458,34"
01/08/2024,14863,,9644,Terminal SE - Transferencia TPV,"88880,01",0,"22593338,35"
01/08/2024,14888,,9730,Terminal SE - Transferencia TPV,141400,0,"22734738,35"
01/08/2024,14883,,9709,Terminal SE - Transferencia TPV,72400,0,"22807138,35"
01/08/2024,14881,,9688,Terminal SE - Transferencia TPV,63000,0,"22870138,35"
01/08/2024,14383,,,Terminal SE - Transferencia TPV,0,7858192,"15011946,35"
01/08/2024,14384,,,Terminal SE - Transferencia TPV,0,"11012,18","15000934,17"
01/08/2024,14864,,9649,Terminal SE - Transferencia TPV,50000,0,"15050934,17"
01/08/2024,14884,,9710,Terminal SE - Transferencia TPV,95700,0,"15146634,17"
01/08/2024,14867,,9655,Terminal SE - Transferencia TPV,72000,0,"15218634,17"
01/08/2024,14865,,9652,Terminal SE - Transferencia TPV,"102300,01",0,"15320934,18"
01/08/2024,14868,,9656,Terminal SE - Transferencia TPV,"56000,01",0,"15376934,19"
01/08/2024,14874,,9673,Terminal SE - Transferencia TPV,193000,0,"15569934,19"
01/08/2024,14878,,9682,Terminal SE - Transferencia TPV,"111499,99",0,"15681434,18"
01/08/2024,14872,,9668,Terminal SE - Transferencia TPV,47500,0,"15728934,18"
01/08/2024,14876,,9676,Terminal SE - Transferencia TPV,"59500,01",0,"15788434,19"
01/08/2024,14866,,9654,Terminal SE - Transferencia TPV,123651,0,"15912085,19"
01/08/2024,14877,,9681,Terminal SE - Transferencia TPV,"91740,01",0,"16003825,2"
01/08/2024,14882,,9705,Terminal SE - Transferencia TPV,66000,0,"16069825,2"
01/08/2024,14869,,9660,Terminal SE - Transferencia TPV,47000,0,"16116825,2"
01/08/2024,14886,,9715,Terminal SE - Transferencia TPV,"205272,02",0,"16322097,22"
01/08/2024,14879,,9683,Terminal SE - Transferencia TPV,74710,0,"16396807,22"
01/08/2024,14871,,9667,Terminal SE - Transferencia TPV,"203000,01",0,"16599807,23"
01/08/2024,14885,,9712,Terminal SE - Transferencia TPV,58976,0,"16658783,23"
01/08/2024,14875,,9674,Terminal SE - Transferencia TPV,"58499,99",0,"16717283,22"
01/08/2024,14870,,9661,Terminal SE - Transferencia TPV,"212861,01",0,"16930144,23"
01/08/2024,14862,,9643,Terminal SE - Transferencia TPV,67100,0,"16997244,23"
01/09/2024,14889,,,Terminal SE - Transferencia TPV,0,2637398,"10657538,18"
01/09/2024,14889,,,Terminal SE - Transferencia TPV,2637398,0,"13294936,18"
01/11/2024,15562,,9817,Terminal SE - Transferencia TPV,"370699,99",0,"8589769,93"
01/11/2024,15565,,9824,Terminal SE - Transferencia TPV,"91079,99",0,"8680849,92"
01/11/2024,15566,,9825,Terminal SE - Transferencia TPV,62500,0,"8743349,92"
01/11/2024,15567,,9827,Terminal SE - Transferencia TPV,51000,0,"8794349,92"
01/11/2024,15552,,9797,Terminal SE - Transferencia TPV,"98229,99",0,"7782288,65"
01/11/2024,15553,,9798,Terminal SE - Transferencia TPV,14815,0,"7797103,65"
01/11/2024,15554,,9800,Terminal SE - Transferencia TPV,"89429,99",0,"7886533,64"
01/11/2024,15555,,9801,Terminal SE - Transferencia TPV,"296708,01",0,"8183241,65"
01/11/2024,15556,,9802,Terminal SE - Transferencia TPV,57200,0,"8240441,65"
01/11/2024,15557,,9803,Terminal SE - Transferencia TPV,"83500,01",0,"8323941,66"
01/11/2024,15558,,9805,Terminal SE - Transferencia TPV,"147840,01",0,"8471781,67"
01/11/2024,15559,,9806,Terminal SE - Transferencia TPV,96580,0,"8568361,67"
01/11/2024,15560,,9807,Terminal SE - Transferencia TPV,"65499,99",0,"8633861,66"
01/11/2024,15561,,9815,Terminal SE - Transferencia TPV,161480,0,"8795341,66"
01/11/2024,15563,,9818,Terminal SE - Transferencia TPV,"140799,99",0,"8936141,65"
01/11/2024,15564,,9823,Terminal SE - Transferencia TPV,113000,0,"9049141,65"
01/12/2024,15956,,9892,Terminal SE - Transferencia TPV,233000,0,"8852471,59"
01/12/2024,15955,,9890,Terminal SE - Transferencia TPV,"177869,99",0,"9030341,58"
01/12/2024,15954,,9887,Terminal SE - Transferencia TPV,223080,0,"9253421,58"
01/12/2024,15953,,9886,Terminal SE - Transferencia TPV,89650,0,"9343071,58"
01/12/2024,15952,,9878,Terminal SE - Transferencia TPV,"113999,99",0,"9457071,57"
01/12/2024,15951,,9876,Terminal SE - Transferencia TPV,135000,0,"9592071,57"
01/12/2024,15950,,9875,Terminal SE - Transferencia TPV,145750,0,"9737821,57"
01/12/2024,15949,,9871,Terminal SE - Transferencia TPV,"113959,98",0,"9851781,55"
01/12/2024,15948,,9866,Terminal SE - Transferencia TPV,"155500,01",0,"10007281,56"
01/12/2024,15945,,9858,Terminal SE - Transferencia TPV,"106149,99",0,"10113431,55"
01/12/2024,15944,,9857,Terminal SE - Transferencia TPV,61000,0,"9613227,55"
01/12/2024,15960,,9911,Terminal SE - Transferencia TPV,35300,0,"9534527,55"
01/12/2024,15947,,9862,Terminal SE - Transferencia TPV,97500,0,"9632027,55"
01/12/2024,15946,,9862,Terminal SE - Transferencia TPV,10000,0,"9642027,55"
01/12/2024,15943,,9850,Terminal SE - Transferencia TPV,72000,0,"9714027,55"
01/12/2024,15572,,,Terminal SE - Transferencia TPV,0,2336892,"7377135,55"
01/12/2024,15962,,9911,Terminal SE - Transferencia TPV,35250,0,"7412385,55"
01/12/2024,15961,,9911,Terminal SE - Transferencia TPV,35270,0,"7447655,55"
01/12/2024,15964,,9919,Terminal SE - Transferencia TPV,"231329,99",0,"7678985,54"
01/12/2024,15963,,9915,Terminal SE - Transferencia TPV,"91079,99",0,"7770065,53"
01/12/2024,15959,,9908,Terminal SE - Transferencia TPV,146000,0,"7916065,53"
01/12/2024,15958,,9901,Terminal SE - Transferencia TPV,79750,0,"7995815,53"
01/12/2024,15957,,9897,Terminal SE - Transferencia TPV,148098,0,"8143913,53"
01/12/2024,15572,,,Terminal SE - Transferencia TPV,2336892,0,"10480805,53"
01/13/2024,15965,,,Terminal SE - Transferencia TPV,2536625,0,"12949930,53"
01/13/2024,16683,,10009,Terminal SE - Transferencia TPV,"240000,01",0,"13189930,54"
01/13/2024,16689,,10027,Terminal SE - Transferencia TPV,135000,0,"13324930,54"
01/13/2024,16658,,9943,Terminal SE - Transferencia TPV,"96800,01",0,"13421730,55"
01/13/2024,16655,,9935,Terminal SE - Transferencia TPV,"124099,99",0,"13545830,54"
01/13/2024,16677,,9985,Terminal SE - Transferencia TPV,"159719,99",0,"13705550,53"
01/13/2024,16666,,9959,Terminal SE - Transferencia TPV,129800,0,"13835350,53"
01/13/2024,16656,,9936,Terminal SE - Transferencia TPV,67000,0,"13902350,53"
01/13/2024,16685,,10017,Terminal SE - Transferencia TPV,"64999,99",0,"13967350,52"
01/13/2024,16674,,9973,Terminal SE - Transferencia TPV,93500,0,"14060850,52"
01/13/2024,16692,,10031,Terminal SE - Transferencia TPV,174240,0,"14235090,52"
01/13/2024,16679,,9988,Terminal SE - Transferencia TPV,121190,0,"14356280,52"
01/13/2024,16682,,10005,Terminal SE - Transferencia TPV,"327494,98",0,"14683775,5"
01/13/2024,16696,,10046,Terminal SE - Transferencia TPV,119000,0,"14802775,5"
01/13/2024,16686,,10020,Terminal SE - Transferencia TPV,"84999,99",0,"14887775,49"
01/13/2024,16695,,10045,Terminal SE - Transferencia TPV,58000,0,"14945775,49"
01/13/2024,16680,,9989,Terminal SE - Transferencia TPV,179190,0,"15124965,49"
01/13/2024,16654,,9934,Terminal SE - Transferencia TPV,55220,0,"15180185,49"
01/13/2024,16694,,10037,Terminal SE - Transferencia TPV,216040,0,"15396225,49"
01/13/2024,16681,,10002,Terminal SE - Transferencia TPV,59000,0,"15455225,49"
01/13/2024,16675,,9976,Terminal SE - Transferencia TPV,64000,0,"15519225,49"
01/13/2024,16670,,9968,Terminal SE - Transferencia TPV,"92399,99",0,"15611625,48"
01/13/2024,16676,,9981,Terminal SE - Transferencia TPV,63000,0,"15674625,48"
01/13/2024,16657,,9942,Terminal SE - Transferencia TPV,61000,0,"15735625,48"
01/13/2024,16669,,9967,Terminal SE - Transferencia TPV,42000,0,"15777625,48"
01/13/2024,16688,,10026,Terminal SE - Transferencia TPV,"121549,99",0,"15899175,47"
01/13/2024,16663,,9949,Terminal SE - Transferencia TPV,"449569,99",0,"16348745,46"
01/13/2024,15965,,,Terminal SE - Transferencia TPV,0,2536625,"13167020,46"
01/13/2024,16668,,9966,Terminal SE - Transferencia TPV,106000,0,"12550420,46"
01/13/2024,16690,,10027,Terminal SE - Transferencia TPV,135000,0,"12685420,46"
01/13/2024,16691,,10027,Terminal SE - Transferencia TPV,"134999,98",0,"12820420,44"
01/13/2024,16693,,10032,Terminal SE - Transferencia TPV,48400,0,"12868820,44"
01/13/2024,16697,,10047,Terminal SE - Transferencia TPV,62500,0,"12931320,44"
01/13/2024,16672,,9971,Terminal SE - Transferencia TPV,"162799,99",0,"13094120,43"
01/13/2024,16664,,9951,Terminal SE - Transferencia TPV,"219299,99",0,"13313420,42"
01/13/2024,16673,,9972,Terminal SE - Transferencia TPV,"174240,01",0,"13487660,43"
01/13/2024,16671,,9970,Terminal SE - Transferencia TPV,"246000,01",0,"13733660,44"
01/13/2024,16665,,9952,Terminal SE - Transferencia TPV,"203400,97",0,"13937061,41"
01/13/2024,16684,,10015,Terminal SE - Transferencia TPV,100870,0,"14037931,41"
01/13/2024,16687,,10025,Terminal SE - Transferencia TPV,"168519,99",0,"14206451,4"
01/13/2024,16678,,9987,Terminal SE - Transferencia TPV,"125839,99",0,"14332291,39"
01/13/2024,16667,,9963,Terminal SE - Transferencia TPV,"80519,99",0,"14412811,38"
01/13/2024,16660,,9945,Terminal SE - Transferencia TPV,96500,0,"14509311,38"
01/13/2024,16661,,9945,Terminal SE - Transferencia TPV,1500,0,"14510811,38"
01/13/2024,16662,,9946,Terminal SE - Transferencia TPV,91630,0,"14602441,38"
01/13/2024,16659,,9944,Terminal SE - Transferencia TPV,105600,0,"14708041,38"
01/14/2024,17276,,10115,Terminal SE - Transferencia TPV,59000,0,"8869941,38"
01/14/2024,16698,,,Terminal SE - Transferencia TPV,0,5662396,"3207545,38"
01/14/2024,17266,,10094,Terminal SE - Transferencia TPV,"93609,99",0,"3301155,37"
01/14/2024,17283,,10150,Terminal SE - Transferencia TPV,71500,0,"3372655,37"
01/14/2024,17270,,10099,Terminal SE - Transferencia TPV,85800,0,"3458455,37"
01/14/2024,17278,,10118,Terminal SE - Transferencia TPV,102850,0,"3561305,37"
01/14/2024,17280,,10121,Terminal SE - Transferencia TPV,91850,0,"3653155,37"
01/14/2024,17265,,10093,Terminal SE - Transferencia TPV,42867,0,"3696022,37"
01/14/2024,17262,,10078,Terminal SE - Transferencia TPV,"95000,01",0,"3791022,38"
01/14/2024,17279,,10120,Terminal SE - Transferencia TPV,"98120,01",0,"3889142,39"
01/14/2024,17282,,10138,Terminal SE - Transferencia TPV,112200,0,"4001342,39"
01/14/2024,17260,,10076,Terminal SE - Transferencia TPV,"75789,99",0,"4077132,38"
01/14/2024,17258,,10074,Terminal SE - Transferencia TPV,215600,0,"4292732,38"
01/14/2024,17271,,10100,Terminal SE - Transferencia TPV,249590,0,"4542322,38"
01/14/2024,17267,,10096,Terminal SE - Transferencia TPV,177870,0,"4720192,38"
01/14/2024,17249,,10059,Terminal SE - Transferencia TPV,85250,0,"4805442,38"
01/14/2024,17250,,10062,Terminal SE - Transferencia TPV,"192939,99",0,"4720382,37"
01/14/2024,17274,,10105,Terminal SE - Transferencia TPV,"5600,01",0,"4725982,38"
01/14/2024,17275,,10106,Terminal SE - Transferencia TPV,"75600,22",0,"4801582,6"
01/14/2024,17254,,10067,Terminal SE - Transferencia TPV,128260,0,"4929842,6"
01/14/2024,17252,,10064,Terminal SE - Transferencia TPV,82500,0,"5012342,6"
01/14/2024,17263,,10091,Terminal SE - Transferencia TPV,92400,0,"5104742,6"
01/14/2024,17257,,10073,Terminal SE - Transferencia TPV,154000,0,"5258742,6"
01/14/2024,17269,,10098,Terminal SE - Transferencia TPV,"266309,98",0,"5525052,58"
01/14/2024,17277,,10117,Terminal SE - Transferencia TPV,128000,0,"5653052,58"
01/14/2024,17272,,10101,Terminal SE - Transferencia TPV,203720,0,"5856772,58"
01/14/2024,17273,,10103,Terminal SE - Transferencia TPV,100000,0,"5956772,58"
01/14/2024,17259,,10075,Terminal SE - Transferencia TPV,"177799,99",0,"6134572,57"
01/14/2024,17268,,10097,Terminal SE - Transferencia TPV,134420,0,"6268992,57"
01/14/2024,17256,,10072,Terminal SE - Transferencia TPV,85690,0,"6354682,57"
01/14/2024,17264,,10092,Terminal SE - Transferencia TPV,"71720,01",0,"6426402,58"
01/14/2024,16698,,,Terminal SE - Transferencia TPV,5662396,0,"12088798,58"
01/14/2024,17261,,10077,Terminal SE - Transferencia TPV,82500,0,"12171298,58"
01/14/2024,17251,,10063,Terminal SE - Transferencia TPV,"476190,01",0,"12647488,59"
01/14/2024,17253,,10065,Terminal SE - Transferencia TPV,265320,0,"12912808,59"
01/14/2024,17248,,10056,Terminal SE - Transferencia TPV,335720,0,"13248528,59"
01/14/2024,17255,,10069,Terminal SE - Transferencia TPV,87100,0,"13335628,59"
01/14/2024,17281,,10122,Terminal SE - Transferencia TPV,"169000,01",0,"13504628,6"
01/15/2024,17284,,,Terminal SE - Transferencia TPV,4971658,0,"18476286,6"
01/15/2024,17284,,,Terminal SE - Transferencia TPV,0,4971658,"13452351,9"
01/18/2024,17745,,10200,Terminal SE - Efectivo TPV,58300,0,"1840770,36"
01/18/2024,17744,,10194,Terminal SE - Efectivo TPV,"33700,01",0,"1874470,37"
01/18/2024,17760,,10225,Terminal SE - Transferencia TPV,316250,0,"2143520,27"
01/18/2024,17759,,10216,Terminal SE - Transferencia TPV,116000,0,"2259520,27"
01/18/2024,17758,,10214,Terminal SE - Transferencia TPV,"98999,99",0,"2358520,26"
01/18/2024,17757,,10211,Terminal SE - Transferencia TPV,105500,0,"2464020,26"
01/18/2024,17756,,10207,Terminal SE - Transferencia TPV,103730,0,"2567750,26"
01/18/2024,17755,,10202,Terminal SE - Transferencia TPV,185900,0,"2753650,26"
01/18/2024,17754,,10198,Terminal SE - Transferencia TPV,68000,0,"2821650,26"
01/18/2024,17753,,10197,Terminal SE - Transferencia TPV,72500,0,"2894150,26"
01/18/2024,17752,,10196,Terminal SE - Transferencia TPV,13000,0,"2907150,26"
01/18/2024,17743,,10192,Terminal SE - Efectivo TPV,44000,0,"2951150,26"
01/18/2024,17751,,10195,Terminal SE - Transferencia TPV,"156089,99",0,"3107240,25"
01/18/2024,17750,,10193,Terminal SE - Transferencia TPV,"49500,01",0,"3156740,26"
01/18/2024,17746,,10204,Terminal SE - Efectivo TPV,81950,0,"3238690,26"
01/18/2024,17762,,10228,Terminal SE - Transferencia TPV,17100,0,"3255790,26"
01/18/2024,17761,,10227,Terminal SE - Transferencia TPV,97900,0,"3353690,26"
01/18/2024,17747,,10209,Terminal SE - Efectivo TPV,73700,0,"3427390,26"
01/18/2024,17748,,10212,Terminal SE - Efectivo TPV,82280,0,"3509670,26"
01/19/2024,18242,,10288,Terminal SE - Transferencia TPV,"57000,01",0,"3113470,27"
01/19/2024,18245,,10299,Terminal SE - Transferencia TPV,50700,0,"3164170,27"
01/19/2024,17749,,,Terminal SE - Efectivo TPV,373950,0,"3373120,27"
01/19/2024,18229,,10242,Terminal SE - Transferencia TPV,"112999,99",0,"3486120,26"
01/19/2024,18230,,10245,Terminal SE - Transferencia TPV,121000,0,"3607120,26"
01/19/2024,18231,,10251,Terminal SE - Transferencia TPV,70510,0,"3557630,26"
01/19/2024,18252,,10315,Terminal SE - Transferencia TPV,"123200,01",0,"3680830,27"
01/19/2024,18251,,10309,Terminal SE - Transferencia TPV,"276649,99",0,"3957480,26"
01/19/2024,18250,,10306,Terminal SE - Transferencia TPV,102000,0,"4059480,26"
01/19/2024,18249,,10305,Terminal SE - Transferencia TPV,102000,0,"4161480,26"
01/19/2024,18248,,10304,Terminal SE - Transferencia TPV,"88999,99",0,"4250480,25"
01/19/2024,18247,,10303,Terminal SE - Transferencia TPV,35100,0,"4285580,25"
01/19/2024,18246,,10300,Terminal SE - Transferencia TPV,202290,0,"4487870,25"
01/19/2024,18244,,10295,Terminal SE - Transferencia TPV,"105499,99",0,"4593370,24"
01/19/2024,18243,,10293,Terminal SE - Transferencia TPV,"174999,99",0,"4768370,23"
01/19/2024,18241,,10286,Terminal SE - Transferencia TPV,167750,0,"4936120,23"
01/19/2024,18240,,10284,Terminal SE - Transferencia TPV,76560,0,"5012680,23"
01/19/2024,18232,,10255,Terminal SE - Transferencia TPV,116050,0,"5128730,23"
01/19/2024,18233,,10262,Terminal SE - Transferencia TPV,116000,0,"5244730,23"
01/19/2024,18234,,10263,Terminal SE - Transferencia TPV,67926,0,"5312656,23"
01/19/2024,18235,,10266,Terminal SE - Transferencia TPV,56000,0,"5368656,23"
01/19/2024,18236,,10267,Terminal SE - Transferencia TPV,116270,0,"5484926,23"
01/19/2024,18237,,10270,Terminal SE - Transferencia TPV,78320,0,"5563246,23"
01/19/2024,18238,,10280,Terminal SE - Transferencia TPV,77220,0,"5640466,23"
01/19/2024,18239,,10281,Terminal SE - Transferencia TPV,122210,0,"5762676,23"
01/19/2024,17763,,,Terminal SE - Transferencia TPV,1400470,0,"7163146,23"
01/19/2024,17763,,,Terminal SE - Transferencia TPV,0,1400470,"5626176,23"
01/19/2024,17749,,,Terminal SE - Efectivo TPV,0,373950,"5227726,23"
01/20/2024,19264,,10421,Terminal SE - Transferencia TPV,"84699,99",0,"5312426,22"
01/20/2024,19284,,10461,Terminal SE - Transferencia TPV,"53039,99",0,"5365466,21"
01/20/2024,19278,,10452,Terminal SE - Transferencia TPV,109000,0,"5474466,21"
01/20/2024,19260,,10407,Terminal SE - Transferencia TPV,122320,0,"5519786,21"
01/20/2024,19234,,10347,Terminal SE - Transferencia TPV,"92950,01",0,"5612736,22"
01/20/2024,19261,,10414,Terminal SE - Transferencia TPV,81620,0,"5694356,22"
01/20/2024,19262,,10418,Terminal SE - Transferencia TPV,"86789,99",0,"5781146,21"
01/20/2024,19243,,10361,Terminal SE - Transferencia TPV,"148000,24",0,"5929146,45"
01/20/2024,19245,,10369,Terminal SE - Transferencia TPV,"322299,98",0,"6251446,43"
01/20/2024,19251,,10381,Terminal SE - Transferencia TPV,"23399,99",0,"6274846,42"
01/20/2024,19238,,10353,Terminal SE - Transferencia TPV,75100,0,"6349946,42"
01/20/2024,19255,,10394,Terminal SE - Transferencia TPV,"391709,99",0,"6741656,41"
01/20/2024,19248,,10373,Terminal SE - Transferencia TPV,145970,0,"6887626,41"
01/20/2024,19275,,10446,Terminal SE - Transferencia TPV,58500,0,"6946126,41"
01/20/2024,19272,,10440,Terminal SE - Transferencia TPV,67100,0,"7013226,41"
01/20/2024,19231,,10335,Terminal SE - Transferencia TPV,100760,0,"7113986,41"
01/20/2024,19285,,10462,Terminal SE - Transferencia TPV,"266000,23",0,"7379986,64"
01/20/2024,19258,,10402,Terminal SE - Transferencia TPV,"101419,99",0,"7481406,63"
01/20/2024,19257,,10401,Terminal SE - Transferencia TPV,64680,0,"7546086,63"
01/20/2024,19266,,10430,Terminal SE - Transferencia TPV,"183999,99",0,"7730086,62"
01/20/2024,19270,,10438,Terminal SE - Transferencia TPV,116270,0,"7846356,62"
01/20/2024,19256,,10399,Terminal SE - Transferencia TPV,"181500,01",0,"8027856,63"
01/20/2024,19280,,10454,Terminal SE - Transferencia TPV,"101199,99",0,"8129056,62"
01/20/2024,19253,,10385,Terminal SE - Transferencia TPV,132000,0,"8261056,62"
01/20/2024,19233,,10344,Terminal SE - Transferencia TPV,81180,0,"8342236,62"
01/20/2024,19230,,10331,Terminal SE - Transferencia TPV,"59500,01",0,"8401736,63"
01/20/2024,19269,,10436,Terminal SE - Transferencia TPV,"101199,99",0,"8502936,62"
01/20/2024,19281,,10455,Terminal SE - Transferencia TPV,113000,0,"8615936,62"
01/20/2024,19242,,10360,Terminal SE - Transferencia TPV,"105599,99",0,"8721536,61"
01/20/2024,19279,,10453,Terminal SE - Transferencia TPV,"113999,99",0,"8835536,6"
01/20/2024,19249,,10374,Terminal SE - Transferencia TPV,73480,0,"8909016,6"
01/20/2024,19274,,10442,Terminal SE - Transferencia TPV,"96579,99",0,"9005596,59"
01/20/2024,19232,,10340,Terminal SE - Transferencia TPV,"215899,99",0,"9221496,58"
01/20/2024,19268,,10434,Terminal SE - Transferencia TPV,51000,0,"9272496,58"
01/20/2024,18253,,,Terminal SE - Transferencia TPV,2617230,0,"11889726,58"
01/20/2024,18253,,,Terminal SE - Transferencia TPV,0,2617230,"9272496,58"
01/20/2024,18391,,,Terminal LS - Tarjeta TPV,2527028,0,"11799524,58"
01/20/2024,18391,,,Terminal LS - Tarjeta TPV,0,2527028,"9272496,58"
01/20/2024,19250,,10377,Terminal SE - Transferencia TPV,"207570,01",0,"9480066,59"
01/20/2024,19244,,10364,Terminal SE - Transferencia TPV,"58800,01",0,"9538866,6"
01/20/2024,19286,,10466,Terminal SE - Transferencia TPV,132550,0,"9671416,6"
01/20/2024,19239,,10356,Terminal SE - Transferencia TPV,"583439,99",0,"10254856,59"
01/20/2024,19273,,10441,Terminal SE - Transferencia TPV,55500,0,"10310356,59"
01/20/2024,19247,,10372,Terminal SE - Transferencia TPV,"160499,97",0,"10470856,56"
01/20/2024,19259,,10406,Terminal SE - Transferencia TPV,"210099,98",0,"10680956,54"
01/20/2024,19246,,10370,Terminal SE - Transferencia TPV,"262459,99",0,"10943416,53"
01/20/2024,19252,,10383,Terminal SE - Transferencia TPV,259490,0,"11202906,53"
01/20/2024,19235,,10349,Terminal SE - Transferencia TPV,269830,0,"11472736,53"
01/20/2024,19254,,10387,Terminal SE - Transferencia TPV,102800,0,"11575536,53"
01/20/2024,19236,,10350,Terminal SE - Transferencia TPV,85030,0,"11660566,53"
01/20/2024,19237,,10352,Terminal SE - Transferencia TPV,83500,0,"11744066,53"
01/20/2024,19229,,10329,Terminal SE - Transferencia TPV,96800,0,"11840866,53"
01/20/2024,19276,,10448,Terminal SE - Transferencia TPV,"53000,01",0,"11893866,54"
01/20/2024,19287,,10468,Terminal SE - Transferencia TPV,402380,0,"12296246,54"
01/20/2024,19265,,10427,Terminal SE - Transferencia TPV,157000,0,"12453246,54"
01/20/2024,19263,,10419,Terminal SE - Transferencia TPV,135740,0,"12588986,54"
01/20/2024,19271,,10439,Terminal SE - Transferencia TPV,"342000,98",0,"12930987,52"
01/20/2024,19240,,10359,Terminal SE - Transferencia TPV,72600,0,"13003587,52"
01/20/2024,19241,,10359,Terminal SE - Transferencia TPV,"72599,99",0,"13076187,51"
01/20/2024,19267,,10432,Terminal SE - Transferencia TPV,"70920,01",0,"13147107,52"
01/20/2024,19277,,10450,Terminal SE - Transferencia TPV,87000,0,"13234107,52"
01/20/2024,19282,,10458,Terminal SE - Transferencia TPV,78000,0,"13312107,52"
01/20/2024,19283,,10461,Terminal SE - Transferencia TPV,53000,0,"13365107,52"
01/21/2024,19801,,10487,Terminal SE - Transferencia TPV,100100,0,"13465207,52"
01/21/2024,19814,,10503,Terminal SE - Transferencia TPV,83500,0,"13548707,52"
01/21/2024,19807,,10495,Terminal SE - Transferencia TPV,"181169,99",0,"13729877,51"
01/21/2024,19821,,10514,Terminal SE - Transferencia TPV,"64999,99",0,"13794877,5"
01/21/2024,19819,,10511,Terminal SE - Transferencia TPV,200000,0,"13994877,5"
01/21/2024,19802,,10490,Terminal SE - Transferencia TPV,"438129,98",0,"14433007,48"
01/21/2024,19797,,10478,Terminal SE - Transferencia TPV,54000,0,"14487007,48"
01/21/2024,19843,,10553,Terminal SE - Transferencia TPV,"152399,99",0,"14639407,47"
01/21/2024,19822,,10515,Terminal SE - Transferencia TPV,106000,0,"14745407,47"
01/21/2024,19847,,10570,Terminal SE - Transferencia TPV,"81380,01",0,"14826787,48"
01/21/2024,19840,,10546,Terminal SE - Transferencia TPV,"82169,98",0,"14908957,46"
01/21/2024,19812,,10499,Terminal SE - Transferencia TPV,70800,0,"14979757,46"
01/21/2024,19845,,10555,Terminal SE - Transferencia TPV,63500,0,"15043257,46"
01/21/2024,19818,,10510,Terminal SE - Transferencia TPV,66000,0,"15109257,46"
01/21/2024,19813,,10501,Terminal SE - Transferencia TPV,"85140,24",0,"15194397,7"
01/21/2024,19815,,10505,Terminal SE - Transferencia TPV,83270,0,"15277667,7"
01/21/2024,19831,,10530,Terminal SE - Transferencia TPV,112750,0,"15390417,7"
01/21/2024,19805,,10493,Terminal SE - Transferencia TPV,21600,0,"15412017,7"
01/21/2024,19832,,10532,Terminal SE - Transferencia TPV,134000,0,"15546017,7"
01/21/2024,19798,,10481,Terminal SE - Transferencia TPV,155320,0,"15701337,7"
01/21/2024,19829,,10526,Terminal SE - Transferencia TPV,139700,0,"15841037,7"
01/21/2024,19817,,10509,Terminal SE - Transferencia TPV,90090,0,"15931127,7"
01/21/2024,19804,,10492,Terminal SE - Transferencia TPV,"309880,23",0,"16241007,93"
01/21/2024,19811,,10498,Terminal SE - Transferencia TPV,166100,0,"16407107,93"
01/21/2024,19288,,,Terminal SE - Transferencia TPV,0,8213966,"8193141,93"
01/21/2024,19799,,10483,Terminal SE - Transferencia TPV,87120,0,"8280261,93"
01/21/2024,19834,,10533,Terminal SE - Transferencia TPV,"163899,98",0,"8444161,91"
01/21/2024,19830,,10527,Terminal SE - Transferencia TPV,97350,0,"8541511,91"
01/21/2024,19844,,10554,Terminal SE - Transferencia TPV,"130999,99",0,"8672511,9"
01/21/2024,19800,,10486,Terminal SE - Transferencia TPV,"133649,99",0,"8806161,89"
01/21/2024,19835,,10534,Terminal SE - Transferencia TPV,"109449,99",0,"8915611,88"
01/21/2024,19820,,10512,Terminal SE - Transferencia TPV,"70000,01",0,"8985611,89"
01/21/2024,19828,,10525,Terminal SE - Transferencia TPV,"287360,23",0,"9272972,12"
01/21/2024,19810,,10497,Terminal SE - Transferencia TPV,449680,0,"9722652,12"
01/21/2024,19824,,10517,Terminal SE - Transferencia TPV,"119999,98",0,"9842652,1"
01/21/2024,19806,,10494,Terminal SE - Transferencia TPV,62500,0,"9905152,1"
01/21/2024,19809,,10496,Terminal SE - Transferencia TPV,53386,0,"9958538,1"
01/21/2024,19808,,10496,Terminal SE - Transferencia TPV,53387,0,"10011925,1"
01/21/2024,19833,,10532,Terminal SE - Transferencia TPV,"13400,01",0,"10025325,11"
01/21/2024,19288,,,Terminal SE - Transferencia TPV,8213966,0,"18239291,11"
01/21/2024,19837,,10539,Terminal SE - Transferencia TPV,"134000,01",0,"18373291,12"
01/21/2024,19803,,10491,Terminal SE - Transferencia TPV,"114289,99",0,"18487581,11"
01/21/2024,19848,,10574,Terminal SE - Transferencia TPV,11700,0,"18499281,11"
01/21/2024,19838,,10540,Terminal SE - Transferencia TPV,143110,0,"18642391,11"
01/21/2024,19823,,10516,Terminal SE - Transferencia TPV,74000,0,"18716391,11"
01/21/2024,19826,,10521,Terminal SE - Transferencia TPV,179410,0,"18895801,11"
01/21/2024,19816,,10508,Terminal SE - Transferencia TPV,148000,0,"19043801,11"
01/21/2024,19839,,10545,Terminal SE - Transferencia TPV,"149999,99",0,"19193801,1"
01/21/2024,19825,,10519,Terminal SE - Transferencia TPV,153560,0,"19347361,1"
01/21/2024,19836,,10538,Terminal SE - Transferencia TPV,68000,0,"19415361,1"
01/21/2024,19846,,10558,Terminal SE - Transferencia TPV,"101199,99",0,"19516561,09"
01/21/2024,19827,,10524,Terminal SE - Transferencia TPV,107030,0,"19623591,09"
01/21/2024,19842,,10552,Terminal SE - Transferencia TPV,116000,0,"19739591,09"
01/21/2024,19841,,10551,Terminal SE - Transferencia TPV,65000,0,"19804591,09"
01/22/2024,19849,,,Terminal SE - Transferencia TPV,0,6439512,"10996279,09"
01/22/2024,19849,,,Terminal SE - Transferencia TPV,6439512,0,"16019491,09"
01/24/2024,20161,,10614,Terminal LS - Transferencia TPV,"64999,99",0,"13529182,82"
01/24/2024,20169,,10629,Terminal LS - Transferencia TPV,81950,0,"13611132,82"
01/24/2024,20157,,10601,Terminal LS - Transferencia TPV,"129799,99",0,13381373
01/24/2024,20160,,10611,Terminal LS - Transferencia TPV,127215,0,"12638062,78"
01/24/2024,20154,,10617,Terminal LS - Tarjeta TPV,"276979,99",0,"12915042,77"
01/24/2024,20165,,10624,Terminal LS - Transferencia TPV,78260,0,"12483602,7"
01/24/2024,20164,,10621,Terminal LS - Transferencia TPV,"177430,01",0,"12397516,69"
01/24/2024,20168,,10628,Terminal LS - Transferencia TPV,86900,0,"12484416,69"
01/24/2024,20152,,10613,Terminal LS - Tarjeta TPV,"172149,98",0,"12656566,67"
01/24/2024,20159,,10607,Terminal LS - Transferencia TPV,"108000,01",0,"11969065,68"
01/24/2024,20153,,10616,Terminal LS - Tarjeta TPV,104500,0,"12073565,68"
01/24/2024,20166,,10625,Terminal LS - Transferencia TPV,"102959,98",0,"12176525,66"
01/24/2024,20163,,10619,Terminal LS - Transferencia TPV,"112199,99",0,"12288725,65"
01/24/2024,20167,,10627,Terminal LS - Transferencia TPV,100650,0,"12389375,65"
01/24/2024,20162,,10615,Terminal LS - Transferencia TPV,"218129,99",0,"12607505,64"
01/24/2024,20155,,10626,Terminal LS - Tarjeta TPV,"820929,94",0,"13428435,58"
01/24/2024,20158,,10602,Terminal LS - Transferencia TPV,"65934,01",0,"13332369,32"
01/25/2024,20396,,10664,Terminal SE - Transferencia TPV,"47000,99",0,"13379370,31"
01/25/2024,20395,,10655,Terminal SE - Transferencia TPV,157880,0,"13537250,31"
01/25/2024,20394,,10651,Terminal SE - Transferencia TPV,57000,0,"13594250,31"
01/25/2024,20393,,10650,Terminal SE - Transferencia TPV,119000,0,"13713250,31"
01/25/2024,20392,,10646,Terminal SE - Transferencia TPV,116000,0,"13829250,31"
01/25/2024,20391,,10641,Terminal SE - Transferencia TPV,87954,0,"13917204,31"
01/25/2024,20390,,10639,Terminal SE - Transferencia TPV,"115923,99",0,"14033128,3"
01/25/2024,20389,,10636,Terminal SE - Transferencia TPV,"71000,01",0,"14104128,31"
01/25/2024,20388,,10635,Terminal SE - Transferencia TPV,68800,0,"14172928,31"
01/25/2024,20156,,,Terminal LS - Tarjeta TPV,0,1884641,"12059631,32"
01/25/2024,20170,,,Terminal LS - Transferencia TPV,0,1454532,"10605099,32"
01/25/2024,20156,,,Terminal LS - Tarjeta TPV,1884641,0,"12489740,32"
01/25/2024,20170,,,Terminal LS - Transferencia TPV,1454532,0,"13944272,32"
01/25/2024,20397,,10671,Terminal SE - Transferencia TPV,256104,0,"14200376,32"
01/26/2024,20889,,10753,Terminal LS - Transferencia TPV,124500,0,"14324876,32"
01/26/2024,20887,,10745,Terminal LS - Transferencia TPV,77574,0,"14402450,32"
01/26/2024,20877,,10704,Terminal LS - Transferencia TPV,74700,0,"14477150,32"
01/26/2024,20891,,10757,Terminal LS - Transferencia TPV,"173000,01",0,"14650150,33"
01/26/2024,20879,,10711,Terminal LS - Transferencia TPV,76591,0,"14608741,07"
01/26/2024,20892,,10758,Terminal LS - Transferencia TPV,117126,0,"14725867,07"
01/26/2024,20894,,10763,Terminal LS - Transferencia TPV,"84238,99",0,"14810106,06"
01/26/2024,20888,,10752,Terminal LS - Transferencia TPV,"89592,99",0,"14899699,05"
01/26/2024,20772,,10699,Terminal SE - Transferencia TPV,"132000,01",0,"15031699,06"
01/26/2024,20773,,10705,Terminal SE - Transferencia TPV,"65000,01",0,"15096699,07"
01/26/2024,20774,,10706,Terminal SE - Transferencia TPV,119000,0,"15215699,07"
01/26/2024,20775,,10710,Terminal SE - Transferencia TPV,61000,0,"15276699,07"
01/26/2024,20778,,10721,Terminal SE - Transferencia TPV,"81834,99",0,"15358534,06"
01/26/2024,20779,,10722,Terminal SE - Transferencia TPV,180000,0,"15538534,06"
01/26/2024,20780,,10724,Terminal SE - Transferencia TPV,84457,0,"15622991,06"
01/26/2024,20781,,10735,Terminal SE - Transferencia TPV,105107,0,"15728098,06"
01/26/2024,20782,,10743,Terminal SE - Transferencia TPV,"83801,99",0,"15811900,05"
01/26/2024,20783,,10746,Terminal SE - Transferencia TPV,"73000,01",0,"15884900,06"
01/26/2024,20784,,10750,Terminal SE - Transferencia TPV,"143676,01",0,"16028576,07"
01/26/2024,20893,,10762,Terminal LS - Transferencia TPV,"74700,99",0,"15487377,08"
01/26/2024,20880,,10712,Terminal LS - Transferencia TPV,"172000,01",0,"15659377,09"
01/26/2024,20881,,10713,Terminal LS - Transferencia TPV,90030,0,"15749407,09"
01/26/2024,20876,,10703,Terminal LS - Transferencia TPV,59000,0,"15808407,09"
01/26/2024,20890,,10754,Terminal LS - Transferencia TPV,"111662,98",0,"15920070,07"
01/26/2024,20398,,,Terminal SE - Transferencia TPV,0,1096707,"14823363,07"
01/26/2024,20776,,10715,Terminal SE - Transferencia TPV,73600,0,"14896963,07"
01/26/2024,20777,,10715,Terminal SE - Transferencia TPV,2765,0,"14899728,07"
01/26/2024,20768,,10687,Terminal SE - Transferencia TPV,72985,0,"14972713,07"
01/26/2024,20769,,10688,Terminal SE - Transferencia TPV,84000,0,"15056713,07"
01/26/2024,20770,,10693,Terminal SE - Transferencia TPV,"100000,01",0,"15156713,08"
01/26/2024,20771,,10698,Terminal SE - Transferencia TPV,60967,0,"15217680,08"
01/26/2024,20398,,,Terminal SE - Transferencia TPV,1096707,0,"16314387,08"
01/26/2024,20886,,10738,Terminal LS - Transferencia TPV,"800000,03",0,"17114387,11"
01/26/2024,20878,,10709,Terminal LS - Transferencia TPV,61185,0,"17175572,11"
01/26/2024,20885,,10737,Terminal LS - Transferencia TPV,"83925,99",0,"17259498,1"
01/26/2024,20882,,10719,Terminal LS - Transferencia TPV,46708,0,"16911006,1"
01/26/2024,20884,,10734,Terminal LS - Transferencia TPV,"77355,99",0,"16988362,09"
01/26/2024,20883,,10723,Terminal LS - Transferencia TPV,"118500,01",0,"17058862,1"
01/27/2024,21451,,10796,Terminal SE - Transferencia TPV,114000,0,"17172862,1"
01/27/2024,21476,,10860,Terminal SE - Transferencia TPV,57000,0,"17229862,1"
01/27/2024,21436,,10768,Terminal SE - Transferencia TPV,74750,0,"17304612,1"
01/27/2024,21477,,10865,Terminal SE - Transferencia TPV,106000,0,"17410612,1"
01/27/2024,21442,,10778,Terminal SE - Transferencia TPV,79541,0,"17490153,1"
01/27/2024,21471,,10849,Terminal SE - Transferencia TPV,60000,0,"17550153,1"
01/27/2024,21472,,10855,Terminal SE - Transferencia TPV,"65499,99",0,"17615653,09"
01/27/2024,21470,,10846,Terminal SE - Transferencia TPV,63000,0,"17678653,09"
01/27/2024,21437,,10769,Terminal SE - Transferencia TPV,"74077,99",0,"17752731,08"
01/27/2024,21473,,10857,Terminal SE - Transferencia TPV,83693,0,"17836424,08"
01/27/2024,21455,,10805,Terminal SE - Transferencia TPV,"354327,99",0,"18190752,07"
01/27/2024,21457,,10807,Terminal SE - Transferencia TPV,57000,0,"18247752,07"
01/27/2024,21458,,10808,Terminal SE - Transferencia TPV,62000,0,"18309752,07"
01/27/2024,21448,,10790,Terminal SE - Transferencia TPV,"85768,99",0,"18395521,06"
01/27/2024,21463,,10830,Terminal SE - Transferencia TPV,97241,0,"18492762,06"
01/27/2024,21467,,10838,Terminal SE - Transferencia TPV,"175428,23",0,"18668190,29"
01/27/2024,21469,,10845,Terminal SE - Transferencia TPV,65500,0,"18733690,29"
01/27/2024,21461,,10825,Terminal SE - Transferencia TPV,177000,0,"18910690,29"
01/27/2024,21456,,10806,Terminal SE - Transferencia TPV,94181,0,"19004871,29"
01/27/2024,21440,,10774,Terminal SE - Transferencia TPV,"249110,99",0,"19253982,28"
01/27/2024,21452,,10799,Terminal SE - Transferencia TPV,120000,0,"19373982,28"
01/27/2024,21468,,10843,Terminal SE - Transferencia TPV,"180059,01",0,"19554041,29"
01/27/2024,20895,,,Terminal LS - Transferencia TPV,0,3182269,"16371772,29"
01/27/2024,20895,,,Terminal LS - Transferencia TPV,3182269,0,"19554041,29"
01/27/2024,21447,,10788,Terminal SE - Transferencia TPV,166839,0,"19720880,29"
01/27/2024,21439,,10771,Terminal SE - Transferencia TPV,81500,0,"19802380,29"
01/27/2024,21460,,10820,Terminal SE - Transferencia TPV,"377200,02",0,"20179580,31"
01/27/2024,21441,,10775,Terminal SE - Transferencia TPV,390493,0,"20570073,31"
01/27/2024,21465,,10833,Terminal SE - Transferencia TPV,84348,0,"20654421,31"
01/27/2024,21453,,10801,Terminal SE - Transferencia TPV,"69270,01",0,"20723691,32"
01/27/2024,21438,,10770,Terminal SE - Transferencia TPV,"170899,99",0,"20894591,31"
01/27/2024,21474,,10858,Terminal SE - Transferencia TPV,"66975,99",0,"20961567,3"
01/27/2024,21443,,10782,Terminal SE - Transferencia TPV,75389,0,"21036956,3"
01/27/2024,21450,,10792,Terminal SE - Transferencia TPV,170000,0,"21206956,3"
01/27/2024,21445,,10784,Terminal SE - Transferencia TPV,"85768,99",0,"21292725,29"
01/27/2024,21446,,10785,Terminal SE - Transferencia TPV,"59500,01",0,"21352225,3"
01/27/2024,21466,,10836,Terminal SE - Transferencia TPV,146298,0,"21498523,3"
01/27/2024,20785,,,Terminal SE - Transferencia TPV,1523176,0,"23021699,3"
01/27/2024,21444,,10783,Terminal SE - Transferencia TPV,89593,0,"23111292,3"
01/27/2024,20785,,,Terminal SE - Transferencia TPV,0,1523176,"21588116,3"
01/27/2024,21435,,10767,Terminal SE - Transferencia TPV,"50399,99",0,"21638516,29"
01/27/2024,21459,,10816,Terminal SE - Transferencia TPV,86500,0,"21725016,29"
01/27/2024,21462,,10826,Terminal SE - Transferencia TPV,"154055,99",0,"21879072,28"
01/27/2024,21449,,10791,Terminal SE - Transferencia TPV,6528,0,"21885600,28"
01/27/2024,21454,,10802,Terminal SE - Transferencia TPV,60000,0,"21945600,28"
01/27/2024,21464,,10831,Terminal SE - Transferencia TPV,80000,0,"22025600,28"
01/27/2024,21475,,10859,Terminal SE - Transferencia TPV,"212904,01",0,"22238504,29"
01/27/2024,21478,,10869,Terminal SE - Transferencia TPV,"101282,99",0,"22339787,28"
01/28/2024,22067,,10942,Terminal SE - Transferencia TPV,40800,0,"22380587,28"
01/28/2024,22060,,10931,Terminal SE - Transferencia TPV,100700,0,"22481287,28"
01/28/2024,22079,,10980,Terminal SE - Transferencia TPV,75600,0,"22556887,28"
01/28/2024,22052,,10914,Terminal SE - Transferencia TPV,169417,0,"22726304,28"
01/28/2024,22066,,10941,Terminal SE - Transferencia TPV,111000,0,"22837304,28"
01/28/2024,22071,,10962,Terminal SE - Transferencia TPV,96000,0,"22933304,28"
01/28/2024,22065,,10939,Terminal SE - Transferencia TPV,"92105,99",0,"23025410,27"
01/28/2024,22054,,10916,Terminal SE - Transferencia TPV,"97786,99",0,"23123197,26"
01/28/2024,22061,,10932,Terminal SE - Transferencia TPV,"150886,99",0,"23274084,25"
01/28/2024,22059,,10928,Terminal SE - Transferencia TPV,119857,0,"23393941,25"
01/28/2024,22056,,10918,Terminal SE - Transferencia TPV,63000,0,"23456941,25"
01/28/2024,22074,,10968,Terminal SE - Transferencia TPV,42400,0,"23499341,25"
01/28/2024,22064,,10938,Terminal SE - Transferencia TPV,"80043,31",0,"23579384,56"
01/28/2024,22068,,10945,Terminal SE - Transferencia TPV,86861,0,"23666245,56"
01/28/2024,22047,,10907,Terminal SE - Transferencia TPV,88500,0,"23754745,56"
01/28/2024,22078,,10979,Terminal SE - Transferencia TPV,66000,0,"23820745,56"
01/28/2024,22072,,10963,Terminal SE - Transferencia TPV,"65600,24",0,"23886345,8"
01/28/2024,22057,,10919,Terminal SE - Transferencia TPV,42000,0,"23928345,8"
01/28/2024,22063,,10937,Terminal SE - Transferencia TPV,"149248,01",0,"24077593,81"
01/28/2024,22076,,10977,Terminal SE - Transferencia TPV,91231,0,"24168824,81"
01/28/2024,22049,,10909,Terminal SE - Transferencia TPV,189674,0,"24358498,81"
01/28/2024,22053,,10915,Terminal SE - Transferencia TPV,233487,0,"24591985,81"
01/28/2024,22062,,10936,Terminal SE - Transferencia TPV,"402585,03",0,"24994570,84"
01/28/2024,22073,,10964,Terminal SE - Transferencia TPV,"80414,99",0,"25074985,83"
01/28/2024,22055,,10917,Terminal SE - Transferencia TPV,"286217,22",0,"25361203,05"
01/28/2024,22077,,10978,Terminal SE - Transferencia TPV,126500,0,"25487703,05"
01/28/2024,22045,,10905,Terminal SE - Transferencia TPV,72439,0,"25560142,05"
01/28/2024,22044,,10897,Terminal SE - Transferencia TPV,55000,0,"25615142,05"
01/28/2024,22058,,10924,Terminal SE - Transferencia TPV,"239277,99",0,"25854420,04"
01/28/2024,22043,,10895,Terminal SE - Transferencia TPV,87500,0,"25941920,04"
01/28/2024,22050,,10910,Terminal SE - Transferencia TPV,"66429,99",0,"26008350,03"
01/28/2024,22069,,10959,Terminal SE - Transferencia TPV,220157,0,"26228507,03"
01/28/2024,22070,,10961,Terminal SE - Transferencia TPV,"208356,99",0,"26436864,02"
01/28/2024,22075,,10976,Terminal SE - Transferencia TPV,170000,0,"26606864,02"
01/28/2024,22046,,10906,Terminal SE - Transferencia TPV,"186505,99",0,"26793370,01"
01/28/2024,22048,,10908,Terminal SE - Transferencia TPV,296967,0,"27090337,01"
01/28/2024,22051,,10913,Terminal SE - Transferencia TPV,"136500,01",0,"27226837,02"
01/29/2024,22080,,,Terminal SE - Transferencia TPV,0,4887293,"22339544,02"
01/29/2024,22080,,,Terminal SE - Transferencia TPV,4887293,0,"27226837,02"
02/01/2024,22549,,11055,Terminal SE - Transferencia TPV,"59999,99",0,"13509530,56"
02/01/2024,22543,,11051,Terminal SE - Transferencia TPV,33200,0,"11932730,56"
02/01/2024,22544,,11052,Terminal SE - Transferencia TPV,64000,0,"11996730,56"
02/01/2024,22545,,11053,Terminal SE - Transferencia TPV,"73000,01",0,"12069730,57"
02/01/2024,22546,,11054,Terminal SE - Transferencia TPV,"66999,99",0,"12136730,56"
02/01/2024,22537,,11025,Terminal SE - Transferencia TPV,"70000,01",0,"12206730,57"
02/01/2024,22548,,11055,Terminal SE - Transferencia TPV,60000,0,"9982670,52"
02/01/2024,22539,,11034,Terminal SE - Transferencia TPV,"60999,99",0,"10043670,51"
02/01/2024,22538,,11029,Terminal SE - Transferencia TPV,85222,0,"10128892,51"
02/01/2024,22540,,11035,Terminal SE - Transferencia TPV,48500,0,"8975857,51"
02/01/2024,22547,,11055,Terminal SE - Transferencia TPV,60000,0,"9035857,51"
02/01/2024,22541,,11037,Terminal SE - Transferencia TPV,181589,0,"8894526,51"
02/01/2024,22542,,11043,Terminal SE - Transferencia TPV,"90903,99",0,"8985430,5"
02/02/2024,22958,,11079,Terminal SE - Transferencia TPV,"130999,99",0,"9116430,49"
02/02/2024,22956,,11071,Terminal SE - Transferencia TPV,"170663,01",0,"9287093,5"
02/02/2024,22957,,11077,Terminal SE - Transferencia TPV,"64999,99",0,"9352093,49"
02/02/2024,22550,,,Terminal SE - Transferencia TPV,954411,0,"10306504,49"
02/02/2024,22550,,,Terminal SE - Transferencia TPV,0,954411,"7589683,79"
02/02/2024,22972,,11136,Terminal SE - Transferencia TPV,"213601,99",0,"7803285,78"
02/02/2024,22971,,11135,Terminal SE - Transferencia TPV,"102703,99",0,"7905989,77"
02/02/2024,22970,,11134,Terminal SE - Transferencia TPV,142474,0,"8048463,77"
02/02/2024,22969,,11131,Terminal SE - Transferencia TPV,61000,0,"8109463,77"
02/02/2024,22968,,11127,Terminal SE - Transferencia TPV,"95819,99",0,"8205283,76"
02/02/2024,22967,,11126,Terminal SE - Transferencia TPV,"69499,99",0,"8274783,75"
02/02/2024,22966,,11121,Terminal SE - Transferencia TPV,11600,0,"8286383,75"
02/02/2024,22965,,11120,Terminal SE - Transferencia TPV,103469,0,"8389852,75"
02/02/2024,22964,,11112,Terminal SE - Transferencia TPV,"87953,99",0,"8477806,74"
02/02/2024,22963,,11111,Terminal SE - Transferencia TPV,"150559,01",0,"8628365,75"
02/02/2024,22962,,11101,Terminal SE - Transferencia TPV,"195573,99",0,"8823939,74"
02/02/2024,22961,,11087,Terminal SE - Transferencia TPV,"84129,99",0,"8908069,73"
02/02/2024,22960,,11086,Terminal SE - Transferencia TPV,57000,0,"8965069,73"
02/02/2024,22959,,11080,Terminal SE - Transferencia TPV,125000,0,"9090069,73"
02/03/2024,23677,,11241,Terminal SE - Transferencia TPV,116000,0,"9206069,73"
02/03/2024,23671,,11230,Terminal SE - Transferencia TPV,59500,0,"9265569,73"
02/03/2024,23644,,11162,Terminal SE - Transferencia TPV,"92870,01",0,"9358439,74"
02/03/2024,23642,,11151,Terminal SE - Transferencia TPV,"68000,01",0,"9426439,75"
02/03/2024,23676,,11239,Terminal SE - Transferencia TPV,64500,0,"9490939,75"
02/03/2024,23669,,11226,Terminal SE - Transferencia TPV,72111,0,"9563050,75"
02/03/2024,23672,,11235,Terminal SE - Transferencia TPV,68000,0,"9631050,75"
02/03/2024,23653,,11173,Terminal SE - Transferencia TPV,"167821,99",0,"9798872,74"
02/03/2024,23670,,11228,Terminal SE - Transferencia TPV,85222,0,"9884094,74"
02/03/2024,23661,,11203,Terminal SE - Transferencia TPV,284839,0,"10168933,74"
02/03/2024,23655,,11180,Terminal SE - Transferencia TPV,63500,0,"10232433,74"
02/03/2024,23678,,11242,Terminal SE - Transferencia TPV,"223216,99",0,"10455650,73"
02/03/2024,23662,,11205,Terminal SE - Transferencia TPV,"150995,99",0,"10606646,72"
02/03/2024,23646,,11164,Terminal SE - Transferencia TPV,"145751,99",0,"10752398,71"
02/03/2024,23643,,11161,Terminal SE - Transferencia TPV,"169024,01",0,"10921422,72"
02/03/2024,23687,,11254,Terminal SE - Transferencia TPV,100000,0,"11021422,72"
02/03/2024,23686,,11254,Terminal SE - Transferencia TPV,100000,0,"11121422,72"
02/03/2024,23685,,11251,Terminal SE - Transferencia TPV,"118245,99",0,"11239668,71"
02/03/2024,23654,,11177,Terminal SE - Transferencia TPV,"121999,99",0,"11361668,7"
02/03/2024,23668,,11225,Terminal SE - Transferencia TPV,91500,0,"11453168,7"
02/03/2024,23665,,11218,Terminal SE - Transferencia TPV,"389071,98",0,"11842240,68"
02/03/2024,23663,,11213,Terminal SE - Transferencia TPV,78300,0,"11920540,68"
02/03/2024,23652,,11172,Terminal SE - Transferencia TPV,"220000,01",0,"12140540,69"
02/03/2024,23666,,11219,Terminal SE - Transferencia TPV,"113799,99",0,"12254340,68"
02/03/2024,23684,,11251,Terminal SE - Transferencia TPV,118300,0,"12372640,68"
02/03/2024,23679,,11245,Terminal SE - Transferencia TPV,"5257,01",0,"12377897,69"
02/03/2024,23659,,11195,Terminal SE - Transferencia TPV,"130208,99",0,"12508106,68"
02/03/2024,23658,,11195,Terminal SE - Transferencia TPV,100000,0,"12608106,68"
02/03/2024,22973,,,Terminal SE - Transferencia TPV,0,1867081,"10741025,68"
02/03/2024,22973,,,Terminal SE - Transferencia TPV,1867081,0,"12608106,68"
02/03/2024,23657,,11194,Terminal SE - Transferencia TPV,72220,0,"12330326,68"
02/03/2024,23682,,11249,Terminal SE - Transferencia TPV,"79999,99",0,"12410326,67"
02/03/2024,23650,,11170,Terminal SE - Transferencia TPV,71500,0,"12481826,67"
02/03/2024,23660,,11196,Terminal SE - Transferencia TPV,59000,0,"12540826,67"
02/03/2024,23674,,11237,Terminal SE - Transferencia TPV,125000,0,"12665826,67"
02/03/2024,23675,,11238,Terminal SE - Transferencia TPV,"62500,01",0,"12728326,68"
02/03/2024,23681,,11248,Terminal SE - Transferencia TPV,85987,0,"12814313,68"
02/03/2024,23664,,11217,Terminal SE - Transferencia TPV,355639,0,"13169952,68"
02/03/2024,23680,,11247,Terminal SE - Transferencia TPV,"159999,99",0,"13329952,67"
02/03/2024,23648,,11166,Terminal SE - Transferencia TPV,"131000,01",0,"13460952,68"
02/03/2024,23667,,11220,Terminal SE - Transferencia TPV,155000,0,"13615952,68"
02/03/2024,23645,,11163,Terminal SE - Transferencia TPV,98224,0,"13714176,68"
02/03/2024,23647,,11165,Terminal SE - Transferencia TPV,"179999,99",0,"13894176,67"
02/03/2024,23641,,11149,Terminal SE - Transferencia TPV,"238999,99",0,"14133176,66"
02/03/2024,23649,,11168,Terminal SE - Transferencia TPV,"95055,99",0,"14228232,65"
02/03/2024,23651,,11171,Terminal SE - Transferencia TPV,61000,0,"14289232,65"
02/03/2024,23640,,11148,Terminal SE - Transferencia TPV,"326999,98",0,"14616232,63"
02/03/2024,23656,,11193,Terminal SE - Transferencia TPV,"138500,01",0,"14754732,64"
02/03/2024,23673,,11236,Terminal SE - Transferencia TPV,"124000,01",0,"14878732,65"
02/03/2024,23683,,11250,Terminal SE - Transferencia TPV,104800,0,"14983532,65"
02/04/2024,24270,,11348,Terminal SE - Transferencia TPV,56960,0,"15040492,65"
02/04/2024,24267,,11336,Terminal SE - Transferencia TPV,"59500,01",0,"15099992,66"
02/04/2024,23688,,,Terminal SE - Transferencia TPV,6243504,0,"21343496,66"
02/04/2024,24260,,11318,Terminal SE - Transferencia TPV,"332803,99",0,"21676300,65"
02/04/2024,24268,,11338,Terminal SE - Transferencia TPV,99000,0,"21775300,65"
02/04/2024,23688,,,Terminal SE - Transferencia TPV,0,6243504,"15531796,65"
02/04/2024,24257,,11303,Terminal SE - Transferencia TPV,114000,0,"15645796,65"
02/04/2024,24271,,11349,Terminal SE - Transferencia TPV,20000,0,"15665796,65"
02/04/2024,24247,,11269,Terminal SE - Transferencia TPV,"120949,99",0,"15786746,64"
02/04/2024,24263,,11331,Terminal SE - Transferencia TPV,56000,0,"15842746,64"
02/04/2024,24266,,11335,Terminal SE - Transferencia TPV,"129499,99",0,"15972246,63"
02/04/2024,24248,,11270,Terminal SE - Transferencia TPV,"75607,01",0,"16047853,64"
02/04/2024,24258,,11314,Terminal SE - Transferencia TPV,"133499,99",0,"16181353,63"
02/04/2024,24262,,11330,Terminal SE - Transferencia TPV,58300,0,"16239653,63"
02/04/2024,24261,,11328,Terminal SE - Transferencia TPV,"150917,01",0,"16390570,64"
02/04/2024,24259,,11315,Terminal SE - Transferencia TPV,150450,0,"16541020,64"
02/04/2024,24264,,11333,Terminal SE - Transferencia TPV,"101000,01",0,"16642020,65"
02/04/2024,24269,,11339,Terminal SE - Transferencia TPV,82600,0,"16724620,65"
02/05/2024,24272,,,Terminal SE - Transferencia TPV,2989155,0,"19713775,65"
02/05/2024,24272,,,Terminal SE - Transferencia TPV,0,2989155,"16724620,65"
02/08/2024,24413,,11373,Terminal SE - Transferencia TPV,"146999,99",0,"11390620,39"
02/08/2024,24412,,11372,Terminal SE - Transferencia TPV,"256412,98",0,"11647033,37"
02/08/2024,24411,,11371,Terminal SE - Transferencia TPV,62000,0,"11709033,37"
02/08/2024,24402,,11359,Terminal SE - Transferencia TPV,153619,0,"11862652,37"
02/08/2024,24403,,11360,Terminal SE - Transferencia TPV,"150777,99",0,"12013430,36"
02/08/2024,24404,,11361,Terminal SE - Transferencia TPV,"65799,99",0,"12079230,35"
02/08/2024,24405,,11362,Terminal SE - Transferencia TPV,74000,0,"12153230,35"
02/08/2024,24406,,11363,Terminal SE - Transferencia TPV,"10000,01",0,"12163230,36"
02/08/2024,24410,,11370,Terminal SE - Transferencia TPV,63698,0,"12226928,36"
02/08/2024,24407,,11367,Terminal SE - Transferencia TPV,101710,0,"12328638,36"
02/08/2024,24408,,11368,Terminal SE - Transferencia TPV,92324,0,"12420962,36"
02/08/2024,24409,,11369,Terminal SE - Transferencia TPV,"204095,99",0,"12298758,35"
02/09/2024,24533,,11392,Terminal SE - Transferencia TPV,"132640,99",0,"12431399,34"
02/09/2024,24535,,11394,Terminal SE - Transferencia TPV,62960,0,"12494359,34"
02/09/2024,24536,,11395,Terminal SE - Transferencia TPV,"83692,99",0,"12578052,33"
02/09/2024,24537,,11396,Terminal SE - Transferencia TPV,81835,0,"12659887,33"
02/09/2024,24520,,11376,Terminal SE - Transferencia TPV,"78229,99",0,"12738117,32"
02/09/2024,24414,,,Terminal SE - Transferencia TPV,1381458,0,"14119575,32"
02/09/2024,24414,,,Terminal SE - Transferencia TPV,0,1381458,"12738117,32"
02/09/2024,24522,,11379,Terminal SE - Transferencia TPV,64500,0,"12802617,32"
02/09/2024,24523,,11380,Terminal SE - Transferencia TPV,15200,0,"12817817,32"
02/09/2024,24521,,11378,Terminal SE - Transferencia TPV,352033,0,"13169850,32"
02/09/2024,24519,,11375,Terminal SE - Transferencia TPV,9000,0,"13178850,32"
02/09/2024,24524,,11381,Terminal SE - Transferencia TPV,64700,0,"13243550,32"
02/09/2024,24525,,11382,Terminal SE - Transferencia TPV,179000,0,"13422550,32"
02/09/2024,24526,,11384,Terminal SE - Transferencia TPV,65500,0,"13488050,32"
02/09/2024,24541,,11402,Terminal SE - Transferencia TPV,"93962,99",0,"13582013,31"
02/09/2024,24540,,11400,Terminal SE - Transferencia TPV,"57907,01",0,"13639920,32"
02/09/2024,24539,,11399,Terminal SE - Transferencia TPV,"115814,99",0,"13755735,31"
02/09/2024,24538,,11398,Terminal SE - Transferencia TPV,120000,0,"13875735,31"
02/09/2024,24527,,11385,Terminal SE - Transferencia TPV,"105000,01",0,"13980735,32"
02/09/2024,24528,,11386,Terminal SE - Transferencia TPV,111000,0,"14091735,32"
02/09/2024,24529,,11388,Terminal SE - Transferencia TPV,80000,0,"14171735,32"
02/09/2024,24530,,11389,Terminal SE - Transferencia TPV,"61000,01",0,"14232735,33"
02/09/2024,24531,,11390,Terminal SE - Transferencia TPV,54000,0,"14286735,33"
02/09/2024,24532,,11391,Terminal SE - Transferencia TPV,199398,0,"14486133,33"
02/09/2024,24534,,11393,Terminal SE - Transferencia TPV,"209230,98",0,"14695364,31"
02/10/2024,24813,,11405,Terminal SE - Transferencia TPV,154602,0,"14849966,31"
02/10/2024,24818,,11412,Terminal SE - Transferencia TPV,69500,0,"14919466,31"
02/10/2024,24812,,11404,Terminal SE - Transferencia TPV,80961,0,"15000427,31"
02/10/2024,24826,,11425,Terminal SE - Transferencia TPV,"90000,01",0,"15090427,32"
02/10/2024,24817,,11411,Terminal SE - Transferencia TPV,112600,0,"15203027,32"
02/10/2024,24838,,11446,Terminal SE - Transferencia TPV,"58499,99",0,"15261527,31"
02/10/2024,24835,,11442,Terminal SE - Transferencia TPV,245615,0,"15507142,31"
02/10/2024,24832,,11437,Terminal SE - Transferencia TPV,"99207,01",0,"15606349,32"
02/10/2024,24542,,,Terminal SE - Transferencia TPV,0,2396707,"13209642,32"
02/10/2024,24831,,11435,Terminal SE - Transferencia TPV,"102703,99",0,"13312346,31"
02/10/2024,24843,,11453,Terminal SE - Transferencia TPV,63450,0,"13375796,31"
02/10/2024,24819,,11416,Terminal SE - Transferencia TPV,"111707,1",0,"13487503,41"
02/10/2024,24841,,11450,Terminal SE - Transferencia TPV,"235890,99",0,"13723394,4"
02/10/2024,24811,,11403,Terminal SE - Transferencia TPV,114000,0,"13837394,4"
02/10/2024,24842,,11451,Terminal SE - Transferencia TPV,"166000,01",0,"14003394,41"
02/10/2024,24542,,,Terminal SE - Transferencia TPV,2396707,0,"16400101,41"
02/10/2024,24814,,11406,Terminal SE - Transferencia TPV,"197373,98",0,"16597475,39"
02/10/2024,24844,,11454,Terminal SE - Transferencia TPV,65000,0,"16662475,39"
02/10/2024,24824,,11423,Terminal SE - Transferencia TPV,179622,0,"16842097,39"
02/10/2024,24833,,11440,Terminal SE - Transferencia TPV,71565,0,"16913662,39"
02/10/2024,24840,,11449,Terminal SE - Transferencia TPV,174269,0,"17087931,39"
02/10/2024,24825,,11424,Terminal SE - Transferencia TPV,"66500,01",0,"17154431,4"
02/10/2024,24829,,11429,Terminal SE - Transferencia TPV,"87999,99",0,"17242431,39"
02/10/2024,24822,,11420,Terminal SE - Transferencia TPV,77500,0,"17319931,39"
02/10/2024,24834,,11441,Terminal SE - Transferencia TPV,105112,0,"17425043,39"
02/10/2024,24837,,11444,Terminal SE - Transferencia TPV,79213,0,"17504256,39"
02/10/2024,24828,,11428,Terminal SE - Transferencia TPV,"111499,99",0,"17615756,38"
02/10/2024,24830,,11432,Terminal SE - Transferencia TPV,"354939,99",0,"17970696,37"
02/10/2024,24823,,11421,Terminal SE - Transferencia TPV,128000,0,"18098696,37"
02/10/2024,24836,,11443,Terminal SE - Transferencia TPV,92543,0,"18191239,37"
02/10/2024,24839,,11448,Terminal SE - Transferencia TPV,"222014,99",0,"18413254,36"
02/10/2024,24827,,11426,Terminal SE - Transferencia TPV,96967,0,"18510221,36"
02/10/2024,24820,,11417,Terminal SE - Transferencia TPV,176156,0,"18686377,36"
02/10/2024,24816,,11407,Terminal SE - Transferencia TPV,123000,0,"18809377,36"
02/10/2024,24815,,11407,Terminal SE - Transferencia TPV,115000,0,"18924377,36"
02/10/2024,24845,,11455,Terminal SE - Transferencia TPV,"122000,01",0,"19046377,37"
02/10/2024,24821,,11418,Terminal SE - Transferencia TPV,"304833,01",0,"19351210,38"
02/11/2024,24846,,,Terminal SE - Transferencia TPV,0,4655916,"14695294,38"
02/11/2024,25207,,11490,Terminal SE - Transferencia TPV,96039,0,"14791333,38"
02/11/2024,25197,,11476,Terminal SE - Transferencia TPV,71128,0,"14862461,38"
02/11/2024,25169,,11482,Terminal SE - Efectivo TPV,18600,0,"14881061,38"
02/11/2024,25187,,11462,Terminal SE - Transferencia TPV,"135000,01",0,"15016061,39"
02/11/2024,25190,,11469,Terminal SE - Transferencia TPV,"412999,99",0,"15429061,38"
02/11/2024,25196,,11475,Terminal SE - Transferencia TPV,65500,0,"15494561,38"
02/11/2024,24866,,,Terminal SE - Efectivo TPV,2685900,0,"18180461,38"
02/11/2024,25174,,11494,Terminal SE - Efectivo TPV,251400,0,"18431861,38"
02/11/2024,25173,,11493,Terminal SE - Efectivo TPV,65000,0,"18496861,38"
02/11/2024,25172,,11492,Terminal SE - Efectivo TPV,"108712,99",0,"18605574,37"
02/11/2024,25175,,11497,Terminal SE - Efectivo TPV,72600,0,"18678174,37"
02/11/2024,25178,,11505,Terminal SE - Efectivo TPV,"79399,99",0,"18757574,36"
02/11/2024,25177,,11503,Terminal SE - Efectivo TPV,73400,0,"18830974,36"
02/11/2024,25203,,11486,Terminal SE - Transferencia TPV,234689,0,"19065663,36"
02/11/2024,25183,,11458,Terminal SE - Transferencia TPV,"183555,99",0,"19249219,35"
02/11/2024,25208,,11491,Terminal SE - Transferencia TPV,"89046,01",0,"19338265,36"
02/11/2024,25198,,11477,Terminal SE - Transferencia TPV,"126412,99",0,"19464678,35"
02/11/2024,25171,,11484,Terminal SE - Efectivo TPV,"111634,98",0,"19576313,33"
02/11/2024,25170,,11483,Terminal SE - Efectivo TPV,100900,0,"19677213,33"
02/11/2024,25211,,11496,Terminal SE - Transferencia TPV,111000,0,"19788213,33"
02/11/2024,25200,,11480,Terminal SE - Transferencia TPV,"260000,01",0,"20048213,34"
02/11/2024,25195,,11474,Terminal SE - Transferencia TPV,"173612,99",0,"20221826,33"
02/11/2024,25212,,11499,Terminal SE - Transferencia TPV,"94945,99",0,"20316772,32"
02/11/2024,25193,,11472,Terminal SE - Transferencia TPV,"207710,01",0,"20524482,33"
02/11/2024,25194,,11473,Terminal SE - Transferencia TPV,"125799,99",0,"20650282,32"
02/11/2024,25204,,11487,Terminal SE - Transferencia TPV,"93599,99",0,"20743882,31"
02/11/2024,25176,,11498,Terminal SE - Efectivo TPV,"137885,01",0,"20881767,32"
02/11/2024,25206,,11489,Terminal SE - Transferencia TPV,"120999,99",0,"21002767,31"
02/11/2024,25188,,11464,Terminal SE - Transferencia TPV,"116579,99",0,"21119347,3"
02/11/2024,25184,,11459,Terminal SE - Transferencia TPV,"174999,98",0,"21294347,28"
02/11/2024,25205,,11488,Terminal SE - Transferencia TPV,100300,0,"21394647,28"
02/11/2024,25191,,11470,Terminal SE - Transferencia TPV,160000,0,"21554647,28"
02/11/2024,25215,,11502,Terminal SE - Transferencia TPV,68600,0,"21623247,28"
02/11/2024,25182,,11457,Terminal SE - Transferencia TPV,86096,0,"21709343,28"
02/11/2024,25189,,11465,Terminal SE - Transferencia TPV,48500,0,"21757843,28"
02/11/2024,25202,,11485,Terminal SE - Transferencia TPV,"116579,99",0,"21874423,27"
02/11/2024,25214,,11501,Terminal SE - Transferencia TPV,"89999,99",0,"21964423,26"
02/11/2024,25199,,11478,Terminal SE - Transferencia TPV,62000,0,"22026423,26"
02/11/2024,25216,,11504,Terminal SE - Transferencia TPV,169745,0,"22196168,26"
02/11/2024,25217,,11506,Terminal SE - Transferencia TPV,76481,0,"22272649,26"
02/11/2024,25185,,11460,Terminal SE - Transferencia TPV,67000,0,"22339649,26"
02/11/2024,25213,,11500,Terminal SE - Transferencia TPV,"215701,99",0,"22555351,25"
02/11/2024,25210,,11495,Terminal SE - Transferencia TPV,"56460,99",0,"22611812,24"
02/11/2024,25209,,11495,Terminal SE - Transferencia TPV,113000,0,"22724812,24"
02/11/2024,25201,,11484,Terminal SE - Transferencia TPV,100000,0,"22824812,24"
02/11/2024,25192,,11471,Terminal SE - Transferencia TPV,234000,0,"23058812,24"
02/11/2024,25186,,11461,Terminal SE - Transferencia TPV,138000,0,"23196812,24"
02/11/2024,25181,,11456,Terminal SE - Transferencia TPV,88000,0,"23284812,24"
02/11/2024,25180,,11456,Terminal SE - Transferencia TPV,88000,0,"23372812,24"
02/12/2024,25218,,,Terminal SE - Transferencia TPV,4972061,0,"28344873,24"
02/12/2024,25179,,,Terminal SE - Efectivo TPV,2016900,0,"30361773,24"
02/12/2024,25179,,,Terminal SE - Efectivo TPV,0,2016900,"28344873,24"
02/12/2024,25218,,,Terminal SE - Transferencia TPV,0,4972061,"23372812,24"
02/15/2024,25649,,11566,Terminal SE - Transferencia TPV,91778,0,"13537291,84"
02/15/2024,25647,,11557,Terminal SE - Transferencia TPV,96800,0,"13634091,84"
02/15/2024,25648,,11560,Terminal SE - Transferencia TPV,55500,0,"13689591,84"
02/15/2024,25650,,11570,Terminal SE - Transferencia TPV,146700,0,"13836291,84"
02/15/2024,25651,,11582,Terminal SE - Transferencia TPV,"65499,99",0,"13901791,83"
02/16/2024,26002,,11642,Terminal SE - Transferencia TPV,97963,0,"7922760,07"
02/16/2024,26003,,11648,Terminal SE - Transferencia TPV,"107073,99",0,"8029834,06"
02/16/2024,25994,,11625,Terminal SE - Transferencia TPV,31900,0,"8061734,06"
02/16/2024,25984,,11591,Terminal SE - Transferencia TPV,132969,0,"7188328,06"
02/16/2024,25985,,11592,Terminal SE - Transferencia TPV,"107000,01",0,"7295328,07"
02/16/2024,25652,,,Terminal SE - Transferencia TPV,0,456278,"6394400,07"
02/16/2024,25652,,,Terminal SE - Transferencia TPV,456278,0,"6850678,07"
02/16/2024,25992,,11621,Terminal SE - Transferencia TPV,"83100,01",0,"6933778,08"
02/16/2024,25995,,11627,Terminal SE - Transferencia TPV,"64500,01",0,"6998278,09"
02/16/2024,25996,,11629,Terminal SE - Transferencia TPV,"100518,99",0,"7098797,08"
02/16/2024,25997,,11633,Terminal SE - Transferencia TPV,64000,0,"7162797,08"
02/16/2024,25998,,11634,Terminal SE - Transferencia TPV,"93999,99",0,"7256797,07"
02/16/2024,25999,,11635,Terminal SE - Transferencia TPV,"271000,01",0,"7527797,08"
02/16/2024,26000,,11636,Terminal SE - Transferencia TPV,"168499,99",0,"7696297,07"
02/16/2024,26004,,11649,Terminal SE - Transferencia TPV,"327887,01",0,"8024184,08"
02/16/2024,26005,,11650,Terminal SE - Transferencia TPV,"77355,99",0,"8101540,07"
02/16/2024,26006,,11656,Terminal SE - Transferencia TPV,"130000,01",0,"8231540,08"
02/16/2024,26001,,11641,Terminal SE - Transferencia TPV,75389,0,"6554200,08"
02/16/2024,25991,,11620,Terminal SE - Transferencia TPV,"21945,99",0,"4496361,07"
02/16/2024,25993,,11625,Terminal SE - Transferencia TPV,31900,0,"4528261,07"
02/16/2024,25986,,11593,Terminal SE - Transferencia TPV,61000,0,"4121315,07"
02/16/2024,25987,,11603,Terminal SE - Transferencia TPV,97131,0,"4218446,07"
02/16/2024,25988,,11605,Terminal SE - Transferencia TPV,63000,0,"4281446,07"
02/16/2024,25989,,11614,Terminal SE - Transferencia TPV,"87188,99",0,"4368635,06"
02/16/2024,25990,,11616,Terminal SE - Transferencia TPV,114774,0,"4483409,06"
02/17/2024,26700,,11686,Terminal SE - Transferencia TPV,245833,0,"2826011,06"
02/17/2024,26709,,11709,Terminal SE - Transferencia TPV,95930,0,"2921941,06"
02/17/2024,26703,,11695,Terminal SE - Transferencia TPV,"137338,99",0,"3059280,05"
02/17/2024,26732,,11762,Terminal SE - Transferencia TPV,"116907,01",0,"3176187,06"
02/17/2024,26702,,11693,Terminal SE - Transferencia TPV,85331,0,"3261518,06"
02/17/2024,26727,,11749,Terminal SE - Transferencia TPV,"62000,01",0,"3323518,07"
02/17/2024,26714,,11722,Terminal SE - Transferencia TPV,"347881,01",0,"3671399,08"
02/17/2024,26719,,11735,Terminal SE - Transferencia TPV,"94074,01",0,"3765473,09"
02/17/2024,26697,,11680,Terminal SE - Transferencia TPV,"162795,99",0,"3928269,08"
02/17/2024,26715,,11723,Terminal SE - Transferencia TPV,"178000,01",0,"4106269,09"
02/17/2024,26716,,11726,Terminal SE - Transferencia TPV,152744,0,"4259013,09"
02/17/2024,26710,,11710,Terminal SE - Transferencia TPV,"214213,99",0,"4473227,08"
02/17/2024,26722,,11739,Terminal SE - Transferencia TPV,160502,0,"4633729,08"
02/17/2024,26701,,11692,Terminal SE - Transferencia TPV,120185,0,"4753914,08"
02/17/2024,26728,,11751,Terminal SE - Transferencia TPV,"103031,01",0,"4856945,09"
02/17/2024,26704,,11699,Terminal SE - Transferencia TPV,80852,0,"4937797,09"
02/17/2024,26007,,,Terminal SE - Transferencia TPV,2410161,0,"7347958,09"
02/17/2024,26007,,,Terminal SE - Transferencia TPV,0,2410161,"4937797,09"
02/17/2024,26733,,11765,Terminal SE - Transferencia TPV,92870,0,"5030667,09"
02/17/2024,26721,,11738,Terminal SE - Transferencia TPV,"348537,01",0,"5379204,1"
02/17/2024,26718,,11734,Terminal SE - Transferencia TPV,152963,0,"5532167,1"
02/17/2024,26707,,11705,Terminal SE - Transferencia TPV,"119093,01",0,"5651260,11"
02/17/2024,26706,,11704,Terminal SE - Transferencia TPV,97241,0,"5748501,11"
02/17/2024,26720,,11737,Terminal SE - Transferencia TPV,391913,0,"6140414,11"
02/17/2024,26735,,11775,Terminal SE - Transferencia TPV,119311,0,"6259725,11"
02/17/2024,26696,,11679,Terminal SE - Transferencia TPV,157000,0,"6416725,11"
02/17/2024,26713,,11718,Terminal SE - Transferencia TPV,71500,0,"6488225,11"
02/17/2024,26708,,11706,Terminal SE - Transferencia TPV,86100,0,"6574325,11"
02/17/2024,26712,,11717,Terminal SE - Transferencia TPV,97459,0,"6671784,11"
02/17/2024,26734,,11774,Terminal SE - Transferencia TPV,"119966,4",0,"6791750,51"
02/17/2024,26726,,11748,Terminal SE - Transferencia TPV,108931,0,"6900681,51"
02/17/2024,26711,,11715,Terminal SE - Transferencia TPV,"84200,01",0,"6984881,52"
02/17/2024,26699,,11684,Terminal SE - Transferencia TPV,221359,0,"7206240,52"
02/17/2024,26705,,11701,Terminal SE - Transferencia TPV,"78499,99",0,"7284740,51"
02/17/2024,26729,,11752,Terminal SE - Transferencia TPV,128000,0,"7412740,51"
02/17/2024,26695,,11678,Terminal SE - Transferencia TPV,"89592,99",0,"7502333,5"
02/17/2024,26730,,11754,Terminal SE - Transferencia TPV,"71599,99",0,"7573933,49"
02/17/2024,26731,,11758,Terminal SE - Transferencia TPV,101283,0,"7675216,49"
02/17/2024,26698,,11683,Terminal SE - Transferencia TPV,141381,0,"7816597,49"
02/17/2024,26723,,11744,Terminal SE - Transferencia TPV,219611,0,"8036208,49"
02/17/2024,26724,,11745,Terminal SE - Transferencia TPV,78100,0,"8114308,49"
02/17/2024,26717,,11730,Terminal SE - Transferencia TPV,165000,0,"8279308,49"
02/17/2024,26725,,11747,Terminal SE - Transferencia TPV,87735,0,"8367043,49"
02/17/2024,26736,,11785,Terminal SE - Transferencia TPV,"154929,99",0,"8521973,48"
02/18/2024,27391,,11835,Terminal SE - Transferencia TPV,61259,0,"8583232,48"
02/18/2024,27405,,11862,Terminal SE - Transferencia TPV,57500,0,"8640732,48"
02/18/2024,27418,,11908,Terminal SE - Transferencia TPV,"70799,99",0,"8711532,47"
02/18/2024,27389,,11831,Terminal SE - Transferencia TPV,77407,0,"8788939,47"
02/18/2024,27383,,11821,Terminal SE - Transferencia TPV,115269,0,"8904208,47"
02/18/2024,27402,,11855,Terminal SE - Transferencia TPV,"122479,99",0,"9026688,46"
02/18/2024,27379,,11811,Terminal SE - Transferencia TPV,"125849,99",0,"9152538,45"
02/18/2024,27399,,11852,Terminal SE - Transferencia TPV,"269999,99",0,"9422538,44"
02/18/2024,27397,,11848,Terminal SE - Transferencia TPV,182791,0,"9605329,44"
02/18/2024,27401,,11854,Terminal SE - Transferencia TPV,"152525,99",0,"9757855,43"
02/18/2024,27390,,11833,Terminal SE - Transferencia TPV,141000,0,"9898855,43"
02/18/2024,27404,,11861,Terminal SE - Transferencia TPV,64000,0,"9962855,43"
02/18/2024,27403,,11860,Terminal SE - Transferencia TPV,82000,0,"10044855,43"
02/18/2024,27394,,11840,Terminal SE - Transferencia TPV,"137999,99",0,"10182855,42"
02/18/2024,26737,,,Terminal SE - Transferencia TPV,0,5941463,"4241392,42"
02/18/2024,27382,,11819,Terminal SE - Transferencia TPV,100000,0,"4341392,42"
02/18/2024,27385,,11824,Terminal SE - Transferencia TPV,90000,0,"4431392,42"
02/18/2024,27386,,11824,Terminal SE - Transferencia TPV,90000,0,"4521392,42"
02/18/2024,27387,,11824,Terminal SE - Transferencia TPV,90000,0,"4611392,42"
02/18/2024,27388,,11826,Terminal SE - Transferencia TPV,86970,0,"4698362,42"
02/18/2024,27410,,11873,Terminal SE - Transferencia TPV,"87999,99",0,"4786362,41"
02/18/2024,27380,,11815,Terminal SE - Transferencia TPV,"157035,99",0,"4943398,4"
02/18/2024,27393,,11839,Terminal SE - Transferencia TPV,111663,0,"5055061,4"
02/18/2024,27411,,11877,Terminal SE - Transferencia TPV,"176999,99",0,"5232061,39"
02/18/2024,27392,,11837,Terminal SE - Transferencia TPV,"87953,99",0,"5320015,38"
02/18/2024,27415,,11904,Terminal SE - Transferencia TPV,63000,0,"5383015,38"
02/18/2024,27381,,11816,Terminal SE - Transferencia TPV,"113078,99",0,"5496094,37"
02/18/2024,27416,,11905,Terminal SE - Transferencia TPV,76600,0,"5572694,37"
02/18/2024,27384,,11822,Terminal SE - Transferencia TPV,91778,0,"5664472,37"
02/18/2024,27417,,11907,Terminal SE - Transferencia TPV,"53499,99",0,"5717972,36"
02/18/2024,27395,,11843,Terminal SE - Transferencia TPV,"63000,01",0,"5780972,37"
02/18/2024,27412,,11881,Terminal SE - Transferencia TPV,"166073,99",0,"5947046,36"
02/18/2024,27409,,11870,Terminal SE - Transferencia TPV,78000,0,"6025046,36"
02/18/2024,27408,,11867,Terminal SE - Transferencia TPV,66500,0,"6091546,36"
02/18/2024,27398,,11851,Terminal SE - Transferencia TPV,172130,0,"6263676,36"
02/18/2024,27407,,11866,Terminal SE - Transferencia TPV,60500,0,"6324176,36"
02/18/2024,27400,,11853,Terminal SE - Transferencia TPV,85300,0,"6409476,36"
02/18/2024,27396,,11844,Terminal SE - Transferencia TPV,"161703,98",0,"6571180,34"
02/18/2024,27414,,11902,Terminal SE - Transferencia TPV,134935,0,"6706115,34"
02/18/2024,26737,,,Terminal SE - Transferencia TPV,5941463,0,"12647578,34"
02/18/2024,27413,,11895,Terminal SE - Transferencia TPV,77246,0,"12724824,34"
02/18/2024,27406,,11864,Terminal SE - Transferencia TPV,"64999,99",0,"12789824,33"
02/19/2024,27419,,,Terminal SE - Transferencia TPV,4268233,0,"17058057,33"
02/19/2024,27419,,,Terminal SE - Transferencia TPV,0,4268233,"8386831,42"
02/22/2024,27781,,11987,Terminal SE - Transferencia TPV,346500,0,"5646310,65"
02/22/2024,27780,,11967,Terminal SE - Transferencia TPV,"83000,01",0,"5729310,66"
02/22/2024,27782,,11988,Terminal SE - Transferencia TPV,119000,0,"5848310,66"
02/23/2024,28015,,12002,Terminal SE - Transferencia TPV,"95164,99",0,"5213284,83"
02/23/2024,27783,,,Terminal SE - Transferencia TPV,0,883218,"4330066,83"
02/23/2024,27783,,,Terminal SE - Transferencia TPV,883218,0,"5213284,83"
02/23/2024,28022,,12037,Terminal SE - Transferencia TPV,100519,0,"5313803,83"
02/23/2024,28021,,12028,Terminal SE - Transferencia TPV,"58800,01",0,"5372603,84"
02/23/2024,28020,,12024,Terminal SE - Transferencia TPV,"66000,01",0,"5438603,85"
02/23/2024,28016,,12011,Terminal SE - Transferencia TPV,61731,0,"5500334,85"
02/23/2024,28017,,12012,Terminal SE - Transferencia TPV,89000,0,"5589334,85"
02/23/2024,28014,,12001,Terminal SE - Transferencia TPV,118000,0,"5707334,85"
02/23/2024,28013,,11999,Terminal SE - Transferencia TPV,69500,0,"5776834,85"
02/23/2024,28019,,12019,Terminal SE - Transferencia TPV,81944,0,"5858778,85"
02/23/2024,28018,,12013,Terminal SE - Transferencia TPV,"61999,99",0,"5920778,84"
02/23/2024,28011,,11997,Terminal SE - Transferencia TPV,58500,0,"5979278,84"
02/23/2024,28012,,11998,Terminal SE - Transferencia TPV,66000,0,"6045278,84"
02/24/2024,28792,,12135,Terminal SE - Transferencia TPV,67500,0,"6112778,84"
02/24/2024,28770,,12068,Terminal SE - Transferencia TPV,"102375,99",0,"6215154,83"
02/24/2024,28768,,12065,Terminal SE - Transferencia TPV,84894,0,"6300048,83"
02/24/2024,28781,,12104,Terminal SE - Transferencia TPV,"129499,99",0,"6429548,82"
02/24/2024,28778,,12089,Terminal SE - Transferencia TPV,64000,0,"6493548,82"
02/24/2024,28805,,12166,Terminal SE - Transferencia TPV,97787,0,"6591335,82"
02/24/2024,28804,,12165,Terminal SE - Transferencia TPV,55200,0,"6646535,82"
02/24/2024,28803,,12165,Terminal SE - Transferencia TPV,110000,0,"6756535,82"
02/24/2024,28784,,12114,Terminal SE - Transferencia TPV,76481,0,"6833016,82"
02/24/2024,28800,,12154,Terminal SE - Transferencia TPV,176017,0,"7009033,82"
02/24/2024,28787,,12119,Terminal SE - Transferencia TPV,131439,0,"7140472,82"
02/24/2024,28793,,12136,Terminal SE - Transferencia TPV,69000,0,"7209472,82"
02/24/2024,28779,,12090,Terminal SE - Transferencia TPV,"204314,99",0,"7413787,81"
02/24/2024,28806,,12167,Terminal SE - Transferencia TPV,181370,0,"7595157,81"
02/24/2024,28783,,12113,Terminal SE - Transferencia TPV,77574,0,"7672731,81"
02/24/2024,28802,,12157,Terminal SE - Transferencia TPV,181698,0,"7854429,81"
02/24/2024,28790,,12128,Terminal SE - Transferencia TPV,99972,0,"7954401,81"
02/24/2024,28795,,12142,Terminal SE - Transferencia TPV,61600,0,"8016001,81"
02/24/2024,28777,,12086,Terminal SE - Transferencia TPV,"201800,01",0,"8101576,62"
02/24/2024,28788,,12121,Terminal SE - Transferencia TPV,69000,0,"8170576,62"
02/24/2024,28772,,12072,Terminal SE - Transferencia TPV,85500,0,"8256076,62"
02/24/2024,28801,,12156,Terminal SE - Transferencia TPV,"136027,99",0,"8392104,61"
02/24/2024,28807,,12174,Terminal SE - Transferencia TPV,"98114,99",0,"8490219,6"
02/24/2024,28789,,12122,Terminal SE - Transferencia TPV,109696,0,"8599915,6"
02/24/2024,28774,,12077,Terminal SE - Transferencia TPV,240000,0,"8839915,6"
02/24/2024,28023,,,Terminal SE - Transferencia TPV,0,927115,"7912800,6"
02/24/2024,28794,,12137,Terminal SE - Transferencia TPV,"53550,01",0,"7966350,61"
02/24/2024,28771,,12069,Terminal SE - Transferencia TPV,88500,0,"8054850,61"
02/24/2024,28769,,12066,Terminal SE - Transferencia TPV,238294,0,"7743836,35"
02/24/2024,28773,,12076,Terminal SE - Transferencia TPV,97787,0,"7841623,35"
02/24/2024,28780,,12095,Terminal SE - Transferencia TPV,"53000,01",0,"7894623,36"
02/24/2024,28785,,12115,Terminal SE - Transferencia TPV,114000,0,"8008623,36"
02/24/2024,28796,,12144,Terminal SE - Transferencia TPV,86500,0,"8095123,36"
02/24/2024,28775,,12084,Terminal SE - Transferencia TPV,224091,0,"8319214,36"
02/24/2024,28776,,12085,Terminal SE - Transferencia TPV,128000,0,"8447214,36"
02/24/2024,28023,,,Terminal SE - Transferencia TPV,927115,0,"9374329,36"
02/24/2024,28798,,12148,Terminal SE - Transferencia TPV,"103795,99",0,"9478125,35"
02/24/2024,28786,,12117,Terminal SE - Transferencia TPV,56000,0,"9534125,35"
02/24/2024,28782,,12105,Terminal SE - Transferencia TPV,"482052,01",0,"10016177,36"
02/24/2024,28791,,12129,Terminal SE - Transferencia TPV,75826,0,"10092003,36"
02/24/2024,28799,,12149,Terminal SE - Transferencia TPV,"147718,99",0,"10239722,35"
02/24/2024,28797,,12146,Terminal SE - Transferencia TPV,207156,0,"10446878,35"
02/25/2024,29485,,12246,Terminal SE - Transferencia TPV,73859,0,"10520737,35"
02/25/2024,29464,,12200,Terminal SE - Transferencia TPV,"126399,99",0,"10647137,34"
02/25/2024,29480,,12238,Terminal SE - Transferencia TPV,"63999,99",0,"10711137,33"
02/25/2024,29483,,12243,Terminal SE - Transferencia TPV,100519,0,"10811656,33"
02/25/2024,29475,,12222,Terminal SE - Transferencia TPV,"95492,99",0,"10907149,32"
02/25/2024,29463,,12197,Terminal SE - Transferencia TPV,91778,0,"10998927,32"
02/25/2024,29495,,12205,Terminal SE - Transferencia TPV,70000,0,"11068927,32"
02/25/2024,29479,,12230,Terminal SE - Transferencia TPV,153356,0,"11222283,32"
02/25/2024,29473,,12219,Terminal SE - Transferencia TPV,90685,0,"11312968,32"
02/25/2024,29490,,12261,Terminal SE - Transferencia TPV,"84999,99",0,"11397968,31"
02/25/2024,28808,,,Terminal SE - Transferencia TPV,5067156,0,"16465124,31"
02/25/2024,29488,,12258,Terminal SE - Transferencia TPV,106200,0,"16571324,31"
02/25/2024,29470,,12214,Terminal SE - Transferencia TPV,97000,0,"16668324,31"
02/25/2024,29492,,12266,Terminal SE - Transferencia TPV,"208999,99",0,"16877324,3"
02/25/2024,29487,,12254,Terminal SE - Transferencia TPV,96148,0,"16973472,3"
02/25/2024,29471,,12216,Terminal SE - Transferencia TPV,"123571,99",0,"17097044,29"
02/25/2024,29469,,12212,Terminal SE - Transferencia TPV,"489590,99",0,"17586635,28"
02/25/2024,29478,,12226,Terminal SE - Transferencia TPV,118000,0,"17704635,28"
02/25/2024,29482,,12242,Terminal SE - Transferencia TPV,"310295,99",0,"18014931,27"
02/25/2024,29476,,12223,Terminal SE - Transferencia TPV,98891,0,"18113822,27"
02/25/2024,29494,,12271,Terminal SE - Transferencia TPV,"64999,99",0,"18178822,26"
02/25/2024,29489,,12259,Terminal SE - Transferencia TPV,81398,0,"18260220,26"
02/25/2024,29493,,12270,Terminal SE - Transferencia TPV,79213,0,"18339433,26"
02/25/2024,29481,,12240,Terminal SE - Transferencia TPV,210870,0,"18550303,26"
02/25/2024,29472,,12217,Terminal SE - Transferencia TPV,123681,0,"18673984,26"
02/25/2024,29491,,12262,Terminal SE - Transferencia TPV,82709,0,"18756693,26"
02/25/2024,29465,,12202,Terminal SE - Transferencia TPV,72439,0,"18829132,26"
02/25/2024,29462,,12194,Terminal SE - Transferencia TPV,106500,0,"18935632,26"
02/25/2024,29466,,12203,Terminal SE - Transferencia TPV,59000,0,"18994632,26"
02/25/2024,29496,,12273,Terminal SE - Transferencia TPV,"161000,01",0,"19155632,27"
02/25/2024,29486,,12253,Terminal SE - Transferencia TPV,"15000,01",0,"19170632,28"
02/25/2024,29474,,12220,Terminal SE - Transferencia TPV,153837,0,"19324469,28"
02/25/2024,29461,,12193,Terminal SE - Transferencia TPV,158644,0,"19483113,28"
02/25/2024,29467,,12207,Terminal SE - Transferencia TPV,"235828,01",0,"19718941,29"
02/25/2024,29497,,12280,Terminal SE - Transferencia TPV,"136027,98",0,"19854969,27"
02/25/2024,29484,,12245,Terminal SE - Transferencia TPV,167713,0,"20022682,27"
02/25/2024,29477,,12224,Terminal SE - Transferencia TPV,"466427,98",0,"20489110,25"
02/25/2024,28808,,,Terminal SE - Transferencia TPV,0,5067156,"15421954,25"
02/25/2024,29468,,12208,Terminal SE - Transferencia TPV,"170772,01",0,"15592726,26"
02/26/2024,29498,,,Terminal SE - Transferencia TPV,5145924,0,"20738650,26"
02/26/2024,29498,,,Terminal SE - Transferencia TPV,0,5145924,"15592726,26"
02/29/2024,29889,,12335,Terminal SE - Transferencia TPV,68200,0,"8742025,46"
02/29/2024,29890,,12336,Terminal SE - Transferencia TPV,111000,0,"8853025,46"
02/29/2024,29891,,12347,Terminal SE - Transferencia TPV,69500,0,"8922525,46"
02/29/2024,29892,,12354,Terminal SE - Transferencia TPV,56000,0,"8978525,46"
02/29/2024,29888,,12334,Terminal SE - Transferencia TPV,64000,0,"8964525,46"
02/29/2024,29887,,12332,Terminal SE - Transferencia TPV,90000,0,"8131025,46"
03/01/2024,30298,,12369,Terminal SE - Transferencia TPV,51953,0,"7585778,63"
03/01/2024,30297,,12369,Terminal SE - Transferencia TPV,104000,0,"7689778,63"
03/01/2024,30312,,12426,Terminal SE - Transferencia TPV,73500,0,"7763278,63"
03/01/2024,30314,,12434,Terminal SE - Transferencia TPV,"374104,01",0,"8137382,64"
03/01/2024,30301,,12390,Terminal SE - Transferencia TPV,163561,0,"4607601,64"
03/01/2024,30313,,12431,Terminal SE - Transferencia TPV,181807,0,"-273011,36"
03/01/2024,30302,,12395,Terminal SE - Transferencia TPV,"97786,99",0,"-8203063,37"
03/01/2024,30303,,12397,Terminal SE - Transferencia TPV,"87079,99",0,"-8115983,38"
03/01/2024,30304,,12402,Terminal SE - Transferencia TPV,101611,0,"-9106908,38"
03/01/2024,30305,,12403,Terminal SE - Transferencia TPV,90685,0,"-9016223,38"
03/01/2024,30306,,12407,Terminal SE - Transferencia TPV,"90138,99",0,"-8926084,39"
03/01/2024,30307,,12411,Terminal SE - Transferencia TPV,53500,0,"-8872584,39"
03/01/2024,30308,,12412,Terminal SE - Transferencia TPV,59000,0,"-8813584,39"
03/01/2024,30309,,12414,Terminal SE - Transferencia TPV,124000,0,"-8689584,39"
03/01/2024,30310,,12415,Terminal SE - Transferencia TPV,"159499,99",0,"-8530084,4"
03/01/2024,30311,,12416,Terminal SE - Transferencia TPV,171000,0,"-8359084,4"
03/01/2024,30300,,12381,Terminal SE - Transferencia TPV,160600,0,"-8198484,4"
03/01/2024,30299,,12377,Terminal SE - Transferencia TPV,64000,0,"-8134484,4"
03/02/2024,31004,,12538,Terminal SE - Transferencia TPV,90248,0,"-8044236,4"
03/02/2024,30993,,12515,Terminal SE - Transferencia TPV,"111225,99",0,"-7933010,41"
03/02/2024,31003,,12534,Terminal SE - Transferencia TPV,114000,0,"-7819010,41"
03/02/2024,30992,,12514,Terminal SE - Transferencia TPV,"203599,99",0,"-7615410,42"
03/02/2024,31014,,12557,Terminal SE - Transferencia TPV,"461620,01",0,"-7153790,41"
03/02/2024,31007,,12546,Terminal SE - Transferencia TPV,55000,0,"-7098790,41"
03/02/2024,30989,,12507,Terminal SE - Transferencia TPV,65500,0,"-7033290,41"
03/02/2024,30997,,12526,Terminal SE - Transferencia TPV,"95710,99",0,"-6937579,42"
03/02/2024,31005,,12542,Terminal SE - Transferencia TPV,"74500,01",0,"-6863079,41"
03/02/2024,30969,,12469,Terminal SE - Transferencia TPV,72300,0,"-6790779,41"
03/02/2024,30999,,12528,Terminal SE - Transferencia TPV,"167275,99",0,"-6623503,42"
03/02/2024,30970,,12470,Terminal SE - Transferencia TPV,"154383,01",0,"-6469120,41"
03/02/2024,31002,,12531,Terminal SE - Transferencia TPV,53000,0,"-6416120,41"
03/02/2024,30967,,12467,Terminal SE - Transferencia TPV,"144768,98",0,"-6271351,43"
03/02/2024,31011,,12552,Terminal SE - Transferencia TPV,55500,0,"-6215851,43"
03/02/2024,31001,,12530,Terminal SE - Transferencia TPV,127615,0,"-6088236,43"
03/02/2024,30316,,,Terminal SE - Transferencia TPV,0,"54399,97","-6142636,4"
03/02/2024,30315,,,Terminal SE - Transferencia TPV,0,2153427,"-8296063,4"
03/02/2024,30966,,12465,Terminal SE - Transferencia TPV,"99999,99",0,"-8196063,41"
03/02/2024,31013,,12555,Terminal SE - Transferencia TPV,10000,0,"-8459063,69"
03/02/2024,30982,,12484,Terminal SE - Transferencia TPV,"334224,01",0,"-8124839,68"
03/02/2024,31008,,12547,Terminal SE - Transferencia TPV,131600,0,"-7993239,68"
03/02/2024,30980,,12482,Terminal SE - Transferencia TPV,"22800,01",0,"-7970439,67"
03/02/2024,30983,,12485,Terminal SE - Transferencia TPV,102376,0,"-7868063,67"
03/02/2024,30315,,,Terminal SE - Transferencia TPV,2153427,0,"-5714636,67"
03/02/2024,31000,,12529,Terminal SE - Transferencia TPV,87407,0,"-5627229,67"
03/02/2024,31006,,12543,Terminal SE - Transferencia TPV,150000,0,"-5477229,67"
03/02/2024,30964,,12462,Terminal SE - Transferencia TPV,105000,0,"-5372229,67"
03/02/2024,30995,,12517,Terminal SE - Transferencia TPV,"154324,01",0,"-5217905,66"
03/02/2024,30968,,12468,Terminal SE - Transferencia TPV,"267029,99",0,"-4950875,67"
03/02/2024,31015,,12561,Terminal SE - Transferencia TPV,"150449,99",0,"-4800425,68"
03/02/2024,30981,,12483,Terminal SE - Transferencia TPV,"144768,99",0,"-4655656,69"
03/02/2024,30963,,12458,Terminal SE - Transferencia TPV,"159955,99",0,"-4495700,7"
03/02/2024,30988,,12503,Terminal SE - Transferencia TPV,60000,0,"-4435700,7"
03/02/2024,30971,,12472,Terminal SE - Transferencia TPV,93089,0,"-4342611,7"
03/02/2024,31009,,12549,Terminal SE - Transferencia TPV,61500,0,"-4281111,7"
03/02/2024,30977,,12476,Terminal SE - Transferencia TPV,135200,0,"-4145911,7"
03/02/2024,30976,,12476,Terminal SE - Transferencia TPV,67650,0,"-4078261,7"
03/02/2024,30975,,12476,Terminal SE - Transferencia TPV,67650,0,"-4010611,7"
03/02/2024,30974,,12476,Terminal SE - Transferencia TPV,67650,0,"-3942961,7"
03/02/2024,30973,,12476,Terminal SE - Transferencia TPV,67650,0,"-3875311,7"
03/02/2024,30972,,12476,Terminal SE - Transferencia TPV,67650,0,"-3807661,7"
03/02/2024,30987,,12498,Terminal SE - Transferencia TPV,"147999,99",0,"-3659661,71"
03/02/2024,30979,,12481,Terminal SE - Transferencia TPV,"119638,99",0,"-3540022,72"
03/02/2024,30984,,12486,Terminal SE - Transferencia TPV,"53000,01",0,"-3487022,71"
03/02/2024,30998,,12527,Terminal SE - Transferencia TPV,"91613,99",0,"-3395408,72"
03/02/2024,30986,,12493,Terminal SE - Transferencia TPV,99728,0,"-3295680,72"
03/02/2024,30990,,12509,Terminal SE - Transferencia TPV,63000,0,"-3232680,72"
03/02/2024,30994,,12516,Terminal SE - Transferencia TPV,157388,0,"-3075292,72"
03/02/2024,30965,,12463,Terminal SE - Transferencia TPV,"69500,01",0,"-3005792,71"
03/02/2024,31012,,12553,Terminal SE - Transferencia TPV,61500,0,"-2944292,71"
03/02/2024,30978,,12480,Terminal SE - Transferencia TPV,"71999,99",0,"-2872292,72"
03/02/2024,30991,,12510,Terminal SE - Transferencia TPV,"122999,99",0,"-2749292,73"
03/02/2024,31010,,12550,Terminal SE - Transferencia TPV,88719,0,"-2660573,73"
03/02/2024,30996,,12521,Terminal SE - Transferencia TPV,81300,0,"-2579273,73"
03/02/2024,30985,,12488,Terminal SE - Transferencia TPV,63500,0,"-2515773,73"
03/03/2024,31553,,12632,Terminal SE - Transferencia TPV,74296,0,"-2441477,73"
03/03/2024,31524,,12590,Terminal SE - Transferencia TPV,"345805,98",0,"-2095671,75"
03/03/2024,31520,,12584,Terminal SE - Transferencia TPV,181698,0,"-1913973,75"
03/03/2024,31526,,12592,Terminal SE - Transferencia TPV,"141999,99",0,"-1771973,76"
03/03/2024,31523,,12588,Terminal SE - Transferencia TPV,"184101,99",0,"-1587871,77"
03/03/2024,31531,,12598,Terminal SE - Transferencia TPV,59000,0,"-1528871,77"
03/03/2024,31551,,12630,Terminal SE - Transferencia TPV,"76977,79",0,"-1451893,98"
03/03/2024,31534,,12603,Terminal SE - Transferencia TPV,118000,0,"-1333893,98"
03/03/2024,31515,,12578,Terminal SE - Transferencia TPV,63000,0,"-1270893,98"
03/03/2024,31525,,12591,Terminal SE - Transferencia TPV,107293,0,"-1163600,98"
03/03/2024,31514,,12573,Terminal SE - Transferencia TPV,167494,0,"-996106,98"
03/03/2024,31533,,12602,Terminal SE - Transferencia TPV,"94399,99",0,"-901706,99"
03/03/2024,31552,,12631,Terminal SE - Transferencia TPV,137000,0,"-764706,99"
03/03/2024,31537,,12606,Terminal SE - Transferencia TPV,"77792,99",0,-686914
03/03/2024,31521,,12585,Terminal SE - Transferencia TPV,49221,0,-637693
03/03/2024,31556,,12643,Terminal SE - Transferencia TPV,86800,0,-550893
03/03/2024,31530,,12596,Terminal SE - Transferencia TPV,96148,0,-454745
03/03/2024,31016,,,Terminal SE - Transferencia TPV,5946043,0,5491298
03/03/2024,31527,,12593,Terminal SE - Transferencia TPV,250000,0,5741298
03/03/2024,31528,,12593,Terminal SE - Transferencia TPV,"250000,01",0,"5991298,01"
03/03/2024,31544,,12620,Terminal SE - Transferencia TPV,45300,0,"6036598,01"
03/03/2024,31545,,12620,Terminal SE - Transferencia TPV,42000,0,"6078598,01"
03/03/2024,31546,,12620,Terminal SE - Transferencia TPV,75500,0,"6154098,01"
03/03/2024,31547,,12620,Terminal SE - Transferencia TPV,144471,0,"6298569,01"
03/03/2024,31548,,12620,Terminal SE - Transferencia TPV,215292,0,"6513861,01"
03/03/2024,31542,,12616,Terminal SE - Transferencia TPV,67000,0,"6580861,01"
03/03/2024,31536,,12605,Terminal SE - Transferencia TPV,131548,0,"6712409,01"
03/03/2024,31540,,12614,Terminal SE - Transferencia TPV,158200,0,"6870609,01"
03/03/2024,31535,,12604,Terminal SE - Transferencia TPV,"87049,99",0,6957659
03/03/2024,31518,,12582,Terminal SE - Transferencia TPV,"169461,01",0,"7127120,01"
03/03/2024,31513,,12572,Terminal SE - Transferencia TPV,"141999,99",0,7269120
03/03/2024,31538,,12610,Terminal SE - Transferencia TPV,152000,0,7421120
03/03/2024,31550,,12628,Terminal SE - Transferencia TPV,"129499,99",0,"7550619,99"
03/03/2024,31539,,12612,Terminal SE - Transferencia TPV,"104888,99",0,"7655508,98"
03/03/2024,31529,,12594,Terminal SE - Transferencia TPV,"239999,99",0,"7895508,97"
03/03/2024,31517,,12580,Terminal SE - Transferencia TPV,162250,0,"8057758,97"
03/03/2024,31555,,12642,Terminal SE - Transferencia TPV,270307,0,"8328065,97"
03/03/2024,31557,,12645,Terminal SE - Transferencia TPV,111444,0,"8439509,97"
03/03/2024,31543,,12619,Terminal SE - Transferencia TPV,62000,0,"8501509,97"
03/03/2024,31532,,12601,Terminal SE - Transferencia TPV,198087,0,"8699596,97"
03/03/2024,31549,,12626,Terminal SE - Transferencia TPV,"53000,01",0,"8752596,98"
03/03/2024,31541,,12615,Terminal SE - Transferencia TPV,78500,0,"8831096,98"
03/03/2024,31554,,12633,Terminal SE - Transferencia TPV,212892,0,"9043988,98"
03/03/2024,31519,,12583,Terminal SE - Transferencia TPV,168095,0,"9212083,98"
03/03/2024,31522,,12587,Terminal SE - Transferencia TPV,9800,0,"9221883,98"
03/03/2024,31516,,12579,Terminal SE - Transferencia TPV,70000,0,"9291883,98"
03/03/2024,31016,,,Terminal SE - Transferencia TPV,0,5946043,"3345840,98"
03/04/2024,31558,,,Terminal SE - Transferencia TPV,5861598,0,"9207438,98"
03/04/2024,31558,,,Terminal SE - Transferencia TPV,0,5861598,"3345840,98"
03/07/2024,31859,,12686,Terminal SE - Transferencia TPV,"79212,99",0,"-3952639,27"
03/07/2024,31860,,12693,Terminal SE - Transferencia TPV,80852,0,"-5170445,31"
03/08/2024,32227,,12734,Terminal SE - Transferencia TPV,140900,0,"-5029545,31"
03/08/2024,32221,,12718,Terminal SE - Transferencia TPV,"71500,01",0,"-4958045,3"
03/08/2024,32229,,12742,Terminal SE - Transferencia TPV,107730,0,"-4850315,3"
03/08/2024,32230,,12748,Terminal SE - Transferencia TPV,54000,0,"-4796315,3"
03/08/2024,32231,,12756,Terminal SE - Transferencia TPV,105872,0,"-4690443,3"
03/08/2024,32215,,12769,Terminal SE - Efectivo TPV,108000,0,"-4582443,3"
03/08/2024,32213,,12754,Terminal SE - Efectivo TPV,88172,0,"-4494271,3"
03/08/2024,32208,,12729,Terminal SE - Efectivo TPV,150000,0,"-4344271,3"
03/08/2024,32212,,12751,Terminal SE - Efectivo TPV,"128925,99",0,"-4215345,31"
03/08/2024,31861,,,Terminal SE - Transferencia TPV,160065,0,"-4055280,31"
03/08/2024,31861,,,Terminal SE - Transferencia TPV,0,160065,"-4215345,31"
03/08/2024,32211,,12739,Terminal SE - Efectivo TPV,"95055,99",0,"-4120289,32"
03/08/2024,32214,,12765,Terminal SE - Efectivo TPV,46000,0,"-4074289,32"
03/08/2024,32210,,12734,Terminal SE - Efectivo TPV,5000,0,"-4069289,32"
03/08/2024,32207,,12727,Terminal SE - Efectivo TPV,60000,0,"-4009289,32"
03/08/2024,32206,,12716,Terminal SE - Efectivo TPV,99644,0,"-3909645,32"
03/08/2024,32209,,12730,Terminal SE - Efectivo TPV,"12100,01",0,"-3897545,31"
03/08/2024,32217,,12709,Terminal SE - Transferencia TPV,68000,0,"-3829545,31"
03/08/2024,32218,,12711,Terminal SE - Transferencia TPV,"99971,99",0,"-3729573,32"
03/08/2024,32220,,12717,Terminal SE - Transferencia TPV,"254355,99",0,"-3475217,33"
03/08/2024,32237,,12772,Terminal SE - Transferencia TPV,86096,0,"-3389121,33"
03/08/2024,32219,,12714,Terminal SE - Transferencia TPV,"77200,01",0,"-3311921,32"
03/08/2024,32224,,12723,Terminal SE - Transferencia TPV,"70000,01",0,"-3241921,31"
03/08/2024,32226,,12733,Terminal SE - Transferencia TPV,99500,0,"-3142421,31"
03/08/2024,32239,,12777,Terminal SE - Transferencia TPV,"102266,99",0,"-3040154,32"
03/08/2024,32240,,12778,Terminal SE - Transferencia TPV,"139742,99",0,"-2900411,33"
03/08/2024,32225,,12730,Terminal SE - Transferencia TPV,44000,0,"-2856411,33"
03/08/2024,32232,,12759,Terminal SE - Transferencia TPV,"102484,99",0,"-2753926,34"
03/08/2024,32233,,12761,Terminal SE - Transferencia TPV,86315,0,"-2667611,34"
03/08/2024,32234,,12764,Terminal SE - Transferencia TPV,51500,0,"-2616111,34"
03/08/2024,32235,,12767,Terminal SE - Transferencia TPV,65000,0,"-2551111,34"
03/08/2024,32223,,12722,Terminal SE - Transferencia TPV,"180605,99",0,"-2370505,35"
03/08/2024,32236,,12771,Terminal SE - Transferencia TPV,"103522,99",0,"-2266982,36"
03/08/2024,32228,,12741,Terminal SE - Transferencia TPV,248807,0,"-2404211,36"
03/08/2024,32222,,12720,Terminal SE - Transferencia TPV,"78199,99",0,"-2326011,37"
03/08/2024,32238,,12775,Terminal SE - Transferencia TPV,"93307,01",0,"-2232704,36"
03/08/2024,32241,,12781,Terminal SE - Transferencia TPV,102813,0,"-2129891,36"
03/09/2024,32785,,12829,Terminal SE - Transferencia TPV,"60000,01",0,"-2069891,35"
03/09/2024,32796,,12866,Terminal SE - Transferencia TPV,"86096,01",0,"-1983795,34"
03/09/2024,32797,,12877,Terminal SE - Transferencia TPV,"66999,99",0,"-1916795,35"
03/09/2024,32780,,12817,Terminal SE - Transferencia TPV,86315,0,"-1830480,35"
03/09/2024,32216,,,Terminal SE - Efectivo TPV,0,793200,"-2623680,35"
03/09/2024,32778,,12813,Terminal SE - Transferencia TPV,"68499,99",0,"-2555180,36"
03/09/2024,32790,,12838,Terminal SE - Transferencia TPV,"112318,99",0,"-2442861,37"
03/09/2024,32792,,12843,Terminal SE - Transferencia TPV,"92324,01",0,"-2350537,36"
03/09/2024,32786,,12830,Terminal SE - Transferencia TPV,"173393,99",0,"-2177143,37"
03/09/2024,32789,,12835,Terminal SE - Transferencia TPV,140398,0,"-2036745,37"
03/09/2024,32768,,12796,Terminal SE - Transferencia TPV,"54500,01",0,"-1982245,36"
03/09/2024,32787,,12831,Terminal SE - Transferencia TPV,"75000,01",0,"-1907245,35"
03/09/2024,32794,,12862,Terminal SE - Transferencia TPV,"96584,99",0,"-1810660,36"
03/09/2024,32774,,12805,Terminal SE - Transferencia TPV,"89920,01",0,"-1720740,35"
03/09/2024,32795,,12864,Terminal SE - Transferencia TPV,175907,0,"-1544833,35"
03/09/2024,32793,,12856,Terminal SE - Transferencia TPV,"191039,99",0,"-1353793,36"
03/09/2024,32770,,12798,Terminal SE - Transferencia TPV,177000,0,"-1176793,36"
03/09/2024,32788,,12834,Terminal SE - Transferencia TPV,102485,0,"-1074308,36"
03/09/2024,32791,,12842,Terminal SE - Transferencia TPV,"75000,01",0,"-999308,35"
03/09/2024,32773,,12802,Terminal SE - Transferencia TPV,50852,0,"-948456,35"
03/09/2024,32783,,12825,Terminal SE - Transferencia TPV,"66999,99",0,"-881456,36"
03/09/2024,32782,,12822,Terminal SE - Transferencia TPV,"110023,99",0,"-771432,37"
03/09/2024,32781,,12819,Terminal SE - Transferencia TPV,"95000,01",0,"-676432,36"
03/09/2024,32784,,12827,Terminal SE - Transferencia TPV,90685,0,"-585747,36"
03/09/2024,32776,,12809,Terminal SE - Transferencia TPV,98333,0,"-487414,36"
03/09/2024,32769,,12797,Terminal SE - Transferencia TPV,83600,0,"-403814,36"
03/09/2024,32772,,12801,Terminal SE - Transferencia TPV,57000,0,"-346814,36"
03/09/2024,32771,,12800,Terminal SE - Transferencia TPV,"302538,99",0,"-44275,37"
03/09/2024,32216,,,Terminal SE - Efectivo TPV,793200,0,"748924,63"
03/09/2024,32242,,,Terminal SE - Transferencia TPV,2633767,0,"3382691,63"
03/09/2024,32242,,,Terminal SE - Transferencia TPV,0,2633767,"748924,63"
03/09/2024,32777,,12811,Terminal SE - Transferencia TPV,67500,0,"816424,63"
03/09/2024,32775,,12806,Terminal SE - Transferencia TPV,"104342,99",0,"920767,62"
03/09/2024,32779,,12816,Terminal SE - Transferencia TPV,77793,0,"998560,62"
03/10/2024,33236,,12904,Terminal SE - Transferencia TPV,"207155,99",0,"1205716,61"
03/10/2024,33250,,12928,Terminal SE - Transferencia TPV,73313,0,"1279029,61"
03/10/2024,33256,,12946,Terminal SE - Transferencia TPV,146000,0,"1425029,61"
03/10/2024,33259,,12960,Terminal SE - Transferencia TPV,66300,0,"1491329,61"
03/10/2024,33258,,12950,Terminal SE - Transferencia TPV,"167493,99",0,"1658823,6"
03/10/2024,33257,,12947,Terminal SE - Transferencia TPV,"73804,99",0,"1732628,59"
03/10/2024,33255,,12939,Terminal SE - Transferencia TPV,150000,0,"1882628,59"
03/10/2024,33228,,12888,Terminal SE - Transferencia TPV,54400,0,"1937028,59"
03/10/2024,33227,,12888,Terminal SE - Transferencia TPV,100000,0,"2037028,59"
03/10/2024,33253,,12936,Terminal SE - Transferencia TPV,55050,0,"2092078,59"
03/10/2024,33249,,12927,Terminal SE - Transferencia TPV,69000,0,"2161078,59"
03/10/2024,33241,,12915,Terminal SE - Transferencia TPV,78667,0,"2239745,59"
03/10/2024,33235,,12903,Terminal SE - Transferencia TPV,"148046,01",0,"2387791,6"
03/10/2024,33232,,12896,Terminal SE - Transferencia TPV,"147008,01",0,"2534799,61"
03/10/2024,33226,,12887,Terminal SE - Transferencia TPV,49221,0,"2584020,61"
03/10/2024,33245,,12919,Terminal SE - Transferencia TPV,96148,0,"2680168,61"
03/10/2024,33238,,12908,Terminal SE - Transferencia TPV,"75000,01",0,"2755168,62"
03/10/2024,33237,,12907,Terminal SE - Transferencia TPV,83600,0,"2838768,62"
03/10/2024,33247,,12925,Terminal SE - Transferencia TPV,71200,0,"2909968,62"
03/10/2024,33239,,12909,Terminal SE - Transferencia TPV,264850,0,"3174818,62"
03/10/2024,33230,,12893,Terminal SE - Transferencia TPV,73204,0,"3248022,62"
03/10/2024,33261,,12963,Terminal SE - Transferencia TPV,69707,0,"3317729,62"
03/10/2024,33246,,12922,Terminal SE - Transferencia TPV,"175360,99",0,"3493090,61"
03/10/2024,33260,,12961,Terminal SE - Transferencia TPV,"83999,99",0,"3577090,6"
03/10/2024,33248,,12926,Terminal SE - Transferencia TPV,296420,0,"3873510,6"
03/10/2024,33225,,12886,Terminal SE - Transferencia TPV,"90049,99",0,"3963560,59"
03/10/2024,33224,,12885,Terminal SE - Transferencia TPV,"123999,99",0,"4087560,58"
03/10/2024,33243,,12917,Terminal SE - Transferencia TPV,"185958,99",0,"4273519,57"
03/10/2024,33234,,12900,Terminal SE - Transferencia TPV,54500,0,"4328019,57"
03/10/2024,33231,,12895,Terminal SE - Transferencia TPV,57000,0,"4385019,57"
03/10/2024,33240,,12913,Terminal SE - Transferencia TPV,15200,0,"4400219,57"
03/10/2024,33223,,12882,Terminal SE - Transferencia TPV,"110999,99",0,"4511219,56"
03/10/2024,33233,,12898,Terminal SE - Transferencia TPV,144222,0,"4655441,56"
03/10/2024,33229,,12890,Terminal SE - Transferencia TPV,"115599,99",0,"4771041,55"
03/10/2024,33251,,12930,Terminal SE - Transferencia TPV,123026,0,"4894067,55"
03/10/2024,33222,,12880,Terminal SE - Transferencia TPV,69000,0,"4963067,55"
03/10/2024,33244,,12918,Terminal SE - Transferencia TPV,90139,0,"5053206,55"
03/10/2024,33242,,12916,Terminal SE - Transferencia TPV,"87079,99",0,"5140286,54"
03/10/2024,33252,,12935,Terminal SE - Transferencia TPV,114000,0,"5254286,54"
03/10/2024,33254,,12938,Terminal SE - Transferencia TPV,53050,0,"5307336,54"
03/10/2024,32798,,,Terminal SE - Transferencia TPV,0,3128464,"2178872,54"
03/10/2024,32798,,,Terminal SE - Transferencia TPV,3128464,0,"5307336,54"
03/11/2024,33262,,,Terminal SE - Transferencia TPV,4308813,0,"9616149,54"
03/11/2024,33262,,,Terminal SE - Transferencia TPV,0,4308813,"5307336,54"
03/12/2024,33366,,12975,Terminal LS - Efectivo TPV,130000,0,"5437336,54"
03/12/2024,33368,,12979,Terminal LS - Efectivo TPV,"131999,99",0,"5569336,53"
03/12/2024,33380,,12978,Terminal LS - Transferencia TPV,119639,0,"5688975,53"
03/12/2024,33385,,12987,Terminal LS - Transferencia TPV,106746,0,"5795721,53"
03/12/2024,33370,,12984,Terminal LS - Efectivo TPV,5800,0,"5801521,53"
03/12/2024,33377,,12969,Terminal LS - Transferencia TPV,"114284,99",0,"5915806,52"
03/12/2024,33372,,12971,Terminal LS - Tarjeta TPV,118000,0,"6033806,52"
03/12/2024,33373,,12972,Terminal LS - Tarjeta TPV,"81944,01",0,"6115750,53"
03/12/2024,33365,,12970,Terminal LS - Efectivo TPV,45050,0,"6160800,53"
03/12/2024,33367,,12976,Terminal LS - Efectivo TPV,68615,0,"6229415,53"
03/12/2024,33375,,12985,Terminal LS - Tarjeta TPV,"72099,99",0,"6231215,08"
03/12/2024,33378,,12973,Terminal LS - Transferencia TPV,71565,0,"6302780,08"
03/12/2024,33381,,12981,Terminal LS - Transferencia TPV,"259326,98",0,"6562107,06"
03/12/2024,33384,,12986,Terminal LS - Transferencia TPV,"766134,99",0,"7328242,05"
03/12/2024,33383,,12983,Terminal LS - Transferencia TPV,131657,0,"7459899,05"
03/12/2024,33379,,12977,Terminal LS - Transferencia TPV,57500,0,"7517399,05"
03/12/2024,33382,,12982,Terminal LS - Transferencia TPV,"101999,98",0,"7619399,03"
03/12/2024,33369,,12980,Terminal LS - Efectivo TPV,72767,0,"-10579549,72"
03/12/2024,33374,,12974,Terminal LS - Tarjeta TPV,"172301,99",0,"-10407247,73"
03/13/2024,33376,,,Terminal LS - Tarjeta TPV,0,444344,"-10851591,73"
03/13/2024,33376,,,Terminal LS - Tarjeta TPV,444344,0,"-10407247,73"
03/13/2024,33371,,,Terminal LS - Efectivo TPV,0,454100,"-11088348,09"
03/13/2024,33371,,,Terminal LS - Efectivo TPV,454100,0,"-11948090,09"
03/13/2024,33386,,,Terminal LS - Transferencia TPV,1728851,0,"-10219239,09"
03/13/2024,33386,,,Terminal LS - Transferencia TPV,0,1728851,"-11948090,09"
03/14/2024,33628,,13011,Terminal SE - Transferencia TPV,129144,0,"-12046192,89"
03/14/2024,33629,,13012,Terminal SE - Transferencia TPV,"80305,99",0,"-11965886,9"
03/14/2024,33630,,13016,Terminal SE - Transferencia TPV,"98599,99",0,"-11867286,91"
03/14/2024,33631,,13018,Terminal SE - Transferencia TPV,67000,0,"-11800286,91"
03/14/2024,33632,,13020,Terminal SE - Transferencia TPV,65000,0,"-11735286,91"
03/14/2024,33633,,13027,Terminal SE - Transferencia TPV,72700,0,"-11662586,91"
03/14/2024,33634,,13030,Terminal SE - Transferencia TPV,70527,0,"-11592059,91"
03/14/2024,33635,,,Terminal SE - Transferencia TPV,742788,0,"-10849271,91"
03/14/2024,33626,,13006,Terminal SE - Transferencia TPV,81500,0,"-10767771,91"
03/14/2024,33627,,13009,Terminal SE - Transferencia TPV,78011,0,"-10943329,69"
03/14/2024,33635,,,Terminal SE - Transferencia TPV,0,742788,"-11686117,69"
03/15/2024,33955,,13072,Terminal SE - Transferencia TPV,9000,0,"-11769717,79"
03/15/2024,33946,,13046,Terminal SE - Transferencia TPV,126741,0,"-11642976,79"
03/15/2024,33947,,13048,Terminal SE - Transferencia TPV,"61500,01",0,"-11581476,78"
03/15/2024,33948,,13049,Terminal SE - Transferencia TPV,61500,0,"-11916076,78"
03/15/2024,33949,,13053,Terminal SE - Transferencia TPV,"78010,99",0,"-11838065,79"
03/15/2024,33950,,13054,Terminal SE - Transferencia TPV,"150000,01",0,"-11688065,78"
03/15/2024,33951,,13064,Terminal SE - Transferencia TPV,221000,0,"-11467065,78"
03/15/2024,33952,,13065,Terminal SE - Transferencia TPV,80852,0,"-11386213,78"
03/15/2024,33953,,13070,Terminal SE - Transferencia TPV,67500,0,"-11318713,78"
03/15/2024,33954,,13071,Terminal SE - Transferencia TPV,"61500,01",0,"-11257213,77"
03/16/2024,34742,,13154,Terminal SE - Transferencia TPV,"79103,99",0,"-17286820,29"
03/16/2024,34750,,13189,Terminal SE - Transferencia TPV,106000,0,"-17180820,29"
03/16/2024,34732,,13130,Terminal SE - Transferencia TPV,"107499,99",0,"-17073320,3"
03/16/2024,34740,,13151,Terminal SE - Transferencia TPV,99644,0,"-16973676,3"
03/16/2024,34760,,13205,Terminal SE - Transferencia TPV,65009,0,"-16908667,3"
03/16/2024,34759,,13201,Terminal SE - Transferencia TPV,"267739,99",0,"-16640927,31"
03/16/2024,34751,,13190,Terminal SE - Transferencia TPV,"213273,99",0,"-16427653,32"
03/16/2024,34758,,13199,Terminal SE - Transferencia TPV,"165527,98",0,"-16262125,34"
03/16/2024,34729,,13122,Terminal SE - Transferencia TPV,125102,0,"-16137023,34"
03/16/2024,34762,,13210,Terminal SE - Transferencia TPV,98443,0,"-16038580,34"
03/16/2024,34735,,13133,Terminal SE - Transferencia TPV,395300,0,"-15643280,34"
03/16/2024,34726,,13119,Terminal SE - Transferencia TPV,"468000,02",0,"-15175280,32"
03/16/2024,34761,,13207,Terminal SE - Transferencia TPV,"170662,99",0,"-15004617,33"
03/16/2024,34757,,13196,Terminal SE - Transferencia TPV,88828,0,"-14915789,33"
03/16/2024,34730,,13123,Terminal SE - Transferencia TPV,11600,0,"-14904189,33"
03/16/2024,34764,,13212,Terminal SE - Transferencia TPV,"91450,01",0,"-14812739,32"
03/16/2024,34731,,13124,Terminal SE - Transferencia TPV,"306000,02",0,"-14506739,3"
03/16/2024,34765,,13213,Terminal SE - Transferencia TPV,"131000,01",0,"-14375739,29"
03/16/2024,34725,,13118,Terminal SE - Transferencia TPV,175000,0,"-14200739,29"
03/16/2024,34733,,13131,Terminal SE - Transferencia TPV,73000,0,"-14127739,29"
03/16/2024,34744,,13163,Terminal SE - Transferencia TPV,82054,0,"-14045685,29"
03/16/2024,34749,,13188,Terminal SE - Transferencia TPV,168000,0,"-13877685,29"
03/16/2024,34763,,13211,Terminal SE - Transferencia TPV,99317,0,"-13778368,29"
03/16/2024,34766,,13214,Terminal SE - Transferencia TPV,71500,0,"-13706868,29"
03/16/2024,34755,,13193,Terminal SE - Transferencia TPV,350000,0,"-13356868,29"
03/16/2024,34754,,13193,Terminal SE - Transferencia TPV,120000,0,"-13236868,29"
03/16/2024,34753,,13193,Terminal SE - Transferencia TPV,120000,0,"-13116868,29"
03/16/2024,34752,,13193,Terminal SE - Transferencia TPV,120000,0,"-12996868,29"
03/16/2024,34756,,13195,Terminal SE - Transferencia TPV,103796,0,"-12893072,29"
03/16/2024,34728,,13121,Terminal SE - Transferencia TPV,118150,0,"-12774922,29"
03/16/2024,34739,,13150,Terminal SE - Transferencia TPV,91231,0,"-12683691,29"
03/16/2024,34743,,13158,Terminal SE - Transferencia TPV,100000,0,"-12583691,29"
03/16/2024,34727,,13120,Terminal SE - Transferencia TPV,"190000,01",0,"-12518262,08"
03/16/2024,34748,,13186,Terminal SE - Transferencia TPV,"90903,99",0,"-12427358,09"
03/16/2024,34745,,13168,Terminal SE - Transferencia TPV,81180,0,"-12370178,09"
03/16/2024,34737,,13139,Terminal SE - Transferencia TPV,102267,0,"-12328111,09"
03/16/2024,34736,,13138,Terminal SE - Transferencia TPV,"66000,01",0,"-12262111,08"
03/16/2024,34767,,13215,Terminal SE - Transferencia TPV,66000,0,"-12196111,08"
03/16/2024,34734,,13132,Terminal SE - Transferencia TPV,88500,0,"-14101481,08"
03/16/2024,34738,,13145,Terminal SE - Transferencia TPV,"70000,01",0,"-15007481,07"
03/16/2024,34747,,13180,Terminal SE - Transferencia TPV,"75716,99",0,"-14931764,08"
03/16/2024,34741,,13152,Terminal SE - Transferencia TPV,"97131,01",0,"-14834633,07"
03/16/2024,34746,,13171,Terminal SE - Transferencia TPV,220704,0,"-14613929,07"
03/17/2024,35386,,13302,Terminal SE - Transferencia TPV,26550,0,"-16945608,07"
03/17/2024,34768,,,Terminal SE - Transferencia TPV,0,5930710,"-22876318,07"
03/17/2024,34768,,,Terminal SE - Transferencia TPV,5930710,0,"-16945608,07"
03/17/2024,35395,,13319,Terminal SE - Transferencia TPV,81800,0,"-16863808,07"
03/17/2024,35396,,13319,Terminal SE - Transferencia TPV,81761,0,"-16782047,07"
03/17/2024,35359,,13250,Terminal SE - Transferencia TPV,78926,0,"-17116982,08"
03/17/2024,35372,,13280,Terminal SE - Transferencia TPV,87400,0,"-17029582,08"
03/17/2024,35373,,13280,Terminal SE - Transferencia TPV,87415,0,"-16942167,08"
03/17/2024,35363,,13266,Terminal SE - Transferencia TPV,141600,0,"-16800567,08"
03/17/2024,35362,,13265,Terminal SE - Transferencia TPV,"82490,99",0,"-16718076,09"
03/17/2024,35364,,13267,Terminal SE - Transferencia TPV,"89199,99",0,"-16628876,1"
03/17/2024,35391,,13313,Terminal SE - Transferencia TPV,"143675,99",0,"-16485200,11"
03/17/2024,35401,,13330,Terminal SE - Transferencia TPV,62000,0,"-16423200,11"
03/17/2024,35370,,13274,Terminal SE - Transferencia TPV,"729000,01",0,"-15694200,1"
03/17/2024,35383,,13297,Terminal SE - Transferencia TPV,154274,0,"-15539926,1"
03/17/2024,35365,,13269,Terminal SE - Transferencia TPV,77356,0,"-15462570,1"
03/17/2024,35360,,13263,Terminal SE - Transferencia TPV,124282,0,"-15338288,1"
03/17/2024,35358,,13262,Terminal SE - Transferencia TPV,95056,0,"-15243232,1"
03/17/2024,35361,,13264,Terminal SE - Transferencia TPV,70000,0,"-15173232,1"
03/17/2024,35357,,13261,Terminal SE - Transferencia TPV,7600,0,"-15165632,1"
03/17/2024,35380,,13293,Terminal SE - Transferencia TPV,"163068,99",0,"-15002563,11"
03/17/2024,35397,,13320,Terminal SE - Transferencia TPV,62000,0,"-14940563,11"
03/17/2024,35407,,13352,Terminal SE - Transferencia TPV,"93853,99",0,"-14846709,12"
03/17/2024,35369,,13273,Terminal SE - Transferencia TPV,69500,0,"-14777209,12"
03/17/2024,35378,,13290,Terminal SE - Transferencia TPV,104670,0,"-14672539,12"
03/17/2024,35377,,13289,Terminal SE - Transferencia TPV,"111662,99",0,"-14560876,13"
03/17/2024,35387,,13303,Terminal SE - Transferencia TPV,127000,0,"-14433876,13"
03/17/2024,35404,,13336,Terminal SE - Transferencia TPV,133400,0,"-14300476,13"
03/17/2024,35388,,13305,Terminal SE - Transferencia TPV,80633,0,"-14219843,13"
03/17/2024,35376,,13288,Terminal SE - Transferencia TPV,66102,0,"-14153741,13"
03/17/2024,35405,,13349,Terminal SE - Transferencia TPV,"99644,01",0,"-14054097,12"
03/17/2024,35368,,13272,Terminal SE - Transferencia TPV,66500,0,"-13987597,12"
03/17/2024,35379,,13292,Terminal SE - Transferencia TPV,108713,0,"-13878884,12"
03/17/2024,35402,,13333,Terminal SE - Transferencia TPV,134607,0,"-13744277,12"
03/17/2024,35389,,13306,Terminal SE - Transferencia TPV,225402,0,"-13518875,12"
03/17/2024,35371,,13276,Terminal SE - Transferencia TPV,"99425,99",0,"-13419449,13"
03/17/2024,35375,,13285,Terminal SE - Transferencia TPV,108822,0,"-13310627,13"
03/17/2024,35400,,13324,Terminal SE - Transferencia TPV,"86499,99",0,"-13224127,14"
03/17/2024,35399,,13323,Terminal SE - Transferencia TPV,"181749,98",0,"-13042377,16"
03/17/2024,35366,,13270,Terminal SE - Transferencia TPV,"89373,99",0,"-12953003,17"
03/17/2024,35367,,13271,Terminal SE - Transferencia TPV,"63000,01",0,"-12890003,16"
03/17/2024,35403,,13334,Terminal SE - Transferencia TPV,124228,0,"-12765775,16"
03/17/2024,35406,,13350,Terminal SE - Transferencia TPV,67043,0,"-16808166,16"
03/17/2024,35385,,13300,Terminal SE - Transferencia TPV,"93962,99",0,"-16714203,17"
03/17/2024,35382,,13295,Terminal SE - Transferencia TPV,"56500,01",0,"-16657703,16"
03/17/2024,35381,,13294,Terminal SE - Transferencia TPV,"146789,99",0,"-16510913,17"
03/17/2024,35384,,13298,Terminal SE - Transferencia TPV,111007,0,"-16399906,17"
03/17/2024,35398,,13322,Terminal SE - Transferencia TPV,108713,0,"-16291193,17"
03/17/2024,35356,,13260,Terminal SE - Transferencia TPV,"127499,99",0,"-16163693,18"
03/17/2024,35394,,13317,Terminal SE - Transferencia TPV,"130728,99",0,"-16032964,19"
03/17/2024,35374,,13282,Terminal SE - Transferencia TPV,"87625,99",0,"-15945338,2"
03/17/2024,35390,,13312,Terminal SE - Transferencia TPV,"109258,99",0,"-15836079,21"
03/17/2024,35393,,13315,Terminal SE - Transferencia TPV,"68000,01",0,"-15768079,2"
03/17/2024,35392,,13314,Terminal SE - Transferencia TPV,59500,0,"-15708579,2"
03/18/2024,35408,,,Terminal SE - Transferencia TPV,5787390,0,"-9921189,2"
03/18/2024,35408,,,Terminal SE - Transferencia TPV,0,5787390,"-15708579,2"
03/21/2024,35804,,13420,Terminal SE - Transferencia TPV,"142528,99",0,"-15993932,49"
03/21/2024,35801,,13409,Terminal SE - Transferencia TPV,55558,0,"-15938374,49"
03/21/2024,35805,,13423,Terminal SE - Transferencia TPV,12000,0,"-15926374,49"
03/21/2024,35802,,13416,Terminal SE - Transferencia TPV,138213,0,"-15788161,49"
03/21/2024,35806,,13423,Terminal SE - Transferencia TPV,100000,0,"-15688161,49"
03/21/2024,35803,,13417,Terminal SE - Transferencia TPV,"122000,01",0,"-15566161,48"
03/21/2024,35808,,13431,Terminal SE - Transferencia TPV,84348,0,"-15481813,48"
03/21/2024,35807,,13427,Terminal SE - Transferencia TPV,67000,0,"-15414813,48"
03/22/2024,36085,,13474,Terminal SE - Transferencia TPV,290000,0,"-15124813,48"
03/22/2024,36086,,13476,Terminal SE - Transferencia TPV,"138759,01",0,"-14986054,47"
03/22/2024,36087,,13481,Terminal SE - Transferencia TPV,64000,0,"-14922054,47"
03/22/2024,36088,,13482,Terminal SE - Transferencia TPV,"46447,99",0,"-14875606,48"
03/22/2024,36089,,13484,Terminal SE - Transferencia TPV,84130,0,"-14791476,48"
03/22/2024,36090,,13490,Terminal SE - Transferencia TPV,"60799,99",0,"-15009676,49"
03/22/2024,36091,,13492,Terminal SE - Transferencia TPV,"76153,99",0,"-14933522,5"
03/22/2024,36083,,13470,Terminal SE - Transferencia TPV,52000,0,"-14881522,5"
03/22/2024,36082,,13464,Terminal SE - Transferencia TPV,72000,0,"-14809522,5"
03/22/2024,36081,,13453,Terminal SE - Transferencia TPV,111226,0,"-14698296,5"
03/22/2024,36080,,13452,Terminal SE - Transferencia TPV,"205407,01",0,"-14551888,49"
03/22/2024,36078,,13445,Terminal SE - Transferencia TPV,62500,0,"-14489388,49"
03/22/2024,36079,,13451,Terminal SE - Transferencia TPV,137066,0,"-14352322,49"
03/22/2024,36077,,13444,Terminal SE - Transferencia TPV,111663,0,"-14240659,49"
03/22/2024,35809,,,Terminal SE - Transferencia TPV,0,721634,"-15468672,02"
03/22/2024,35809,,,Terminal SE - Transferencia TPV,721634,0,"-14747038,02"
03/22/2024,36092,,13496,Terminal SE - Transferencia TPV,162578,0,"-14584460,02"
03/22/2024,36093,,13498,Terminal SE - Transferencia TPV,92761,0,"-14491699,02"
03/22/2024,36084,,13472,Terminal SE - Transferencia TPV,54000,0,"-15041099,02"
03/23/2024,36693,,13529,Terminal LS - Transferencia TPV,77683,0,"-15702016,02"
03/23/2024,36699,,13555,Terminal LS - Transferencia TPV,145000,0,"-15557016,02"
03/23/2024,36700,,13556,Terminal LS - Transferencia TPV,60000,0,"-15497016,02"
03/23/2024,36696,,13545,Terminal LS - Transferencia TPV,204937,0,"-15292079,02"
03/23/2024,36616,,13586,Terminal SE - Transferencia TPV,87626,0,"-15204453,02"
03/23/2024,36610,,13571,Terminal SE - Transferencia TPV,115000,0,"-15089453,02"
03/23/2024,36605,,13561,Terminal SE - Transferencia TPV,297950,0,"-14791503,02"
03/23/2024,36094,,,Terminal SE - Transferencia TPV,1821523,0,"-12969980,02"
03/23/2024,36599,,13549,Terminal SE - Transferencia TPV,30302,0,"-12939678,02"
03/23/2024,36601,,13552,Terminal SE - Transferencia TPV,"134999,99",0,"-12804678,03"
03/23/2024,36592,,13531,Terminal SE - Transferencia TPV,165200,0,"-12639478,03"
03/23/2024,36590,,13527,Terminal SE - Transferencia TPV,"133842,99",0,"-12505635,04"
03/23/2024,36606,,13562,Terminal SE - Transferencia TPV,124000,0,"-12381635,04"
03/23/2024,36094,,,Terminal SE - Transferencia TPV,0,1821523,"-14203158,04"
03/23/2024,36704,,13573,Terminal LS - Transferencia TPV,71128,0,"-14132030,04"
03/23/2024,36712,,13597,Terminal LS - Transferencia TPV,"236764,99",0,"-13895265,05"
03/23/2024,36705,,13585,Terminal LS - Transferencia TPV,89374,0,"-13805891,05"
03/23/2024,36614,,13581,Terminal SE - Transferencia TPV,84894,0,"-13720997,05"
03/23/2024,36588,,13525,Terminal SE - Transferencia TPV,89374,0,"-13631623,05"
03/23/2024,36604,,13560,Terminal SE - Transferencia TPV,192000,0,"-13439623,05"
03/23/2024,36611,,13577,Terminal SE - Transferencia TPV,114176,0,"-13325447,05"
03/23/2024,36613,,13580,Terminal SE - Transferencia TPV,"204969,99",0,"-13120477,06"
03/23/2024,36598,,13543,Terminal SE - Transferencia TPV,75300,0,"-13045177,06"
03/23/2024,36596,,13541,Terminal SE - Transferencia TPV,116000,0,"-12929177,06"
03/23/2024,36597,,13542,Terminal SE - Transferencia TPV,54500,0,"-12874677,06"
03/23/2024,36607,,13564,Terminal SE - Transferencia TPV,54900,0,"-12819777,06"
03/23/2024,36602,,13553,Terminal SE - Transferencia TPV,55500,0,"-12764277,06"
03/23/2024,36595,,13537,Terminal SE - Transferencia TPV,"77399,99",0,"-12686877,07"
03/23/2024,36615,,13582,Terminal SE - Transferencia TPV,64500,0,"-12622377,07"
03/23/2024,36612,,13578,Terminal SE - Transferencia TPV,31357,0,"-12591020,07"
03/23/2024,36608,,13565,Terminal SE - Transferencia TPV,65800,0,"-12525220,07"
03/23/2024,36589,,13526,Terminal SE - Transferencia TPV,209068,0,"-12316152,07"
03/23/2024,36593,,13535,Terminal SE - Transferencia TPV,"112999,99",0,"-12203152,08"
03/23/2024,36584,,13520,Terminal SE - Transferencia TPV,113500,0,"-12089652,08"
03/23/2024,36585,,13520,Terminal SE - Transferencia TPV,"10000,01",0,"-12079652,07"
03/23/2024,36600,,13550,Terminal SE - Transferencia TPV,237406,0,"-11842246,07"
03/23/2024,36609,,13570,Terminal SE - Transferencia TPV,166500,0,"-11675746,07"
03/23/2024,36587,,13524,Terminal SE - Transferencia TPV,"79212,99",0,"-11596533,08"
03/23/2024,36586,,13523,Terminal SE - Transferencia TPV,"85000,01",0,"-11511533,07"
03/23/2024,36603,,13558,Terminal SE - Transferencia TPV,"64999,99",0,"-11446533,08"
03/23/2024,36594,,13536,Terminal SE - Transferencia TPV,"95820,01",0,"-11350713,07"
03/23/2024,36591,,13528,Terminal SE - Transferencia TPV,68560,0,"-11282153,07"
03/23/2024,36708,,13591,Terminal LS - Transferencia TPV,28000,0,"-11254153,07"
03/23/2024,36714,,13599,Terminal LS - Transferencia TPV,123190,0,"-11130963,07"
03/23/2024,36691,,13599,Terminal LS - Tarjeta TPV,123190,0,"-11007773,07"
03/23/2024,36701,,13567,Terminal LS - Transferencia TPV,80961,0,"-10926812,07"
03/23/2024,36703,,13572,Terminal LS - Transferencia TPV,223733,0,"-10703079,07"
03/23/2024,36694,,13530,Terminal LS - Transferencia TPV,155367,0,"-10547712,07"
03/23/2024,36706,,13588,Terminal LS - Transferencia TPV,"145314,99",0,"-10402397,08"
03/23/2024,36697,,13547,Terminal LS - Transferencia TPV,67000,0,"-10335397,08"
03/23/2024,36707,,13589,Terminal LS - Transferencia TPV,"85768,99",0,"-10249628,09"
03/23/2024,36713,,13598,Terminal LS - Transferencia TPV,103250,0,"-10146378,09"
03/23/2024,36709,,13594,Terminal LS - Transferencia TPV,412017,0,"-9734361,09"
03/23/2024,36710,,13595,Terminal LS - Transferencia TPV,74500,0,"-9659861,09"
03/23/2024,36698,,13554,Terminal LS - Transferencia TPV,54000,0,"-9605861,09"
03/23/2024,36695,,13538,Terminal LS - Transferencia TPV,86315,0,"-9519546,09"
03/23/2024,36702,,13569,Terminal LS - Transferencia TPV,68615,0,"-9450931,09"
03/23/2024,36711,,13596,Terminal LS - Transferencia TPV,"86314,99",0,"-9364616,1"
03/24/2024,37280,,13674,Terminal SE - Transferencia TPV,89593,0,"-9418723,1"
03/24/2024,37241,,13615,Terminal SE - Transferencia TPV,155694,0,"-9263029,1"
03/24/2024,37258,,13632,Terminal SE - Transferencia TPV,"190766,99",0,"-9072262,11"
03/24/2024,37240,,13614,Terminal SE - Transferencia TPV,"253536,01",0,"-8818726,1"
03/24/2024,37247,,13624,Terminal SE - Transferencia TPV,129750,0,"-8688976,1"
03/24/2024,37232,,13600,Terminal SE - Transferencia TPV,65556,0,"-8623420,1"
03/24/2024,37236,,13609,Terminal SE - Transferencia TPV,"70299,99",0,"-8553120,11"
03/24/2024,37291,,13696,Terminal SE - Transferencia TPV,222343,0,"-8330777,11"
03/24/2024,37269,,13647,Terminal SE - Transferencia TPV,26000,0,"-8304777,11"
03/24/2024,37250,,13627,Terminal SE - Transferencia TPV,"155257,01",0,"-8149520,1"
03/24/2024,37259,,13633,Terminal SE - Transferencia TPV,143348,0,"-8006172,1"
03/24/2024,37233,,13604,Terminal SE - Transferencia TPV,"221741,98",0,"-7784430,12"
03/24/2024,37277,,13670,Terminal SE - Transferencia TPV,"143999,99",0,"-7640430,13"
03/24/2024,37284,,13682,Terminal SE - Transferencia TPV,"145200,01",0,"-7495230,12"
03/24/2024,37265,,13643,Terminal SE - Transferencia TPV,108494,0,"-7386736,12"
03/24/2024,37275,,13668,Terminal SE - Transferencia TPV,"93306,99",0,"-7293429,13"
03/24/2024,37244,,13620,Terminal SE - Transferencia TPV,"82163,01",0,"-7211266,12"
03/24/2024,37272,,13656,Terminal SE - Transferencia TPV,193000,0,"-7018266,12"
03/24/2024,36716,,,Terminal LS - Transferencia TPV,"29229,04",0,"-6989037,08"
03/24/2024,36716,,,Terminal LS - Transferencia TPV,0,"29229,04","-7018266,12"
03/24/2024,36692,,,Terminal LS - Tarjeta TPV,0,1773831,"-8792097,12"
03/24/2024,36692,,,Terminal LS - Tarjeta TPV,1773831,0,"-7018266,12"
03/24/2024,36715,,,Terminal LS - Transferencia TPV,0,2708463,"-9726729,12"
03/24/2024,36715,,,Terminal LS - Transferencia TPV,2708463,0,"-7018266,12"
03/24/2024,37252,,13629,Terminal SE - Transferencia TPV,44500,0,"-7033766,12"
03/24/2024,37253,,13629,Terminal SE - Transferencia TPV,44500,0,"-6989266,12"
03/24/2024,37254,,13629,Terminal SE - Transferencia TPV,44500,0,"-6944766,12"
03/24/2024,37255,,13629,Terminal SE - Transferencia TPV,"44529,99",0,"-6900236,13"
03/24/2024,37256,,13630,Terminal SE - Transferencia TPV,63000,0,"-6837236,13"
03/24/2024,37245,,13621,Terminal SE - Transferencia TPV,"117999,99",0,"-6719236,14"
03/24/2024,37260,,13634,Terminal SE - Transferencia TPV,"86000,01",0,"-6633236,13"
03/24/2024,37282,,13678,Terminal SE - Transferencia TPV,108000,0,"-6525236,13"
03/24/2024,37276,,13669,Terminal SE - Transferencia TPV,68287,0,"-6456949,13"
03/24/2024,37257,,13631,Terminal SE - Transferencia TPV,226385,0,"-6230564,13"
03/24/2024,37264,,13641,Terminal SE - Transferencia TPV,71500,0,"-6159064,13"
03/24/2024,37242,,13616,Terminal SE - Transferencia TPV,143457,0,"-6015607,13"
03/24/2024,37267,,13645,Terminal SE - Transferencia TPV,"162686,99",0,"-5852920,14"
03/24/2024,37262,,13636,Terminal SE - Transferencia TPV,90685,0,"-5762235,14"
03/24/2024,37294,,13702,Terminal SE - Transferencia TPV,"644465,99",0,"-5117769,15"
03/24/2024,37281,,13677,Terminal SE - Transferencia TPV,69000,0,"-5048769,15"
03/24/2024,37274,,13667,Terminal SE - Transferencia TPV,175033,0,"-4873736,15"
03/24/2024,37270,,13650,Terminal SE - Transferencia TPV,"134224,99",0,"-4739511,16"
03/24/2024,37271,,13655,Terminal SE - Transferencia TPV,115000,0,"-4624511,16"
03/24/2024,37248,,13625,Terminal SE - Transferencia TPV,"176000,01",0,"-4448511,15"
03/24/2024,37285,,13684,Terminal SE - Transferencia TPV,61000,0,"-4387511,15"
03/24/2024,37249,,13626,Terminal SE - Transferencia TPV,86096,0,"-4301415,15"
03/24/2024,37289,,13694,Terminal SE - Transferencia TPV,"197540,99",0,"-4103874,16"
03/24/2024,37279,,13672,Terminal SE - Transferencia TPV,80852,0,"-4023022,16"
03/24/2024,37246,,13623,Terminal SE - Transferencia TPV,67000,0,"-3956022,16"
03/24/2024,37237,,13610,Terminal SE - Transferencia TPV,51000,0,"-3905022,16"
03/24/2024,37263,,13637,Terminal SE - Transferencia TPV,"174999,99",0,"-3730022,17"
03/24/2024,37292,,13697,Terminal SE - Transferencia TPV,153782,0,"-3576240,17"
03/24/2024,37278,,13671,Terminal SE - Transferencia TPV,"295163,98",0,"-3281076,19"
03/24/2024,37290,,13695,Terminal SE - Transferencia TPV,164544,0,"-3116532,19"
03/24/2024,37238,,13611,Terminal SE - Transferencia TPV,90685,0,"-3025847,19"
03/24/2024,37283,,13679,Terminal SE - Transferencia TPV,"130000,01",0,"-2895847,18"
03/24/2024,37234,,13606,Terminal SE - Transferencia TPV,201256,0,"-2694591,18"
03/24/2024,37268,,13646,Terminal SE - Transferencia TPV,"115923,99",0,"-2578667,19"
03/24/2024,37239,,13612,Terminal SE - Transferencia TPV,"218409,01",0,"-2360258,18"
03/24/2024,37273,,13664,Terminal SE - Transferencia TPV,53000,0,"-2307258,18"
03/24/2024,37261,,13635,Terminal SE - Transferencia TPV,72000,0,"-2235258,18"
03/24/2024,37243,,13617,Terminal SE - Transferencia TPV,"173721,99",0,"-2061536,19"
03/24/2024,36617,,,Terminal SE - Transferencia TPV,0,3612728,"-5674264,19"
03/24/2024,36617,,,Terminal SE - Transferencia TPV,3612728,0,"-2061536,19"
03/24/2024,37293,,13698,Terminal SE - Transferencia TPV,66500,0,"-5188781,19"
03/24/2024,37251,,13628,Terminal SE - Transferencia TPV,72439,0,"-5116342,19"
03/24/2024,37266,,13644,Terminal SE - Transferencia TPV,91559,0,"-5024783,19"
03/24/2024,37235,,13607,Terminal SE - Transferencia TPV,"95602,02",0,"-4929181,17"
03/25/2024,37756,,13756,Terminal SE - Transferencia TPV,"182500,01",0,"-4746681,16"
03/25/2024,37760,,13763,Terminal SE - Transferencia TPV,177000,0,"-4569681,16"
03/25/2024,37763,,13767,Terminal SE - Transferencia TPV,68600,0,"-4501081,16"
03/25/2024,37762,,13765,Terminal SE - Transferencia TPV,110000,0,"-4391081,16"
03/25/2024,37729,,13717,Terminal SE - Transferencia TPV,"88062,99",0,"-4303018,17"
03/25/2024,37731,,13719,Terminal SE - Transferencia TPV,"154053,99",0,"-4148964,18"
03/25/2024,37723,,13709,Terminal SE - Transferencia TPV,"98551,99",0,"-4050412,19"
03/25/2024,37748,,13742,Terminal SE - Transferencia TPV,157388,0,"-3893024,19"
03/25/2024,37741,,13732,Terminal SE - Transferencia TPV,25130,0,"-3867894,19"
03/25/2024,37759,,13761,Terminal SE - Transferencia TPV,199398,0,"-3668496,19"
03/25/2024,37768,,13775,Terminal SE - Transferencia TPV,39100,0,"-3629396,19"
03/25/2024,37761,,13764,Terminal SE - Transferencia TPV,101502,0,"-3527894,19"
03/25/2024,37728,,13714,Terminal SE - Transferencia TPV,"74241,99",0,"-3453652,2"
03/25/2024,37737,,13726,Terminal SE - Transferencia TPV,"188744,99",0,"-3264907,21"
03/25/2024,37757,,13757,Terminal SE - Transferencia TPV,"133514,99",0,"-3131392,22"
03/25/2024,37295,,,Terminal SE - Transferencia TPV,8114179,0,"4982786,78"
03/25/2024,37735,,13724,Terminal SE - Transferencia TPV,111000,0,"5093786,78"
03/25/2024,37730,,13718,Terminal SE - Transferencia TPV,150000,0,"5243786,78"
03/25/2024,37747,,13740,Terminal SE - Transferencia TPV,125000,0,"5368786,78"
03/25/2024,37745,,13737,Terminal SE - Transferencia TPV,105000,0,"5473786,78"
03/25/2024,37753,,13749,Terminal SE - Transferencia TPV,"89046,01",0,"5562832,79"
03/25/2024,37733,,13721,Terminal SE - Transferencia TPV,90248,0,"3863401,61"
03/25/2024,37749,,13745,Terminal SE - Transferencia TPV,"66500,01",0,"3929901,62"
03/25/2024,37743,,13734,Terminal SE - Transferencia TPV,96694,0,"4026595,62"
03/25/2024,37758,,13758,Terminal SE - Transferencia TPV,87954,0,"4114549,62"
03/25/2024,37732,,13720,Terminal SE - Transferencia TPV,"309694,99",0,"4424244,61"
03/25/2024,37742,,13733,Terminal SE - Transferencia TPV,223544,0,"4647788,61"
03/25/2024,37744,,13735,Terminal SE - Transferencia TPV,21600,0,"4669388,61"
03/25/2024,37771,,13780,Terminal SE - Transferencia TPV,"94071,99",0,"4763460,6"
03/25/2024,37727,,13713,Terminal SE - Transferencia TPV,138213,0,"4901673,6"
03/25/2024,37754,,13751,Terminal SE - Transferencia TPV,"61500,01",0,"4963173,61"
03/25/2024,37773,,13782,Terminal SE - Transferencia TPV,"84129,99",0,"5047303,6"
03/25/2024,37751,,13747,Terminal SE - Transferencia TPV,102157,0,"5149460,6"
03/25/2024,37740,,13731,Terminal SE - Transferencia TPV,"141749,98",0,"5291210,58"
03/25/2024,37755,,13752,Terminal SE - Transferencia TPV,140835,0,"5432045,58"
03/25/2024,37752,,13748,Terminal SE - Transferencia TPV,65000,0,"5497045,58"
03/25/2024,37295,,,Terminal SE - Transferencia TPV,0,8114179,"-2617133,42"
03/25/2024,37764,,13770,Terminal SE - Transferencia TPV,"115050,01",0,"-2502083,41"
03/25/2024,37772,,13781,Terminal SE - Transferencia TPV,"679999,99",0,"-2957015,42"
03/25/2024,37725,,13711,Terminal SE - Transferencia TPV,"138759,01",0,"-2818256,41"
03/25/2024,37746,,13739,Terminal SE - Transferencia TPV,107839,0,"-2710417,41"
03/25/2024,37750,,13746,Terminal SE - Transferencia TPV,"74514,99",0,"-2635902,42"
03/25/2024,37736,,13725,Terminal SE - Transferencia TPV,334880,0,"-2301022,42"
03/25/2024,37734,,13722,Terminal SE - Transferencia TPV,84130,0,"-5559426,67"
03/25/2024,37726,,13712,Terminal SE - Transferencia TPV,109150,0,"-5450276,67"
03/25/2024,37724,,13710,Terminal SE - Transferencia TPV,65000,0,"-5385276,67"
03/25/2024,37738,,13727,Terminal SE - Transferencia TPV,133843,0,"-5251433,67"
03/25/2024,37770,,13775,Terminal SE - Transferencia TPV,"39100,01",0,"-5212333,66"
03/25/2024,37769,,13775,Terminal SE - Transferencia TPV,39100,0,"-5173233,66"
03/25/2024,37739,,13729,Terminal SE - Transferencia TPV,30734,0,"-6012865,66"
03/25/2024,37767,,13775,Terminal SE - Transferencia TPV,39100,0,"-5973765,66"
03/25/2024,37765,,13772,Terminal SE - Transferencia TPV,109000,0,"-5864765,66"
03/25/2024,37766,,13774,Terminal SE - Transferencia TPV,60639,0,"-7414126,66"
03/26/2024,37774,,,Terminal SE - Transferencia TPV,6262726,0,"-2588880,26"
03/26/2024,37774,,,Terminal SE - Transferencia TPV,0,6262726,"-13213254,24"
03/27/2024,39620,,13802,Terminal SE - Transferencia TPV,104670,0,"-14041030,03"
03/27/2024,39624,,13804,Terminal SE - Transferencia TPV,"87516,99",0,"-13953513,04"
03/27/2024,39625,,13805,Terminal SE - Transferencia TPV,128052,0,"-13825461,04"
03/27/2024,39626,,13806,Terminal SE - Transferencia TPV,61895,0,"-13763566,04"
03/27/2024,39627,,13807,Terminal SE - Transferencia TPV,"119856,99",0,"-14496159,01"
03/27/2024,39628,,13817,Terminal SE - Transferencia TPV,"94999,99",0,"-14401159,02"
03/27/2024,39631,,13823,Terminal SE - Transferencia TPV,"146407,01",0,"-14254752,01"
03/27/2024,39632,,13826,Terminal SE - Transferencia TPV,64244,0,"-14190508,01"
03/27/2024,39633,,13837,Terminal SE - Transferencia TPV,"107767,99",0,"-14082740,02"
03/27/2024,39634,,13838,Terminal SE - Transferencia TPV,57500,0,"-14025240,02"
03/27/2024,39617,,13797,Terminal SE - Transferencia TPV,8550,0,"-14016690,02"
03/27/2024,39618,,13799,Terminal SE - Transferencia TPV,85769,0,"-13930921,02"
03/27/2024,39641,,13859,Terminal SE - Transferencia TPV,126194,0,"-13804727,02"
03/27/2024,39640,,13853,Terminal SE - Transferencia TPV,"149193,99",0,"-13655533,03"
03/27/2024,39639,,13852,Terminal SE - Transferencia TPV,148647,0,"-13506886,03"
03/27/2024,39638,,13849,Terminal SE - Transferencia TPV,204315,0,"-13302571,03"
03/27/2024,39637,,13843,Terminal SE - Transferencia TPV,62500,0,"-13240071,03"
03/27/2024,39636,,13842,Terminal SE - Transferencia TPV,159000,0,"-13081071,03"
03/27/2024,39635,,13841,Terminal SE - Transferencia TPV,66000,0,"-13015071,03"
03/27/2024,39630,,13821,Terminal SE - Transferencia TPV,"62468,99",0,"-12952602,04"
03/27/2024,39629,,13821,Terminal SE - Transferencia TPV,100000,0,"-12949602,04"
03/27/2024,39623,,13803,Terminal SE - Transferencia TPV,"115999,99",0,"-12833602,05"
03/27/2024,39622,,13803,Terminal SE - Transferencia TPV,58000,0,"-12775602,05"
03/27/2024,39621,,13803,Terminal SE - Transferencia TPV,58000,0,"-12717602,05"
03/27/2024,39619,,13801,Terminal SE - Transferencia TPV,"200490,99",0,"-12824311,06"
03/28/2024,40222,,13948,Terminal SE - Transferencia TPV,8550,0,"-12815761,06"
03/28/2024,40192,,13881,Terminal SE - Transferencia TPV,71500,0,"-12744261,06"
03/28/2024,40213,,13927,Terminal SE - Transferencia TPV,130182,0,"-12614079,06"
03/28/2024,40225,,13956,Terminal SE - Transferencia TPV,"103925,99",0,"-12510153,07"
03/28/2024,40216,,13939,Terminal SE - Transferencia TPV,"235016,98",0,"-12275136,09"
03/28/2024,40201,,13898,Terminal SE - Transferencia TPV,"174923,99",0,"-12100212,1"
03/28/2024,40224,,13954,Terminal SE - Transferencia TPV,"98999,98",0,"-12001212,12"
03/28/2024,40205,,13908,Terminal SE - Transferencia TPV,77900,0,"-11923312,12"
03/28/2024,40202,,13900,Terminal SE - Transferencia TPV,222561,0,"-11700751,12"
03/28/2024,40194,,13883,Terminal SE - Transferencia TPV,"330454,99",0,"-11370296,13"
03/28/2024,40196,,13885,Terminal SE - Transferencia TPV,71674,0,"-11298622,13"
03/28/2024,40206,,13910,Terminal SE - Transferencia TPV,105000,0,"-11193622,13"
03/28/2024,40199,,13894,Terminal SE - Transferencia TPV,69000,0,"-11124622,13"
03/28/2024,40217,,13941,Terminal SE - Transferencia TPV,"158534,99",0,"-10966087,14"
03/28/2024,40189,,13872,Terminal SE - Transferencia TPV,147828,0,"-10818259,14"
03/28/2024,40204,,13907,Terminal SE - Transferencia TPV,87298,0,"-10730961,14"
03/28/2024,40185,,13868,Terminal SE - Transferencia TPV,"89999,99",0,"-10640961,15"
03/28/2024,40195,,13884,Terminal SE - Transferencia TPV,105435,0,"-10535526,15"
03/28/2024,40223,,13952,Terminal SE - Transferencia TPV,"157387,98",0,"-10378138,17"
03/28/2024,40208,,13919,Terminal SE - Transferencia TPV,90000,0,"-10288138,17"
03/28/2024,40193,,13882,Terminal SE - Transferencia TPV,80800,0,"-10207338,17"
03/28/2024,40187,,13870,Terminal SE - Transferencia TPV,"89045,99",0,"-10118292,18"
03/28/2024,40221,,13947,Terminal SE - Transferencia TPV,72500,0,"-10045792,18"
03/28/2024,40190,,13878,Terminal SE - Transferencia TPV,"69379,99",0,"-9976412,19"
03/28/2024,40200,,13895,Terminal SE - Transferencia TPV,"137174,99",0,"-9839237,2"
03/28/2024,40209,,13920,Terminal SE - Transferencia TPV,112209,0,"-9727028,2"
03/28/2024,40219,,13945,Terminal SE - Transferencia TPV,80000,0,"-9647028,2"
03/28/2024,40198,,13887,Terminal SE - Transferencia TPV,"40999,99",0,"-9606028,21"
03/28/2024,40214,,13928,Terminal SE - Transferencia TPV,"224528,01",0,"-9381500,2"
03/28/2024,40215,,13938,Terminal SE - Transferencia TPV,"212563,98",0,"-9168936,22"
03/28/2024,40212,,13925,Terminal SE - Transferencia TPV,104581,0,"-9064355,22"
03/28/2024,40191,,13880,Terminal SE - Transferencia TPV,158207,0,"-8906148,22"
03/28/2024,40186,,13869,Terminal SE - Transferencia TPV,"362959,01",0,"-8543189,21"
03/28/2024,40218,,13944,Terminal SE - Transferencia TPV,71000,0,"-8472189,21"
03/28/2024,40211,,13924,Terminal SE - Transferencia TPV,112000,0,"-8360189,21"
03/28/2024,40220,,13946,Terminal SE - Transferencia TPV,62500,0,"-8297689,21"
03/28/2024,39642,,,Terminal SE - Transferencia TPV,0,2578074,"-10875763,21"
03/28/2024,40210,,13921,Terminal SE - Transferencia TPV,79000,0,"-10796763,21"
03/28/2024,40203,,13901,Terminal SE - Transferencia TPV,"68999,99",0,"-10727763,22"
03/28/2024,40207,,13914,Terminal SE - Transferencia TPV,93635,0,"-10634128,22"
03/28/2024,40188,,13871,Terminal SE - Transferencia TPV,57000,0,"-10577128,22"
03/28/2024,40197,,13886,Terminal SE - Transferencia TPV,481600,0,"-10095528,22"
03/29/2024,40923,,14048,Terminal SE - Transferencia TPV,"145006,01",0,"-9950522,21"
03/29/2024,40902,,14002,Terminal SE - Transferencia TPV,"194262,99",0,"-9756259,22"
03/29/2024,40888,,13983,Terminal SE - Transferencia TPV,"101282,99",0,"-9654976,23"
03/29/2024,40921,,14047,Terminal SE - Transferencia TPV,95493,0,"-9559483,23"
03/29/2024,40910,,14025,Terminal SE - Transferencia TPV,93463,0,"-9466020,23"
03/29/2024,40885,,13977,Terminal SE - Transferencia TPV,"165999,99",0,"-9300020,24"
03/29/2024,40909,,14018,Terminal SE - Transferencia TPV,109000,0,"-9191020,24"
03/29/2024,40924,,14049,Terminal SE - Transferencia TPV,101000,0,"-9090020,24"
03/29/2024,40884,,13976,Terminal SE - Transferencia TPV,"107838,99",0,"-8982181,25"
03/29/2024,40894,,13990,Terminal SE - Transferencia TPV,135263,0,"-8846918,25"
03/29/2024,40935,,14070,Terminal SE - Transferencia TPV,178420,0,"-8668498,25"
03/29/2024,40916,,14034,Terminal SE - Transferencia TPV,55500,0,"-9164129,36"
03/29/2024,40912,,14029,Terminal SE - Transferencia TPV,"66000,01",0,"-9098129,35"
03/29/2024,40914,,14032,Terminal SE - Transferencia TPV,54000,0,"-9044129,35"
03/29/2024,40938,,14081,Terminal SE - Transferencia TPV,"77245,99",0,"-8966883,36"
03/29/2024,40926,,14053,Terminal SE - Transferencia TPV,68000,0,"-8898883,36"
03/29/2024,40886,,13979,Terminal SE - Transferencia TPV,78994,0,"-8819889,36"
03/29/2024,40911,,14027,Terminal SE - Transferencia TPV,"89999,99",0,"-8729889,37"
03/29/2024,40918,,14038,Terminal SE - Transferencia TPV,158207,0,"-8571682,37"
03/29/2024,40893,,13988,Terminal SE - Transferencia TPV,157469,0,"-8414213,37"
03/29/2024,40907,,14014,Terminal SE - Transferencia TPV,89046,0,"-8325167,37"
03/29/2024,40887,,13981,Terminal SE - Transferencia TPV,137011,0,"-8188156,37"
03/29/2024,40933,,14065,Terminal SE - Transferencia TPV,"423168,97",0,"-7764987,4"
03/29/2024,40904,,14004,Terminal SE - Transferencia TPV,"81725,99",0,"-7683261,41"
03/29/2024,40937,,14080,Terminal SE - Transferencia TPV,"106527,99",0,"-7576733,42"
03/29/2024,40922,,14048,Terminal SE - Transferencia TPV,145005,0,"-7431728,42"
03/29/2024,40226,,,Terminal SE - Transferencia TPV,0,5306923,"-12738651,42"
03/29/2024,40891,,13986,Terminal SE - Transferencia TPV,130000,0,"-12608651,42"
03/29/2024,40892,,13986,Terminal SE - Transferencia TPV,163361,0,"-12445290,42"
03/29/2024,40896,,13993,Terminal SE - Transferencia TPV,50000,0,"-12395290,42"
03/29/2024,40919,,14040,Terminal SE - Transferencia TPV,"53000,01",0,"-12342290,41"
03/29/2024,40897,,13994,Terminal SE - Transferencia TPV,"140347,99",0,"-12201942,42"
03/29/2024,40929,,14060,Terminal SE - Transferencia TPV,64000,0,"-12137942,42"
03/29/2024,40928,,14058,Terminal SE - Transferencia TPV,80700,0,"-12057242,42"
03/29/2024,40920,,14042,Terminal SE - Transferencia TPV,62000,0,"-11995242,42"
03/29/2024,40881,,13971,Terminal SE - Transferencia TPV,"153508,99",0,"-11841733,43"
03/29/2024,40927,,14056,Terminal SE - Transferencia TPV,111000,0,"-11730733,43"
03/29/2024,40905,,14009,Terminal SE - Transferencia TPV,"94181,01",0,"-11636552,42"
03/29/2024,40900,,13998,Terminal SE - Transferencia TPV,"217589,98",0,"-11418962,44"
03/29/2024,40917,,14037,Terminal SE - Transferencia TPV,"245559,98",0,"-11173402,46"
03/29/2024,40915,,14033,Terminal SE - Transferencia TPV,120000,0,"-11053402,46"
03/29/2024,40899,,13997,Terminal SE - Transferencia TPV,"79759,01",0,"-10973643,45"
03/29/2024,40903,,14003,Terminal SE - Transferencia TPV,"163451,98",0,"-10810191,47"
03/29/2024,40936,,14074,Terminal SE - Transferencia TPV,47600,0,"-10762591,47"
03/29/2024,40934,,14066,Terminal SE - Transferencia TPV,104000,0,"-10658591,47"
03/29/2024,40895,,13991,Terminal SE - Transferencia TPV,"98879,99",0,"-10559711,48"
03/29/2024,40890,,13985,Terminal SE - Transferencia TPV,"145400,01",0,"-10414311,47"
03/29/2024,40925,,14052,Terminal SE - Transferencia TPV,123000,0,"-10291311,47"
03/29/2024,40908,,14015,Terminal SE - Transferencia TPV,72000,0,"-10219311,47"
03/29/2024,40882,,13972,Terminal SE - Transferencia TPV,"104342,99",0,"-10114968,48"
03/29/2024,40932,,14064,Terminal SE - Transferencia TPV,"102244,99",0,"-10513723,49"
03/29/2024,40883,,13975,Terminal SE - Transferencia TPV,124556,0,"-10389167,49"
03/29/2024,40906,,14013,Terminal SE - Transferencia TPV,"220102,98",0,"-10169064,51"
03/29/2024,40930,,14062,Terminal SE - Transferencia TPV,"104342,99",0,"-10064721,52"
03/29/2024,40901,,14000,Terminal SE - Transferencia TPV,83037,0,"-9981684,52"
03/29/2024,40931,,14063,Terminal SE - Transferencia TPV,112537,0,"-9869147,52"
03/29/2024,40913,,14031,Terminal SE - Transferencia TPV,58000,0,"-9983947,52"
03/29/2024,40889,,13984,Terminal SE - Transferencia TPV,"98999,99",0,"-9884947,53"
03/29/2024,40898,,13996,Terminal SE - Transferencia TPV,"79759,01",0,"-9805188,52"
03/30/2024,41640,,14209,Terminal SE - Transferencia TPV,83911,0,"-9721277,52"
03/30/2024,40939,,,Terminal SE - Transferencia TPV,0,6822316,"-18551493,52"
03/30/2024,41639,,14207,Terminal SE - Transferencia TPV,"144549,99",0,"-18406943,53"
03/30/2024,41609,,14134,Terminal SE - Transferencia TPV,"105216,99",0,"-18301726,54"
03/30/2024,41593,,14114,Terminal SE - Transferencia TPV,77683,0,"-18224043,54"
03/30/2024,41603,,14126,Terminal SE - Transferencia TPV,"90099,99",0,"-18133943,55"
03/30/2024,41610,,14136,Terminal SE - Transferencia TPV,"161704,01",0,"-17972239,54"
03/30/2024,41608,,14133,Terminal SE - Transferencia TPV,138978,0,"-17833261,54"
03/30/2024,41629,,14187,Terminal SE - Transferencia TPV,"113000,01",0,"-17720261,53"
03/30/2024,41636,,14203,Terminal SE - Transferencia TPV,169352,0,"-17550909,53"
03/30/2024,41626,,14177,Terminal SE - Transferencia TPV,"76481,01",0,"-17474428,52"
03/30/2024,41617,,14151,Terminal SE - Transferencia TPV,246598,0,"-17227830,52"
03/30/2024,41605,,14128,Terminal SE - Transferencia TPV,"169800,01",0,"-17058030,51"
03/30/2024,41595,,14116,Terminal SE - Transferencia TPV,24320,0,"-17033710,51"
03/30/2024,41584,,14098,Terminal SE - Transferencia TPV,125900,0,"-16907810,51"
03/30/2024,41598,,14119,Terminal SE - Transferencia TPV,78994,0,"-16828816,51"
03/30/2024,41586,,14100,Terminal SE - Transferencia TPV,"185084,98",0,"-16643731,53"
03/30/2024,41615,,14149,Terminal SE - Transferencia TPV,"112999,99",0,"-16530731,54"
03/30/2024,41622,,14164,Terminal SE - Transferencia TPV,59500,0,"-16471231,54"
03/30/2024,41600,,14121,Terminal SE - Transferencia TPV,88900,0,"-16382331,54"
03/30/2024,41642,,14211,Terminal SE - Transferencia TPV,93000,0,"-16289331,54"
03/30/2024,41590,,14108,Terminal SE - Transferencia TPV,"205352,98",0,"-16083978,56"
03/30/2024,41594,,14115,Terminal SE - Transferencia TPV,7600,0,"-16076378,56"
03/30/2024,41587,,14102,Terminal SE - Transferencia TPV,181370,0,"-15895008,56"
03/30/2024,41585,,14099,Terminal SE - Transferencia TPV,86315,0,"-15808693,56"
03/30/2024,41599,,14120,Terminal SE - Transferencia TPV,"114999,99",0,"-15693693,57"
03/30/2024,41592,,14113,Terminal SE - Transferencia TPV,"97513,99",0,"-15596179,58"
03/30/2024,41628,,14184,Terminal SE - Transferencia TPV,77000,0,"-15519179,58"
03/30/2024,41612,,14138,Terminal SE - Transferencia TPV,"60965,99",0,"-15458213,59"
03/30/2024,41616,,14150,Terminal SE - Transferencia TPV,65000,0,"-15393213,59"
03/30/2024,41621,,14160,Terminal SE - Transferencia TPV,"169952,99",0,"-15223260,6"
03/30/2024,41641,,14210,Terminal SE - Transferencia TPV,148702,0,"-15074558,6"
03/30/2024,41614,,14145,Terminal SE - Transferencia TPV,232176,0,"-14842382,6"
03/30/2024,41630,,14195,Terminal SE - Transferencia TPV,"63000,01",0,"-14779382,59"
03/30/2024,41618,,14155,Terminal SE - Transferencia TPV,"253918,98",0,"-14525463,61"
03/30/2024,41637,,14205,Terminal SE - Transferencia TPV,116500,0,"-14408963,61"
03/30/2024,41634,,14199,Terminal SE - Transferencia TPV,275000,0,"-14133963,61"
03/30/2024,41606,,14129,Terminal SE - Transferencia TPV,196700,0,"-13937263,61"
03/30/2024,41611,,14137,Terminal SE - Transferencia TPV,"157988,99",0,"-13779274,62"
03/30/2024,41589,,14107,Terminal SE - Transferencia TPV,85659,0,"-13693615,62"
03/30/2024,41619,,14156,Terminal SE - Transferencia TPV,145151,0,"-13548464,62"
03/30/2024,41633,,14198,Terminal SE - Transferencia TPV,103000,0,"-13445464,62"
03/30/2024,41632,,14197,Terminal SE - Transferencia TPV,78800,0,"-13366664,62"
03/30/2024,41644,,14213,Terminal SE - Transferencia TPV,"380604,99",0,"-12986059,63"
03/30/2024,41588,,14106,Terminal SE - Transferencia TPV,"116360,99",0,"-12869698,64"
03/30/2024,41613,,14139,Terminal SE - Transferencia TPV,76809,0,"-12792889,64"
03/30/2024,41624,,14175,Terminal SE - Transferencia TPV,"85276,99",0,"-12707612,65"
03/30/2024,41607,,14132,Terminal SE - Transferencia TPV,115159,0,"-12592453,65"
03/30/2024,41643,,14212,Terminal SE - Transferencia TPV,74351,0,"-12518102,65"
03/30/2024,41604,,14127,Terminal SE - Transferencia TPV,62000,0,"-12456102,65"
03/30/2024,41625,,14176,Terminal SE - Transferencia TPV,"83146,01",0,"-12372956,64"
03/30/2024,41638,,14206,Terminal SE - Transferencia TPV,87407,0,"-12285549,64"
03/30/2024,41627,,14183,Terminal SE - Transferencia TPV,87000,0,"-12198549,64"
03/30/2024,41596,,14117,Terminal SE - Transferencia TPV,214039,0,"-11984510,64"
03/30/2024,41645,,14214,Terminal SE - Transferencia TPV,192952,0,"-11791558,64"
03/30/2024,41623,,14166,Terminal SE - Transferencia TPV,"106636,99",0,"-11684921,65"
03/30/2024,41620,,14157,Terminal SE - Transferencia TPV,59000,0,"-11625921,65"
03/30/2024,41601,,14124,Terminal SE - Transferencia TPV,"93689,99",0,"-11532231,66"
03/30/2024,41631,,14196,Terminal SE - Transferencia TPV,"95592,99",0,"-11436638,67"
03/30/2024,41591,,14112,Terminal SE - Transferencia TPV,"83037,01",0,"-11353601,66"
03/30/2024,41602,,14125,Terminal SE - Transferencia TPV,"237638,99",0,"-11115962,67"
03/30/2024,41597,,14118,Terminal SE - Transferencia TPV,"137611,99",0,"-10978350,68"
03/30/2024,41635,,14200,Terminal SE - Transferencia TPV,"113500,01",0,"-10864850,67"
03/31/2024,41646,,,Terminal SE - Transferencia TPV,0,7770706,"-18954941,46"
03/31/2024,41969,,14238,Terminal SE - Transferencia TPV,90000,0,"-18864941,46"
03/31/2024,41968,,14237,Terminal SE - Transferencia TPV,150000,0,"-18714941,46"
03/31/2024,41967,,14236,Terminal SE - Transferencia TPV,131000,0,"-18583941,46"
03/31/2024,41978,,14257,Terminal SE - Transferencia TPV,76809,0,"-18507132,46"
03/31/2024,41980,,14259,Terminal SE - Transferencia TPV,36500,0,"-18470632,46"
03/31/2024,41981,,14260,Terminal SE - Transferencia TPV,"193825,98",0,"-18276806,48"
03/31/2024,41982,,14261,Terminal SE - Transferencia TPV,135000,0,"-18141806,48"
03/31/2024,41983,,14263,Terminal SE - Transferencia TPV,191204,0,"-17950602,48"
03/31/2024,41984,,14264,Terminal SE - Transferencia TPV,87626,0,"-17862976,48"
03/31/2024,41985,,14268,Terminal SE - Transferencia TPV,167604,0,"-17695372,48"
03/31/2024,41979,,14258,Terminal SE - Transferencia TPV,124883,0,"-17570489,48"
03/31/2024,41977,,14253,Terminal SE - Transferencia TPV,"164200,99",0,"-17406288,49"
03/31/2024,41976,,14248,Terminal SE - Transferencia TPV,67700,0,"-17338588,49"
03/31/2024,41975,,14246,Terminal SE - Transferencia TPV,191531,0,"-17147057,49"
03/31/2024,41974,,14245,Terminal SE - Transferencia TPV,6000,0,"-17141057,49"
03/31/2024,41973,,14244,Terminal SE - Transferencia TPV,"68000,01",0,"-17073057,48"
03/31/2024,41972,,14242,Terminal SE - Transferencia TPV,82000,0,"-16991057,48"
03/31/2024,41971,,14240,Terminal SE - Transferencia TPV,"117499,99",0,"-16873557,49"
03/31/2024,41970,,14239,Terminal SE - Transferencia TPV,65000,0,"-16808557,49"
03/31/2024,41966,,14223,Terminal SE - Transferencia TPV,"125000,01",0,"-16683557,48"
03/31/2024,41986,,14269,Terminal SE - Transferencia TPV,"251799,99",0,"-16431757,49"
03/31/2024,41987,,14270,Terminal SE - Transferencia TPV,50000,0,"-16381757,49"
03/31/2024,41988,,14271,Terminal SE - Transferencia TPV,"215000,01",0,"-16166757,48"
04/01/2024,41989,,,Terminal SE - Transferencia TPV,0,2788401,"-37245696,48"
04/04/2024,42210,,14308,Terminal SE - Transferencia TPV,84800,0,"-40655361,65"
04/04/2024,42212,,14308,Terminal SE - Transferencia TPV,87300,0,"-40568061,65"
04/04/2024,42214,,14309,Terminal SE - Transferencia TPV,74788,0,"-40493273,65"
04/04/2024,42213,,14308,Terminal SE - Transferencia TPV,93500,0,"-40399773,65"
04/04/2024,42217,,14317,Terminal SE - Transferencia TPV,60000,0,"-40339773,65"
04/04/2024,42208,,14307,Terminal SE - Transferencia TPV,84894,0,"-40254879,65"
04/04/2024,42215,,14315,Terminal SE - Transferencia TPV,"174999,99",0,"-40079879,66"
04/04/2024,42216,,14316,Terminal SE - Transferencia TPV,108000,0,"-39971879,66"
04/04/2024,42207,,14306,Terminal SE - Transferencia TPV,116000,0,"-39855879,66"
04/04/2024,42209,,14308,Terminal SE - Transferencia TPV,70300,0,"-39785579,66"
04/04/2024,42211,,14308,Terminal SE - Transferencia TPV,63700,0,"-39721879,66"
04/05/2024,42505,,14352,Terminal SE - Transferencia TPV,"199600,01",0,"-39522279,65"
04/05/2024,42218,,,Terminal SE - Transferencia TPV,0,1018282,"-40540561,65"
04/05/2024,42502,,14342,Terminal SE - Transferencia TPV,135000,0,"-40405561,65"
04/05/2024,42503,,14343,Terminal SE - Transferencia TPV,120000,0,"-40285561,65"
04/05/2024,42504,,14350,Terminal SE - Transferencia TPV,199507,0,"-40086054,65"
04/05/2024,42506,,14357,Terminal SE - Transferencia TPV,"156295,01",0,"-39929759,64"
04/05/2024,42507,,14361,Terminal SE - Transferencia TPV,"228460,99",0,"-39701298,65"
04/05/2024,42508,,14362,Terminal SE - Transferencia TPV,57800,0,"-39643498,65"
04/05/2024,42509,,14366,Terminal SE - Transferencia TPV,68287,0,"-39575211,65"
04/05/2024,42510,,14369,Terminal SE - Transferencia TPV,"93416,99",0,"-39481794,66"
04/05/2024,42511,,14375,Terminal SE - Transferencia TPV,"53599,99",0,"-39428194,67"
04/05/2024,42512,,14376,Terminal SE - Transferencia TPV,93034,0,"-39335160,67"
04/05/2024,42514,,14378,Terminal SE - Transferencia TPV,64000,0,"-39271160,67"
04/05/2024,42517,,14383,Terminal SE - Transferencia TPV,"96147,99",0,"-39175012,68"
04/05/2024,42513,,14377,Terminal SE - Transferencia TPV,61800,0,"-40338212,68"
04/05/2024,42515,,14379,Terminal SE - Transferencia TPV,98000,0,"-40240212,68"
04/05/2024,42516,,14379,Terminal SE - Transferencia TPV,96741,0,"-40143471,68"
04/05/2024,42498,,14333,Terminal SE - Transferencia TPV,82200,0,"-40061271,68"
04/05/2024,42499,,14335,Terminal SE - Transferencia TPV,69500,0,"-39991771,68"
04/05/2024,42500,,14337,Terminal SE - Transferencia TPV,"88827,99",0,"-39902943,69"
04/05/2024,42501,,14339,Terminal SE - Transferencia TPV,23000,0,"-39879943,69"
04/06/2024,43089,,14486,Terminal SE - Transferencia TPV,104343,0,"-39775600,69"
04/06/2024,42518,,,Terminal SE - Transferencia TPV,0,2086545,"-41862145,69"
04/06/2024,43067,,14412,Terminal SE - Transferencia TPV,"122971,02",0,"-41739174,67"
04/06/2024,43074,,14435,Terminal SE - Transferencia TPV,"81944,01",0,"-41657230,66"
04/06/2024,43088,,14484,Terminal SE - Transferencia TPV,"61999,99",0,"-41595230,67"
04/06/2024,43068,,14413,Terminal SE - Transferencia TPV,102000,0,"-41493230,67"
04/06/2024,43085,,14479,Terminal SE - Transferencia TPV,"148999,99",0,"-41344230,68"
04/06/2024,43081,,14474,Terminal SE - Transferencia TPV,87954,0,"-41256276,68"
04/06/2024,43071,,14423,Terminal SE - Transferencia TPV,"241462,98",0,"-41014813,7"
04/06/2024,43075,,14446,Terminal SE - Transferencia TPV,"147500,01",0,"-40867313,69"
04/06/2024,43087,,14483,Terminal SE - Transferencia TPV,59000,0,"-40808313,69"
04/06/2024,43073,,14433,Terminal SE - Transferencia TPV,"80852,01",0,"-40727461,68"
04/06/2024,43078,,14462,Terminal SE - Transferencia TPV,101720,0,"-40625741,68"
04/06/2024,43065,,14407,Terminal SE - Transferencia TPV,213274,0,"-40412467,68"
04/06/2024,43064,,14405,Terminal SE - Transferencia TPV,240862,0,"-40171605,68"
04/06/2024,43079,,14469,Terminal SE - Transferencia TPV,50000,0,"-40121605,68"
04/06/2024,43077,,14461,Terminal SE - Transferencia TPV,66976,0,"-40054629,68"
04/06/2024,43076,,14455,Terminal SE - Transferencia TPV,"141999,99",0,"-39912629,69"
04/06/2024,43066,,14410,Terminal SE - Transferencia TPV,88500,0,"-39824129,69"
04/06/2024,43072,,14431,Terminal SE - Transferencia TPV,"53000,01",0,"-39771129,68"
04/06/2024,43086,,14482,Terminal SE - Transferencia TPV,"133000,01",0,"-39638129,67"
04/06/2024,43070,,14422,Terminal SE - Transferencia TPV,"70000,01",0,"-39568129,66"
04/06/2024,43082,,14476,Terminal SE - Transferencia TPV,"132950,01",0,"-39435179,65"
04/06/2024,43084,,14478,Terminal SE - Transferencia TPV,10000,0,"-39425179,65"
04/06/2024,43083,,14477,Terminal SE - Transferencia TPV,69500,0,"-39355679,65"
04/06/2024,43063,,14402,Terminal SE - Transferencia TPV,90794,0,"-39264885,65"
04/06/2024,43069,,14421,Terminal SE - Transferencia TPV,82600,0,"-39182285,65"
04/06/2024,43062,,14397,Terminal SE - Transferencia TPV,126000,0,"-39056285,65"
04/06/2024,43080,,14473,Terminal SE - Transferencia TPV,125115,0,"-38931170,65"
04/07/2024,43624,,14517,Terminal SE - Transferencia TPV,"240042,98",0,"-38691127,67"
04/07/2024,43652,,14589,Terminal SE - Transferencia TPV,"112000,01",0,"-38579127,66"
04/07/2024,43628,,14523,Terminal SE - Transferencia TPV,"364380,01",0,"-38214747,65"
04/07/2024,43644,,14574,Terminal SE - Transferencia TPV,"69106,01",0,"-38145641,64"
04/07/2024,43638,,14549,Terminal SE - Transferencia TPV,84020,0,"-38061621,64"
04/07/2024,43626,,14521,Terminal SE - Transferencia TPV,"61999,99",0,"-37999621,65"
04/07/2024,43090,,,Terminal SE - Transferencia TPV,0,3035136,"-41034757,65"
04/07/2024,43642,,14561,Terminal SE - Transferencia TPV,65000,0,"-40969757,65"
04/07/2024,43650,,14587,Terminal SE - Transferencia TPV,53000,0,"-40916757,65"
04/07/2024,43632,,14538,Terminal SE - Transferencia TPV,180000,0,"-40736757,65"
04/07/2024,43623,,14515,Terminal SE - Transferencia TPV,59000,0,"-40677757,65"
04/07/2024,43633,,14539,Terminal SE - Transferencia TPV,8000,0,"-40669757,65"
04/07/2024,43641,,14560,Terminal SE - Transferencia TPV,63000,0,"-40606757,65"
04/07/2024,43622,,14511,Terminal SE - Transferencia TPV,160010,0,"-40446747,65"
04/07/2024,43636,,14544,Terminal SE - Transferencia TPV,63000,0,"-40383747,65"
04/07/2024,43648,,14585,Terminal SE - Transferencia TPV,63500,0,"-40320247,65"
04/07/2024,43625,,14520,Terminal SE - Transferencia TPV,87407,0,"-40232840,65"
04/07/2024,43640,,14558,Terminal SE - Transferencia TPV,"222397,01",0,"-40010443,64"
04/07/2024,43630,,14536,Terminal SE - Transferencia TPV,"124118,99",0,"-39886324,65"
04/07/2024,43634,,14540,Terminal SE - Transferencia TPV,"205399,99",0,"-39680924,66"
04/07/2024,43631,,14537,Terminal SE - Transferencia TPV,"693999,98",0,"-38986924,68"
04/07/2024,43651,,14588,Terminal SE - Transferencia TPV,63000,0,"-38923924,68"
04/07/2024,43646,,14579,Terminal SE - Transferencia TPV,100464,0,"-38823460,68"
04/07/2024,43643,,14570,Terminal SE - Transferencia TPV,91778,0,"-38731682,68"
04/07/2024,43637,,14546,Terminal SE - Transferencia TPV,99918,0,"-38631764,68"
04/07/2024,43639,,14557,Terminal SE - Transferencia TPV,77574,0,"-38554190,68"
04/07/2024,43645,,14576,Terminal SE - Transferencia TPV,87954,0,"-38466236,68"
04/07/2024,43621,,14509,Terminal SE - Transferencia TPV,89538,0,"-38376698,68"
04/07/2024,43635,,14543,Terminal SE - Transferencia TPV,"127999,99",0,"-38248698,69"
04/07/2024,43647,,14584,Terminal SE - Transferencia TPV,"85999,99",0,"-38162698,7"
04/07/2024,43627,,14522,Terminal SE - Transferencia TPV,100000,0,"-38062698,7"
04/07/2024,43629,,14534,Terminal SE - Transferencia TPV,83256,0,"-38211642,7"
04/07/2024,43649,,14586,Terminal SE - Transferencia TPV,"90599,99",0,"-38121042,71"
04/08/2024,43653,,,Terminal SE - Transferencia TPV,0,4077512,"-42198554,71"
04/11/2024,43917,,14616,Terminal SE - Transferencia TPV,62000,0,"-47285748,62"
04/11/2024,43914,,14611,Terminal SE - Transferencia TPV,6000,0,"-47279748,62"
04/11/2024,43915,,14613,Terminal SE - Transferencia TPV,66000,0,"-47213748,62"
04/11/2024,43916,,14614,Terminal SE - Transferencia TPV,163000,0,"-47050748,62"
04/11/2024,43918,,14617,Terminal SE - Transferencia TPV,"70000,01",0,"-46980748,61"
04/11/2024,43919,,14621,Terminal SE - Transferencia TPV,104500,0,"-46876248,61"
04/11/2024,43920,,14623,Terminal SE - Transferencia TPV,8570,0,"-46867678,61"
04/11/2024,43921,,14624,Terminal SE - Transferencia TPV,117618,0,"-46750060,61"
04/11/2024,43922,,14637,Terminal SE - Transferencia TPV,"113738,99",0,"-46636321,62"
04/11/2024,43923,,14639,Terminal SE - Transferencia TPV,"87297,99",0,"-46549023,63"
04/11/2024,43924,,14640,Terminal SE - Transferencia TPV,13000,0,"-46536023,63"
04/11/2024,43925,,14644,Terminal SE - Transferencia TPV,92000,0,"-46444023,63"
04/12/2024,44265,,14667,Terminal SE - Transferencia TPV,"62499,99",0,"-46381523,64"
04/12/2024,44267,,14674,Terminal SE - Transferencia TPV,"88300,01",0,"-46511150,77"
04/12/2024,44268,,14675,Terminal SE - Transferencia TPV,"58000,01",0,"-46453150,76"
04/12/2024,44269,,14679,Terminal SE - Transferencia TPV,111000,0,"-46342150,76"
04/12/2024,43926,,,Terminal SE - Transferencia TPV,0,903654,"-47353804,76"
04/12/2024,44283,,14711,Terminal SE - Transferencia TPV,74500,0,"-47279304,76"
04/12/2024,44270,,14682,Terminal SE - Transferencia TPV,182518,0,"-47096786,76"
04/12/2024,44271,,14684,Terminal SE - Transferencia TPV,116000,0,"-46980786,76"
04/12/2024,44279,,14708,Terminal SE - Transferencia TPV,"149999,99",0,"-46830786,77"
04/12/2024,44274,,14694,Terminal SE - Transferencia TPV,"68342,99",0,"-46762443,78"
04/12/2024,44273,,14687,Terminal SE - Transferencia TPV,118273,0,"-46644170,78"
04/12/2024,44272,,14685,Terminal SE - Transferencia TPV,75700,0,"-46568470,78"
04/12/2024,44278,,14705,Terminal SE - Transferencia TPV,228623,0,"-46339847,78"
04/12/2024,44280,,14711,Terminal SE - Transferencia TPV,149000,0,"-46190847,78"
04/12/2024,44281,,14711,Terminal SE - Transferencia TPV,75000,0,"-46115847,78"
04/12/2024,44282,,14711,Terminal SE - Transferencia TPV,74500,0,"-46138347,78"
04/12/2024,44266,,14671,Terminal SE - Transferencia TPV,"76100,01",0,"-46062247,77"
04/12/2024,44261,,14660,Terminal SE - Transferencia TPV,90139,0,"-45972108,77"
04/12/2024,44277,,14702,Terminal SE - Transferencia TPV,"192599,99",0,"-45779508,78"
04/12/2024,44262,,14661,Terminal SE - Transferencia TPV,"63499,99",0,"-45716008,79"
04/12/2024,44263,,14662,Terminal SE - Transferencia TPV,154700,0,"-45561308,79"
04/12/2024,44264,,14666,Terminal SE - Transferencia TPV,68000,0,"-45493308,79"
04/12/2024,44276,,14699,Terminal SE - Transferencia TPV,88281,0,"-45405027,79"
04/12/2024,44275,,14696,Terminal SE - Transferencia TPV,"130750,01",0,"-45274277,78"
04/13/2024,44777,,14744,Terminal SE - Transferencia TPV,111000,0,"-45934819,26"
04/13/2024,44780,,14752,Terminal SE - Transferencia TPV,"225000,01",0,"-45709819,25"
04/13/2024,44789,,14771,Terminal SE - Transferencia TPV,120000,0,"-45589819,25"
04/13/2024,44791,,14774,Terminal SE - Transferencia TPV,"153071,99",0,"-45436747,26"
04/13/2024,44802,,14810,Terminal SE - Transferencia TPV,"125647,99",0,"-45311099,27"
04/13/2024,44795,,14781,Terminal SE - Transferencia TPV,81944,0,"-45229155,27"
04/13/2024,44794,,14779,Terminal SE - Transferencia TPV,114285,0,"-45114870,27"
04/13/2024,44793,,14778,Terminal SE - Transferencia TPV,"53000,01",0,"-45061870,26"
04/13/2024,44787,,14768,Terminal SE - Transferencia TPV,"383937,01",0,"-44677933,25"
04/13/2024,44790,,14773,Terminal SE - Transferencia TPV,79500,0,"-44598433,25"
04/13/2024,44778,,14745,Terminal SE - Transferencia TPV,"72500,01",0,"-44525933,24"
04/13/2024,44798,,14798,Terminal SE - Transferencia TPV,108212,0,"-44417721,24"
04/13/2024,44797,,14787,Terminal SE - Transferencia TPV,"180987,99",0,"-44236733,25"
04/13/2024,44804,,14813,Terminal SE - Transferencia TPV,"116500,01",0,"-44120233,24"
04/13/2024,44779,,14750,Terminal SE - Transferencia TPV,67000,0,"-44053233,24"
04/13/2024,44781,,14753,Terminal SE - Transferencia TPV,"129581,01",0,"-43923652,23"
04/13/2024,44776,,14742,Terminal SE - Transferencia TPV,152089,0,"-43771563,23"
04/13/2024,44788,,14770,Terminal SE - Transferencia TPV,"122250,01",0,"-43649313,22"
04/13/2024,44799,,14802,Terminal SE - Transferencia TPV,"79977,99",0,"-43569335,23"
04/13/2024,44775,,14736,Terminal SE - Transferencia TPV,378310,0,"-43191025,23"
04/13/2024,44785,,14764,Terminal SE - Transferencia TPV,73531,0,"-43117494,23"
04/13/2024,44801,,14807,Terminal SE - Transferencia TPV,93963,0,"-43023531,23"
04/13/2024,44774,,14733,Terminal SE - Transferencia TPV,66000,0,"-42957531,23"
04/13/2024,44800,,14806,Terminal SE - Transferencia TPV,"204150,99",0,"-42753380,24"
04/13/2024,44786,,14765,Terminal SE - Transferencia TPV,161704,0,"-42591676,24"
04/13/2024,44792,,14776,Terminal SE - Transferencia TPV,55500,0,"-42536176,24"
04/13/2024,44782,,14755,Terminal SE - Transferencia TPV,107000,0,"-44114176,24"
04/13/2024,44784,,14760,Terminal SE - Transferencia TPV,96203,0,"-44017973,24"
04/13/2024,44803,,14812,Terminal SE - Transferencia TPV,"80000,01",0,"-45941980,23"
04/13/2024,44796,,14782,Terminal SE - Transferencia TPV,55250,0,"-45886730,23"
04/13/2024,44284,,,Terminal SE - Transferencia TPV,0,2496326,"-48383056,23"
04/13/2024,44783,,14759,Terminal SE - Transferencia TPV,87626,0,"-49195430,23"
04/14/2024,45434,,14868,Terminal SE - Transferencia TPV,"184210,99",0,"-49011219,24"
04/14/2024,45432,,14860,Terminal SE - Transferencia TPV,159000,0,"-48852219,24"
04/14/2024,45420,,14844,Terminal SE - Transferencia TPV,"264999,98",0,"-48587219,26"
04/14/2024,45433,,14865,Terminal SE - Transferencia TPV,"116579,99",0,"-48470639,27"
04/14/2024,45418,,14839,Terminal SE - Transferencia TPV,80852,0,"-48389787,27"
04/14/2024,45444,,14891,Terminal SE - Transferencia TPV,74500,0,"-48315287,27"
04/14/2024,45438,,14875,Terminal SE - Transferencia TPV,82491,0,"-48232796,27"
04/14/2024,45429,,14856,Terminal SE - Transferencia TPV,"95328,99",0,"-48137467,28"
04/14/2024,45423,,14850,Terminal SE - Transferencia TPV,138400,0,"-47999067,28"
04/14/2024,45416,,14834,Terminal SE - Transferencia TPV,"179999,99",0,"-47819067,29"
04/14/2024,45455,,14911,Terminal SE - Transferencia TPV,75935,0,"-47743132,29"
04/14/2024,45430,,14857,Terminal SE - Transferencia TPV,"551214,98",0,"-47191917,31"
04/14/2024,45428,,14855,Terminal SE - Transferencia TPV,6337,0,"-47185580,31"
04/14/2024,45440,,14877,Terminal SE - Transferencia TPV,"89046,01",0,"-47096534,3"
04/14/2024,45446,,14895,Terminal SE - Transferencia TPV,52000,0,"-47044534,3"
04/14/2024,45436,,14870,Terminal SE - Transferencia TPV,105763,0,"-46938771,3"
04/14/2024,45424,,14851,Terminal SE - Transferencia TPV,320000,0,"-46618771,3"
04/14/2024,44805,,,Terminal SE - Transferencia TPV,0,3935749,"-50554520,3"
04/14/2024,45445,,14893,Terminal SE - Transferencia TPV,"120999,99",0,"-50433520,31"
04/14/2024,45448,,14897,Terminal SE - Transferencia TPV,96148,0,"-50337372,31"
04/14/2024,45419,,14840,Terminal SE - Transferencia TPV,122917,0,"-50214455,31"
04/14/2024,45421,,14848,Terminal SE - Transferencia TPV,"91999,99",0,"-50122455,32"
04/14/2024,45431,,14859,Terminal SE - Transferencia TPV,40150,0,"-50082305,32"
04/14/2024,45450,,14899,Terminal SE - Transferencia TPV,"121714,99",0,"-49960590,33"
04/14/2024,45451,,14900,Terminal SE - Transferencia TPV,178000,0,"-49782590,33"
04/14/2024,45435,,14869,Terminal SE - Transferencia TPV,66850,0,"-49715740,33"
04/14/2024,45453,,14903,Terminal SE - Transferencia TPV,"68499,99",0,"-49647240,34"
04/14/2024,45427,,14854,Terminal SE - Transferencia TPV,"132000,01",0,"-49515240,33"
04/14/2024,45447,,14896,Terminal SE - Transferencia TPV,"84999,99",0,"-49430240,34"
04/14/2024,45441,,14887,Terminal SE - Transferencia TPV,85950,0,"-49344290,34"
04/14/2024,45425,,14852,Terminal SE - Transferencia TPV,123000,0,"-49221290,34"
04/14/2024,45442,,14889,Terminal SE - Transferencia TPV,"233000,01",0,"-48988290,33"
04/14/2024,45443,,14890,Terminal SE - Transferencia TPV,61300,0,"-48926990,33"
04/14/2024,45437,,14871,Terminal SE - Transferencia TPV,83583,0,"-48843407,33"
04/14/2024,45439,,14876,Terminal SE - Transferencia TPV,"355092,98",0,"-48488314,35"
04/14/2024,45426,,14853,Terminal SE - Transferencia TPV,"216332,99",0,"-48271981,36"
04/14/2024,45417,,14838,Terminal SE - Transferencia TPV,201529,0,"-48070452,36"
04/14/2024,45454,,14910,Terminal SE - Transferencia TPV,"93416,99",0,"-47977035,37"
04/14/2024,45414,,14824,Terminal SE - Transferencia TPV,139087,0,"-47837948,37"
04/14/2024,45452,,14902,Terminal SE - Transferencia TPV,101884,0,"-47736064,37"
04/14/2024,45415,,14826,Terminal SE - Transferencia TPV,146950,0,"-47589114,37"
04/14/2024,45449,,14898,Terminal SE - Transferencia TPV,"145999,99",0,"-47443114,38"
04/14/2024,45422,,14849,Terminal SE - Transferencia TPV,250149,0,"-47192965,38"
04/15/2024,45456,,,Terminal SE - Transferencia TPV,0,5938208,"-53131173,38"
04/17/2024,45660,,14954,Terminal SE - Transferencia TPV,92870,0,"-65258948,18"
04/17/2024,45656,,14926,Terminal SE - Transferencia TPV,80000,0,"-68899180,76"
04/17/2024,45657,,14944,Terminal SE - Transferencia TPV,8000,0,"-70362190,76"
04/17/2024,45658,,14952,Terminal SE - Transferencia TPV,"34999,99",0,"-70327190,77"
04/17/2024,45659,,14953,Terminal SE - Transferencia TPV,"182899,98",0,"-70144290,79"
04/18/2024,45764,,14980,Terminal SE - Transferencia TPV,"118999,99",0,"-70025290,8"
04/18/2024,45763,,14975,Terminal SE - Transferencia TPV,100737,0,"-69998554,32"
04/18/2024,45753,,14956,Terminal SE - Transferencia TPV,63000,0,"-70274354,15"
04/18/2024,45762,,14972,Terminal SE - Transferencia TPV,96400,0,"-70177954,15"
04/18/2024,45752,,14955,Terminal SE - Transferencia TPV,63000,0,"-70114954,15"
04/18/2024,45760,,14969,Terminal SE - Transferencia TPV,"76500,01",0,"-70038454,14"
04/18/2024,45759,,14968,Terminal SE - Transferencia TPV,"68499,99",0,"-69969954,15"
04/18/2024,45758,,14966,Terminal SE - Transferencia TPV,"74077,99",0,"-69895876,16"
04/18/2024,45761,,14970,Terminal SE - Transferencia TPV,"95139,01",0,"-69993150,63"
04/18/2024,45756,,14960,Terminal SE - Transferencia TPV,"187925,99",0,"-69805224,64"
04/18/2024,45757,,14965,Terminal SE - Transferencia TPV,62500,0,"-69742724,64"
04/18/2024,45661,,,Terminal SE - Transferencia TPV,0,398770,"-70141494,64"
04/18/2024,45754,,14957,Terminal SE - Transferencia TPV,167600,0,"-69973894,64"
04/18/2024,45755,,14959,Terminal SE - Transferencia TPV,"127999,99",0,"-69845894,65"
04/19/2024,46009,,15020,Terminal SE - Transferencia TPV,"91340,99",0,"-70410453,65"
04/19/2024,46008,,15017,Terminal SE - Transferencia TPV,"166019,01",0,"-70244434,64"
04/19/2024,46007,,15016,Terminal SE - Transferencia TPV,114300,0,"-70130134,64"
04/19/2024,45996,,14985,Terminal SE - Transferencia TPV,"69500,01",0,"-73332150,6"
04/19/2024,45997,,14986,Terminal SE - Transferencia TPV,110352,0,"-73221798,6"
04/19/2024,45998,,14993,Terminal SE - Transferencia TPV,77410,0,"-73144388,6"
04/19/2024,45999,,14994,Terminal SE - Transferencia TPV,"61500,01",0,"-73082888,59"
04/19/2024,46000,,14997,Terminal SE - Transferencia TPV,"76199,99",0,"-73006688,6"
04/19/2024,46001,,14998,Terminal SE - Transferencia TPV,"66500,01",0,"-72940188,59"
04/19/2024,46002,,14999,Terminal SE - Transferencia TPV,65000,0,"-72875188,59"
04/19/2024,46003,,15006,Terminal SE - Transferencia TPV,"117000,01",0,"-72758188,58"
04/19/2024,46004,,15007,Terminal SE - Transferencia TPV,"166000,01",0,"-72592188,57"
04/19/2024,46005,,15008,Terminal SE - Transferencia TPV,"83801,99",0,"-72508386,58"
04/19/2024,46006,,15013,Terminal SE - Transferencia TPV,"169999,99",0,"-72338386,59"
04/19/2024,45765,,,Terminal SE - Transferencia TPV,0,1302402,"-73862632,59"
04/19/2024,46010,,15029,Terminal SE - Transferencia TPV,163124,0,"-76427022,73"
04/19/2024,46011,,15033,Terminal SE - Transferencia TPV,"192089,02",0,"-76234933,71"
04/19/2024,46012,,15034,Terminal SE - Transferencia TPV,"131875,99",0,"-76103057,72"
04/20/2024,46508,,15089,Terminal SE - Transferencia TPV,101283,0,"-79516980,72"
04/20/2024,46515,,15110,Terminal SE - Transferencia TPV,146000,0,"-79370980,72"
04/20/2024,46503,,15079,Terminal SE - Transferencia TPV,"92869,99",0,"-79278110,73"
04/20/2024,46495,,15051,Terminal SE - Transferencia TPV,104124,0,"-79173986,73"
04/20/2024,46501,,15068,Terminal SE - Transferencia TPV,66000,0,"-79107986,73"
04/20/2024,46499,,15060,Terminal SE - Transferencia TPV,"107715,01",0,"-79000271,72"
04/20/2024,46514,,15109,Terminal SE - Transferencia TPV,57000,0,"-78943271,72"
04/20/2024,46509,,15094,Terminal SE - Transferencia TPV,"121499,99",0,"-78821771,73"
04/20/2024,46521,,15129,Terminal SE - Transferencia TPV,89920,0,"-78731851,73"
04/20/2024,46513,,15108,Terminal SE - Transferencia TPV,159355,0,"-78572496,73"
04/20/2024,46510,,15095,Terminal SE - Transferencia TPV,"361249,99",0,"-78211246,74"
04/20/2024,46516,,15111,Terminal SE - Transferencia TPV,119311,0,"-78091935,74"
04/20/2024,46517,,15112,Terminal SE - Transferencia TPV,170226,0,"-77921709,74"
04/20/2024,46518,,15118,Terminal SE - Transferencia TPV,89593,0,"-77832116,74"
04/20/2024,46506,,15085,Terminal SE - Transferencia TPV,61000,0,"-77771116,74"
04/20/2024,46496,,15052,Terminal SE - Transferencia TPV,153000,0,"-77618116,74"
04/20/2024,46507,,15088,Terminal SE - Transferencia TPV,8550,0,"-77609566,74"
04/20/2024,46505,,15084,Terminal SE - Transferencia TPV,"68000,01",0,"-77541566,73"
04/20/2024,46504,,15083,Terminal SE - Transferencia TPV,68000,0,"-77473566,73"
04/20/2024,46500,,15062,Terminal SE - Transferencia TPV,85000,0,"-77388566,73"
04/20/2024,46497,,15052,Terminal SE - Transferencia TPV,"7000,01",0,"-77381566,72"
04/20/2024,46502,,15069,Terminal SE - Transferencia TPV,"142364,99",0,"-77239201,73"
04/20/2024,46498,,15059,Terminal SE - Transferencia TPV,81895,0,"-77157306,73"
04/20/2024,46524,,15135,Terminal SE - Transferencia TPV,76000,0,"-77081306,73"
04/20/2024,46523,,15135,Terminal SE - Transferencia TPV,100000,0,"-76981306,73"
04/20/2024,46013,,,Terminal SE - Transferencia TPV,0,1922090,"-78903396,73"
04/20/2024,46512,,15099,Terminal SE - Transferencia TPV,68300,0,"-78835096,73"
04/20/2024,46522,,15135,Terminal SE - Transferencia TPV,76900,0,"-78758196,73"
04/20/2024,46520,,15128,Terminal SE - Transferencia TPV,131712,0,"-78626484,73"
04/20/2024,46519,,15119,Terminal SE - Transferencia TPV,25500,0,"-78600984,73"
04/20/2024,46511,,15098,Terminal SE - Transferencia TPV,68000,0,"-78532984,73"
04/21/2024,47035,,15152,Terminal SE - Transferencia TPV,52000,0,"-78480984,73"
04/21/2024,47048,,15189,Terminal SE - Transferencia TPV,65250,0,"-78415734,73"
04/21/2024,47049,,15190,Terminal SE - Transferencia TPV,159000,0,"-78256734,73"
04/21/2024,47050,,15193,Terminal SE - Transferencia TPV,"326357,01",0,"-77930377,72"
04/21/2024,47051,,15195,Terminal SE - Transferencia TPV,65500,0,"-77864877,72"
04/21/2024,47052,,15196,Terminal SE - Transferencia TPV,125000,0,"-77739877,72"
04/21/2024,47053,,15197,Terminal SE - Transferencia TPV,66000,0,"-77673877,72"
04/21/2024,47054,,15203,Terminal SE - Transferencia TPV,70000,0,"-77603877,72"
04/21/2024,47046,,15184,Terminal SE - Transferencia TPV,175000,0,"-77428877,72"
04/21/2024,47047,,15187,Terminal SE - Transferencia TPV,150100,0,"-77278777,72"
04/21/2024,47040,,15165,Terminal SE - Transferencia TPV,287297,0,"-76991480,72"
04/21/2024,47041,,15167,Terminal SE - Transferencia TPV,"79540,99",0,"-76911939,73"
04/21/2024,47042,,15168,Terminal SE - Transferencia TPV,"1106741,98",0,"-75805197,75"
04/21/2024,47043,,15169,Terminal SE - Transferencia TPV,"248999,98",0,"-75556197,77"
04/21/2024,47044,,15180,Terminal SE - Transferencia TPV,127014,0,"-75429183,77"
04/21/2024,47045,,15183,Terminal SE - Transferencia TPV,"99753,99",0,"-75329429,78"
04/21/2024,47055,,15205,Terminal SE - Transferencia TPV,76263,0,"-75253166,78"
04/21/2024,47056,,15206,Terminal SE - Transferencia TPV,"141403,52",0,"-75111763,26"
04/21/2024,47057,,15218,Terminal SE - Transferencia TPV,"160064,99",0,"-74951698,27"
04/21/2024,47039,,15163,Terminal SE - Transferencia TPV,158700,0,"-74792998,27"
04/21/2024,47038,,15161,Terminal SE - Transferencia TPV,"126959,01",0,"-74666039,26"
04/21/2024,47037,,15159,Terminal SE - Transferencia TPV,98880,0,"-74567159,26"
04/21/2024,47036,,15157,Terminal SE - Transferencia TPV,146025,0,"-74421134,26"
04/21/2024,47034,,15151,Terminal SE - Transferencia TPV,161000,0,"-74260134,26"
04/21/2024,47033,,15147,Terminal SE - Transferencia TPV,"86642,99",0,"-74173491,27"
04/21/2024,47032,,15145,Terminal SE - Transferencia TPV,244194,0,"-73929297,27"
04/21/2024,46526,,,Terminal SE - Transferencia TPV,"9993,98",0,"-74019303,29"
04/21/2024,46525,,,Terminal SE - Transferencia TPV,0,3017286,"-77036589,29"
04/22/2024,47058,,,Terminal SE - Transferencia TPV,0,4603660,"-81640249,29"
04/24/2024,47286,,15252,Terminal SE - Transferencia TPV,138978,0,"-83431521,35"
04/24/2024,47279,,15239,Terminal SE - Transferencia TPV,"301336,99",0,"-83130184,36"
04/24/2024,47278,,15238,Terminal SE - Transferencia TPV,85000,0,"-83045184,36"
04/24/2024,47285,,15251,Terminal SE - Transferencia TPV,67194,0,"-82977990,36"
04/24/2024,47281,,15243,Terminal SE - Transferencia TPV,137500,0,"-82840490,36"
04/24/2024,47287,,15253,Terminal SE - Transferencia TPV,67000,0,"-82773490,36"
04/24/2024,47280,,15242,Terminal SE - Transferencia TPV,111000,0,"-83501870,49"
04/24/2024,47283,,15247,Terminal SE - Transferencia TPV,69000,0,"-83432870,49"
04/24/2024,47289,,15256,Terminal SE - Transferencia TPV,99000,0,"-83333870,49"
04/24/2024,47288,,15255,Terminal SE - Transferencia TPV,76000,0,"-83257870,49"
04/24/2024,47282,,15246,Terminal SE - Transferencia TPV,94250,0,"-83553420,63"
04/24/2024,47284,,15248,Terminal SE - Transferencia TPV,"98000,01",0,"-83993652,62"
04/25/2024,47420,,15265,Terminal SE - Transferencia TPV,63000,0,"-83930652,62"
04/25/2024,47419,,15264,Terminal SE - Transferencia TPV,56000,0,"-84157652,62"
04/25/2024,47418,,15263,Terminal SE - Transferencia TPV,149000,0,"-84093652,62"
04/25/2024,47422,,15283,Terminal SE - Transferencia TPV,50000,0,"-84043652,62"
04/25/2024,47421,,15276,Terminal SE - Transferencia TPV,"171645,99",0,"-84249156,61"
04/25/2024,47290,,,Terminal SE - Transferencia TPV,0,1344258,"-85593414,61"
04/26/2024,47760,,15349,Terminal SE - Transferencia TPV,101023,0,"-85492391,61"
04/26/2024,47749,,15302,Terminal SE - Transferencia TPV,100000,0,"-85392391,61"
04/26/2024,47752,,15306,Terminal SE - Transferencia TPV,113500,0,"-85278891,61"
04/26/2024,47761,,15351,Terminal SE - Transferencia TPV,90400,0,"-85188491,61"
04/26/2024,47758,,15344,Terminal SE - Transferencia TPV,"347173,01",0,"-84841318,6"
04/26/2024,47757,,15336,Terminal SE - Transferencia TPV,103796,0,"-84737522,6"
04/26/2024,47756,,15328,Terminal SE - Transferencia TPV,"142853,01",0,"-84594669,59"
04/26/2024,47423,,,Terminal SE - Transferencia TPV,0,489645,"-85084314,59"
04/26/2024,47755,,15312,Terminal SE - Transferencia TPV,53000,0,"-85031314,59"
04/26/2024,47754,,15311,Terminal SE - Transferencia TPV,64800,0,"-84966514,59"
04/26/2024,47753,,15308,Terminal SE - Transferencia TPV,140000,0,"-84826514,59"
04/26/2024,47751,,15304,Terminal SE - Transferencia TPV,61000,0,"-84765514,59"
04/26/2024,47748,,15301,Terminal SE - Transferencia TPV,69000,0,"-84696514,59"
04/26/2024,47747,,15298,Terminal SE - Transferencia TPV,61000,0,"-84635514,59"
04/26/2024,47746,,15297,Terminal SE - Transferencia TPV,"370607,02",0,"-84264907,57"
04/26/2024,47750,,15302,Terminal SE - Transferencia TPV,"175769,99",0,"-84789137,58"
04/26/2024,47759,,15349,Terminal SE - Transferencia TPV,150000,0,"-84639137,58"
04/27/2024,48270,,15392,Terminal SE - Transferencia TPV,90000,0,"-84549137,58"
04/27/2024,48259,,15368,Terminal SE - Transferencia TPV,318381,0,"-84230756,58"
04/27/2024,48268,,15385,Terminal SE - Transferencia TPV,"786993,96",0,"-83443762,62"
04/27/2024,48279,,15414,Terminal SE - Transferencia TPV,114000,0,"-83329762,62"
04/27/2024,48265,,15378,Terminal SE - Transferencia TPV,"89499,99",0,"-83240262,63"
04/27/2024,48266,,15382,Terminal SE - Transferencia TPV,"254472,01",0,"-82985790,62"
04/27/2024,48274,,15401,Terminal SE - Transferencia TPV,81507,0,"-82904283,62"
04/27/2024,48261,,15370,Terminal SE - Transferencia TPV,111000,0,"-83191033,62"
04/27/2024,48260,,15369,Terminal SE - Transferencia TPV,"274951,01",0,"-82916082,61"
04/27/2024,48272,,15395,Terminal SE - Transferencia TPV,"79000,01",0,"-83707448,6"
04/27/2024,48283,,15427,Terminal SE - Transferencia TPV,98770,0,"-83608678,6"
04/27/2024,48267,,15383,Terminal SE - Transferencia TPV,"151499,99",0,"-83457178,61"
04/27/2024,48275,,15402,Terminal SE - Transferencia TPV,"127000,01",0,"-83330178,6"
04/27/2024,47762,,,Terminal SE - Transferencia TPV,0,2143922,"-85474100,6"
04/27/2024,48281,,15416,Terminal SE - Transferencia TPV,180400,0,"-85293700,6"
04/27/2024,48286,,15444,Terminal SE - Transferencia TPV,150000,0,"-85143700,6"
04/27/2024,48282,,15418,Terminal SE - Transferencia TPV,"95492,99",0,"-85048207,61"
04/27/2024,48277,,15408,Terminal SE - Transferencia TPV,158153,0,"-84890054,61"
04/27/2024,48263,,15376,Terminal SE - Transferencia TPV,71000,0,"-84819054,61"
04/27/2024,48273,,15400,Terminal SE - Transferencia TPV,184867,0,"-84984187,61"
04/27/2024,48284,,15432,Terminal SE - Transferencia TPV,"184756,98",0,"-84799430,63"
04/27/2024,48257,,15362,Terminal SE - Transferencia TPV,94000,0,"-84705430,63"
04/27/2024,48276,,15407,Terminal SE - Transferencia TPV,65500,0,"-84639930,63"
04/27/2024,48280,,15415,Terminal SE - Transferencia TPV,"153836,99",0,"-84486093,64"
04/27/2024,48264,,15377,Terminal SE - Transferencia TPV,"139032,01",0,"-84347061,63"
04/27/2024,48262,,15372,Terminal SE - Transferencia TPV,71500,0,"-84275561,63"
04/27/2024,48269,,15389,Terminal SE - Transferencia TPV,"99425,99",0,"-84176135,64"
04/27/2024,48258,,15365,Terminal SE - Transferencia TPV,110352,0,"-84065783,64"
04/27/2024,48256,,15361,Terminal SE - Transferencia TPV,39497,0,"-84026286,64"
04/27/2024,48255,,15361,Terminal SE - Transferencia TPV,39497,0,"-83986789,64"
04/27/2024,48285,,15435,Terminal SE - Transferencia TPV,"110569,99",0,"-83876219,65"
04/27/2024,48278,,15411,Terminal SE - Transferencia TPV,214500,0,"-83661719,65"
04/27/2024,48271,,15393,Terminal SE - Transferencia TPV,12000,0,"-83649719,65"
04/28/2024,48710,,15505,Terminal SE - Transferencia TPV,68500,0,"-83581219,65"
04/28/2024,48695,,15461,Terminal SE - Transferencia TPV,"78499,99",0,"-83502719,66"
04/28/2024,48694,,15459,Terminal SE - Transferencia TPV,"184000,01",0,"-83318719,65"
04/28/2024,48693,,15455,Terminal SE - Transferencia TPV,62500,0,"-83256219,65"
04/28/2024,48692,,15454,Terminal SE - Transferencia TPV,79000,0,"-83177219,65"
04/28/2024,48689,,15448,Terminal SE - Transferencia TPV,"170000,01",0,"-83007219,64"
04/28/2024,48699,,15471,Terminal SE - Transferencia TPV,97732,0,"-82909487,64"
04/28/2024,48703,,15487,Terminal SE - Transferencia TPV,81000,0,"-82828487,64"
04/28/2024,48704,,15488,Terminal SE - Transferencia TPV,131000,0,"-82697487,64"
04/28/2024,48705,,15489,Terminal SE - Transferencia TPV,75000,0,"-82622487,64"
04/28/2024,48706,,15493,Terminal SE - Transferencia TPV,126500,0,"-82495987,64"
04/28/2024,48707,,15496,Terminal SE - Transferencia TPV,"61500,01",0,"-82434487,63"
04/28/2024,48708,,15497,Terminal SE - Transferencia TPV,68500,0,"-82365987,63"
04/28/2024,48709,,15500,Terminal SE - Transferencia TPV,"64500,01",0,"-82301487,62"
04/28/2024,48696,,15467,Terminal SE - Transferencia TPV,122000,0,"-82179487,62"
04/28/2024,48698,,15469,Terminal SE - Transferencia TPV,128100,0,"-82051387,62"
04/28/2024,48711,,15519,Terminal SE - Transferencia TPV,165750,0,"-81885637,62"
04/28/2024,48691,,15453,Terminal SE - Transferencia TPV,"78000,01",0,"-81807637,61"
04/28/2024,48690,,15451,Terminal SE - Transferencia TPV,212236,0,"-81595401,61"
04/28/2024,48701,,15485,Terminal SE - Transferencia TPV,73204,0,"-81522197,61"
04/28/2024,48287,,,Terminal SE - Transferencia TPV,0,4991751,"-86513948,61"
04/28/2024,48288,,,Terminal SE - Transferencia TPV,"240295,04",0,"-86273653,57"
04/28/2024,48697,,15468,Terminal SE - Transferencia TPV,63000,0,"-86210653,57"
04/28/2024,48700,,15478,Terminal SE - Transferencia TPV,161649,0,"-86049004,57"
04/28/2024,48702,,15486,Terminal SE - Transferencia TPV,69000,0,"-85980004,57"
04/29/2024,48712,,,Terminal SE - Transferencia TPV,0,2421171,"-88401175,57"
05/01/2024,49277,,15555,Terminal SE - Transferencia TPV,94265,0,"-92298599,13"
05/01/2024,49274,,15552,Terminal SE - Transferencia TPV,13000,0,"-92285599,13"
05/01/2024,49276,,15554,Terminal SE - Transferencia TPV,150778,0,"-92134821,13"
05/01/2024,49309,,15605,Terminal SE - Transferencia TPV,65600,0,"-92069221,13"
05/01/2024,49286,,15566,Terminal SE - Transferencia TPV,97596,0,"-91971625,13"
05/01/2024,49303,,15589,Terminal SE - Transferencia TPV,81781,0,"-91889844,13"
05/01/2024,49298,,15581,Terminal SE - Transferencia TPV,"477243,98",0,"-91412600,15"
05/01/2024,49311,,15611,Terminal SE - Transferencia TPV,253150,0,"-92102288,15"
05/01/2024,49296,,15576,Terminal SE - Transferencia TPV,170390,0,"-91931898,15"
05/01/2024,49287,,15568,Terminal SE - Transferencia TPV,"323843,99",0,"-91608054,16"
05/01/2024,49307,,15600,Terminal SE - Transferencia TPV,"105599,99",0,"-91502454,17"
05/01/2024,49282,,15559,Terminal SE - Transferencia TPV,"91777,99",0,"-91410676,18"
05/01/2024,49283,,15561,Terminal SE - Transferencia TPV,"306308,01",0,"-91104368,17"
05/01/2024,49285,,15565,Terminal SE - Transferencia TPV,"98879,99",0,"-91005488,18"
05/01/2024,49310,,15609,Terminal SE - Transferencia TPV,"97000,01",0,"-90908488,17"
05/01/2024,49288,,15569,Terminal SE - Transferencia TPV,100700,0,"-90807788,17"
05/01/2024,49301,,15584,Terminal SE - Transferencia TPV,105326,0,"-90702462,17"
05/01/2024,49273,,15551,Terminal SE - Transferencia TPV,172302,0,"-90530160,17"
05/01/2024,49272,,15550,Terminal SE - Transferencia TPV,"118765,01",0,"-90411395,16"
05/01/2024,49284,,15562,Terminal SE - Transferencia TPV,45600,0,"-90365795,16"
05/01/2024,49300,,15583,Terminal SE - Transferencia TPV,10000,0,"-90355795,16"
05/01/2024,49299,,15583,Terminal SE - Transferencia TPV,20000,0,"-90335795,16"
05/01/2024,49293,,15570,Terminal SE - Transferencia TPV,92700,0,"-90243095,16"
05/01/2024,49292,,15570,Terminal SE - Transferencia TPV,82700,0,"-90160395,16"
05/01/2024,49291,,15570,Terminal SE - Transferencia TPV,76300,0,"-90084095,16"
05/01/2024,49290,,15570,Terminal SE - Transferencia TPV,78000,0,"-90006095,16"
05/01/2024,49289,,15570,Terminal SE - Transferencia TPV,73700,0,"-93296254,16"
05/01/2024,49281,,15557,Terminal SE - Transferencia TPV,112000,0,"-93184254,16"
05/01/2024,49280,,15557,Terminal SE - Transferencia TPV,55550,0,"-93128704,16"
05/01/2024,49278,,15557,Terminal SE - Transferencia TPV,55550,0,"-93073154,16"
05/01/2024,49270,,15548,Terminal SE - Transferencia TPV,"221030,99",0,"-92852123,17"
05/01/2024,49294,,15570,Terminal SE - Transferencia TPV,"78200,99",0,"-92773922,18"
05/01/2024,49295,,15575,Terminal SE - Transferencia TPV,"185030,99",0,"-95608170,19"
05/01/2024,49279,,15557,Terminal SE - Transferencia TPV,55550,0,"-95552620,19"
05/01/2024,49304,,15593,Terminal SE - Transferencia TPV,83747,0,"-95468873,19"
05/01/2024,49308,,15604,Terminal SE - Transferencia TPV,88000,0,"-95380873,19"
05/01/2024,49271,,15549,Terminal SE - Transferencia TPV,228461,0,"-95152412,19"
05/01/2024,49312,,15616,Terminal SE - Transferencia TPV,"111500,01",0,"-95040912,18"
05/01/2024,49297,,15578,Terminal SE - Transferencia TPV,111000,0,"-94929912,18"
05/01/2024,49302,,15585,Terminal SE - Transferencia TPV,"91558,99",0,"-94838353,19"
05/01/2024,49305,,15597,Terminal SE - Transferencia TPV,92761,0,"-94745592,19"
05/01/2024,49275,,15553,Terminal SE - Transferencia TPV,"195580,99",0,"-94550011,2"
05/01/2024,49306,,15598,Terminal SE - Transferencia TPV,154500,0,"-94395511,2"
05/02/2024,49429,,15624,Terminal SE - Transferencia TPV,184976,0,"-94499335,15"
05/02/2024,49431,,15631,Terminal SE - Transferencia TPV,63000,0,"-94436335,15"
05/02/2024,49430,,15630,Terminal SE - Transferencia TPV,"138999,99",0,"-94297335,16"
05/02/2024,49313,,,Terminal SE - Transferencia TPV,0,5323324,"-99620659,16"
05/02/2024,49432,,15642,Terminal SE - Transferencia TPV,70000,0,"-99550659,16"
05/03/2024,49660,,15697,Terminal SE - Transferencia TPV,"265280,99",0,"-99285378,17"
05/03/2024,49659,,15694,Terminal SE - Transferencia TPV,"389508,99",0,"-99019369,21"
05/03/2024,49658,,15688,Terminal SE - Transferencia TPV,"98879,99",0,"-99044789,21"
05/03/2024,49657,,15683,Terminal SE - Transferencia TPV,"61999,99",0,"-98982789,22"
05/03/2024,49656,,15679,Terminal SE - Transferencia TPV,158000,0,"-98824789,22"
05/03/2024,49655,,15676,Terminal SE - Transferencia TPV,99590,0,"-98725199,22"
05/03/2024,49654,,15674,Terminal SE - Transferencia TPV,62500,0,"-98662699,22"
05/03/2024,49433,,,Terminal SE - Transferencia TPV,0,456976,"-99119675,22"
05/03/2024,49652,,15672,Terminal SE - Transferencia TPV,"71000,01",0,"-99048675,21"
05/03/2024,49653,,15673,Terminal SE - Transferencia TPV,66000,0,"-98982675,21"
05/03/2024,49651,,15671,Terminal SE - Transferencia TPV,69000,0,"-98913675,21"
05/03/2024,49650,,15670,Terminal SE - Transferencia TPV,"70799,99",0,"-98842875,22"
05/03/2024,49649,,15669,Terminal SE - Transferencia TPV,128000,0,"-98714875,22"
05/03/2024,49648,,15650,Terminal SE - Transferencia TPV,60000,0,"-98654875,22"
05/03/2024,49647,,15649,Terminal SE - Transferencia TPV,67800,0,"-98587075,22"
05/04/2024,50094,,15708,Terminal SE - Transferencia TPV,64000,0,"-98523075,22"
05/04/2024,50129,,15792,Terminal SE - Transferencia TPV,90685,0,"-98432390,22"
05/04/2024,50108,,15738,Terminal SE - Transferencia TPV,"64999,99",0,"-98367390,23"
05/04/2024,50128,,15791,Terminal SE - Transferencia TPV,"113629,98",0,"-98253760,25"
05/04/2024,50098,,15718,Terminal SE - Transferencia TPV,86151,0,"-98167609,25"
05/04/2024,50117,,15760,Terminal SE - Transferencia TPV,"93349,99",0,"-98074259,26"
05/04/2024,50106,,15732,Terminal SE - Transferencia TPV,64800,0,"-98009459,26"
05/04/2024,50125,,15775,Terminal SE - Transferencia TPV,188581,0,"-97820878,26"
05/04/2024,50102,,15722,Terminal SE - Transferencia TPV,60850,0,"-97760028,26"
05/04/2024,50118,,15762,Terminal SE - Transferencia TPV,4000,0,"-97756028,26"
05/04/2024,50115,,15751,Terminal SE - Transferencia TPV,270500,0,"-97485528,26"
05/04/2024,50109,,15740,Terminal SE - Transferencia TPV,109259,0,"-97376269,26"
05/04/2024,50104,,15726,Terminal SE - Transferencia TPV,"159999,99",0,"-97216269,27"
05/04/2024,50095,,15713,Terminal SE - Transferencia TPV,57000,0,"-97159269,27"
05/04/2024,50121,,15768,Terminal SE - Transferencia TPV,176836,0,"-97172233,27"
05/04/2024,50103,,15724,Terminal SE - Transferencia TPV,63000,0,"-97109233,27"
05/04/2024,50123,,15771,Terminal SE - Transferencia TPV,80600,0,"-99263102,45"
05/04/2024,50105,,15731,Terminal SE - Transferencia TPV,234000,0,"-99029102,45"
05/04/2024,50116,,15754,Terminal SE - Transferencia TPV,132422,0,"-98896680,45"
05/04/2024,50119,,15763,Terminal SE - Transferencia TPV,"176671,99",0,"-98720008,46"
05/04/2024,50112,,15745,Terminal SE - Transferencia TPV,78721,0,"-98641287,46"
05/04/2024,50122,,15770,Terminal SE - Transferencia TPV,132600,0,"-98508687,46"
05/04/2024,50127,,15789,Terminal SE - Transferencia TPV,83037,0,"-98425650,46"
05/04/2024,50126,,15785,Terminal SE - Transferencia TPV,"90000,01",0,"-98472150,45"
05/04/2024,49661,,,Terminal SE - Transferencia TPV,0,1668359,"-100140509,45"
05/04/2024,50111,,15744,Terminal SE - Transferencia TPV,"180168,99",0,"-99960340,46"
05/04/2024,50101,,15721,Terminal SE - Transferencia TPV,115000,0,"-99845340,46"
05/04/2024,50097,,15717,Terminal SE - Transferencia TPV,102157,0,"-99747683,46"
05/04/2024,50114,,15749,Terminal SE - Transferencia TPV,"127299,99",0,"-99620383,47"
05/04/2024,50099,,15719,Terminal SE - Transferencia TPV,"63000,01",0,"-99557383,46"
05/04/2024,50113,,15747,Terminal SE - Transferencia TPV,98169,0,"-99459214,46"
05/04/2024,50100,,15720,Terminal SE - Transferencia TPV,54000,0,"-99603214,46"
05/04/2024,50107,,15733,Terminal SE - Transferencia TPV,163000,0,"-99440214,46"
05/04/2024,50110,,15743,Terminal SE - Transferencia TPV,"125000,01",0,"-99576514,45"
05/04/2024,50120,,15765,Terminal SE - Transferencia TPV,34700,0,"-99626814,45"
05/04/2024,50124,,15773,Terminal SE - Transferencia TPV,"230000,01",0,"-99485314,44"
05/04/2024,50096,,15714,Terminal SE - Transferencia TPV,81070,0,"-99633044,44"
05/05/2024,50130,,,Terminal SE - Transferencia TPV,0,4049269,"-103682313,44"
05/05/2024,50575,,15847,Terminal SE - Transferencia TPV,74000,0,"-103608313,44"
05/05/2024,50562,,15815,Terminal SE - Transferencia TPV,206063,0,"-103402250,44"
05/05/2024,50581,,15870,Terminal SE - Transferencia TPV,"54999,99",0,"-103347250,45"
05/05/2024,50560,,15813,Terminal SE - Transferencia TPV,105654,0,"-103241596,45"
05/05/2024,50571,,15829,Terminal SE - Transferencia TPV,85769,0,"-103155827,45"
05/05/2024,50552,,15799,Terminal SE - Transferencia TPV,86424,0,"-103069403,45"
05/05/2024,50569,,15827,Terminal SE - Transferencia TPV,"153509,01",0,"-102915894,44"
05/05/2024,50553,,15801,Terminal SE - Transferencia TPV,137831,0,"-102778063,44"
05/05/2024,50579,,15862,Terminal SE - Transferencia TPV,"381151,01",0,"-102396912,43"
05/05/2024,50576,,15854,Terminal SE - Transferencia TPV,62700,0,"-102334212,43"
05/05/2024,50568,,15826,Terminal SE - Transferencia TPV,"66999,99",0,"-102267212,44"
05/05/2024,50567,,15824,Terminal SE - Transferencia TPV,87600,0,"-102179612,44"
05/05/2024,50554,,15804,Terminal SE - Transferencia TPV,78011,0,"-102101601,44"
05/05/2024,50561,,15814,Terminal SE - Transferencia TPV,"81179,99",0,"-102020421,45"
05/05/2024,50565,,15821,Terminal SE - Transferencia TPV,206773,0,"-101998968,45"
05/05/2024,50572,,15833,Terminal SE - Transferencia TPV,77600,0,"-101921368,45"
05/05/2024,50577,,15856,Terminal SE - Transferencia TPV,20000,0,"-101901368,45"
05/05/2024,50580,,15869,Terminal SE - Transferencia TPV,50000,0,"-101851368,45"
05/05/2024,50555,,15809,Terminal SE - Transferencia TPV,"232394,01",0,"-101618974,44"
05/05/2024,50573,,15840,Terminal SE - Transferencia TPV,57000,0,"-101561974,44"
05/05/2024,50574,,15844,Terminal SE - Transferencia TPV,122000,0,"-101439974,44"
05/05/2024,50563,,15816,Terminal SE - Transferencia TPV,"74999,99",0,"-101364974,45"
05/05/2024,50570,,15828,Terminal SE - Transferencia TPV,"104342,99",0,"-101260631,46"
05/05/2024,50578,,15860,Terminal SE - Transferencia TPV,"157849,99",0,"-101102781,47"
05/05/2024,50556,,15811,Terminal SE - Transferencia TPV,28700,0,"-101074081,47"
05/05/2024,50557,,15811,Terminal SE - Transferencia TPV,28661,0,"-101045420,47"
05/05/2024,50558,,15812,Terminal SE - Transferencia TPV,50000,0,"-100995420,47"
05/05/2024,50559,,15812,Terminal SE - Transferencia TPV,"55434,99",0,"-100939985,48"
05/05/2024,50564,,15819,Terminal SE - Transferencia TPV,40000,0,"-100899985,48"
05/05/2024,50566,,15823,Terminal SE - Transferencia TPV,"95055,99",0,"-100804929,49"
05/06/2024,50582,,,Terminal SE - Transferencia TPV,0,3062640,"-104087987,49"
05/08/2024,50801,,15912,Terminal SE - Transferencia TPV,110842,0,"-106488673,94"
05/08/2024,50799,,15900,Terminal SE - Transferencia TPV,"22944,01",0,-108031272
05/08/2024,50800,,15901,Terminal SE - Transferencia TPV,116000,0,"-108082898,97"
05/09/2024,50985,,15929,Terminal SE - Transferencia TPV,72000,0,"-108010898,97"
05/09/2024,50984,,15928,Terminal SE - Transferencia TPV,"78499,99",0,"-107932398,98"
05/09/2024,50988,,15932,Terminal SE - Transferencia TPV,"187379,99",0,"-107745018,99"
05/09/2024,50987,,15931,Terminal SE - Transferencia TPV,56000,0,"-109125018,99"
05/09/2024,50986,,15930,Terminal SE - Transferencia TPV,116000,0,"-109009018,99"
05/09/2024,50995,,15960,Terminal SE - Transferencia TPV,"63350,99",0,"-109252691,57"
05/09/2024,50994,,15960,Terminal SE - Transferencia TPV,63650,0,"-109189041,57"
05/09/2024,50993,,15960,Terminal SE - Transferencia TPV,63350,0,"-109125691,57"
05/09/2024,50992,,15943,Terminal SE - Transferencia TPV,66000,0,"-109059691,57"
05/09/2024,50991,,15942,Terminal SE - Transferencia TPV,62000,0,"-108997691,57"
05/09/2024,50990,,15941,Terminal SE - Transferencia TPV,93089,0,"-108904602,57"
05/09/2024,50802,,,Terminal SE - Transferencia TPV,0,249742,"-109154344,57"
05/09/2024,50989,,15935,Terminal SE - Transferencia TPV,"182790,99",0,"-108971553,58"
05/10/2024,51242,,15977,Terminal SE - Transferencia TPV,22600,0,"-108948953,58"
05/10/2024,51248,,15987,Terminal SE - Transferencia TPV,271000,0,"-108677953,58"
05/10/2024,51252,,16005,Terminal SE - Transferencia TPV,212000,0,"-108465953,58"
05/10/2024,51250,,16002,Terminal SE - Transferencia TPV,188788,0,"-108277165,58"
05/10/2024,51247,,15986,Terminal SE - Transferencia TPV,66000,0,"-108211165,58"
05/10/2024,51251,,16002,Terminal SE - Transferencia TPV,63000,0,"-108148165,58"
05/10/2024,51249,,15988,Terminal SE - Transferencia TPV,77630,0,"-108070535,58"
05/10/2024,51241,,15974,Terminal SE - Transferencia TPV,115815,0,"-107954720,58"
05/10/2024,51243,,15978,Terminal SE - Transferencia TPV,64500,0,"-107890220,58"
05/10/2024,50996,,,Terminal SE - Transferencia TPV,0,1104420,"-108994640,58"
05/10/2024,51244,,15983,Terminal SE - Transferencia TPV,65000,0,"-108929640,58"
05/10/2024,51245,,15984,Terminal SE - Transferencia TPV,170000,0,"-108759640,58"
05/10/2024,51246,,15985,Terminal SE - Transferencia TPV,56000,0,"-108703640,58"
05/11/2024,51789,,16035,Terminal SE - Transferencia TPV,"149083,99",0,"-108554556,59"
05/11/2024,51807,,16089,Terminal SE - Transferencia TPV,"197758,99",0,"-108915377,6"
05/11/2024,51804,,16077,Terminal SE - Transferencia TPV,66800,0,"-108848577,6"
05/11/2024,51801,,16069,Terminal SE - Transferencia TPV,93799,0,"-108754778,6"
05/11/2024,51791,,16043,Terminal SE - Transferencia TPV,67000,0,"-108687778,6"
05/11/2024,51786,,16032,Terminal SE - Transferencia TPV,"262222,01",0,"-108425556,59"
05/11/2024,51806,,16082,Terminal SE - Transferencia TPV,"61185,01",0,"-108364371,58"
05/11/2024,51795,,16052,Terminal SE - Transferencia TPV,64000,0,"-108300371,58"
05/11/2024,51802,,16070,Terminal SE - Transferencia TPV,"66999,99",0,"-108233371,59"
05/11/2024,51794,,16048,Terminal SE - Transferencia TPV,109806,0,"-108123565,59"
05/11/2024,51796,,16054,Terminal SE - Transferencia TPV,"90499,99",0,"-108033065,6"
05/11/2024,51793,,16047,Terminal SE - Transferencia TPV,81500,0,"-107951565,6"
05/11/2024,51792,,16047,Terminal SE - Transferencia TPV,150000,0,"-107801565,6"
05/11/2024,51780,,16024,Terminal SE - Transferencia TPV,"206999,99",0,"-107594565,61"
05/11/2024,51779,,16024,Terminal SE - Transferencia TPV,103213,0,"-107545352,61"
05/11/2024,51781,,16028,Terminal SE - Transferencia TPV,51800,0,"-107493552,61"
05/11/2024,51803,,16071,Terminal SE - Transferencia TPV,98333,0,"-107395219,61"
05/11/2024,51790,,16039,Terminal SE - Transferencia TPV,218081,0,"-107177138,61"
05/11/2024,51788,,16034,Terminal SE - Transferencia TPV,"80305,99",0,"-107096832,62"
05/11/2024,51805,,16080,Terminal SE - Transferencia TPV,89700,0,"-107007132,62"
05/11/2024,51785,,16031,Terminal SE - Transferencia TPV,86000,0,"-106921132,62"
05/11/2024,51797,,16055,Terminal SE - Transferencia TPV,"54500,01",0,"-106866632,61"
05/11/2024,51799,,16064,Terminal SE - Transferencia TPV,81944,0,"-106784688,61"
05/11/2024,51800,,16066,Terminal SE - Transferencia TPV,"86970,01",0,"-106697718,6"
05/11/2024,51787,,16033,Terminal SE - Transferencia TPV,"46999,99",0,"-106650718,61"
05/11/2024,51798,,16061,Terminal SE - Transferencia TPV,71200,0,"-106579518,61"
05/11/2024,51808,,16095,Terminal SE - Transferencia TPV,"267794,01",0,"-106311724,6"
05/11/2024,51784,,16029,Terminal SE - Transferencia TPV,"299363,98",0,"-106012360,62"
05/11/2024,51783,,16029,Terminal SE - Transferencia TPV,102000,0,"-105910360,62"
05/11/2024,51782,,16028,Terminal SE - Transferencia TPV,51800,0,"-105858560,62"
05/11/2024,51253,,,Terminal SE - Transferencia TPV,0,1372333,"-107230893,62"
05/12/2024,52281,,16143,Terminal SE - Transferencia TPV,"174268,99",0,"-107056624,63"
05/12/2024,52274,,16127,Terminal SE - Transferencia TPV,101500,0,"-106955124,63"
05/12/2024,52282,,16144,Terminal SE - Transferencia TPV,"110958,99",0,"-106844165,64"
05/12/2024,52305,,16182,Terminal SE - Transferencia TPV,157850,0,"-106686315,64"
05/12/2024,52302,,16173,Terminal SE - Transferencia TPV,"103796,01",0,"-106582519,63"
05/12/2024,52284,,16148,Terminal SE - Transferencia TPV,157000,0,"-106425519,63"
05/12/2024,52286,,16152,Terminal SE - Transferencia TPV,54000,0,"-106371519,63"
05/12/2024,52273,,16126,Terminal SE - Transferencia TPV,149000,0,"-106222519,63"
05/12/2024,52294,,16162,Terminal SE - Transferencia TPV,66000,0,"-106156519,63"
05/12/2024,52277,,16133,Terminal SE - Transferencia TPV,166894,0,"-105989625,63"
05/12/2024,52288,,16154,Terminal SE - Transferencia TPV,85500,0,"-105904125,63"
05/12/2024,52290,,16156,Terminal SE - Transferencia TPV,116000,0,"-105788125,63"
05/12/2024,52301,,16172,Terminal SE - Transferencia TPV,60000,0,"-105728125,63"
05/12/2024,52280,,16141,Terminal SE - Transferencia TPV,205790,0,"-105522335,63"
05/12/2024,52291,,16157,Terminal SE - Transferencia TPV,91559,0,"-105430776,63"
05/12/2024,52296,,16164,Terminal SE - Transferencia TPV,85441,0,"-105345335,63"
05/12/2024,52278,,16134,Terminal SE - Transferencia TPV,165255,0,"-105180080,63"
05/12/2024,52276,,16132,Terminal SE - Transferencia TPV,240698,0,"-104939382,63"
05/12/2024,52298,,16169,Terminal SE - Transferencia TPV,71800,0,"-104867582,63"
05/12/2024,52304,,16178,Terminal SE - Transferencia TPV,174924,0,"-104692658,63"
05/12/2024,52285,,16151,Terminal SE - Transferencia TPV,252498,0,"-104440160,63"
05/12/2024,52299,,16170,Terminal SE - Transferencia TPV,59500,0,"-104380660,63"
05/12/2024,51809,,,Terminal SE - Transferencia TPV,0,3458296,"-107838956,63"
05/12/2024,52303,,16174,Terminal SE - Transferencia TPV,"81398,01",0,"-107757558,62"
05/12/2024,52297,,16166,Terminal SE - Transferencia TPV,74700,0,"-107682858,62"
05/12/2024,52289,,16155,Terminal SE - Transferencia TPV,"88000,01",0,"-107594858,61"
05/12/2024,52287,,16153,Terminal SE - Transferencia TPV,69000,0,"-107525858,61"
05/12/2024,52279,,16137,Terminal SE - Transferencia TPV,155148,0,"-107370710,61"
05/12/2024,52292,,16158,Terminal SE - Transferencia TPV,"254049,99",0,"-107116660,62"
05/12/2024,52283,,16147,Terminal SE - Transferencia TPV,97241,0,"-107019419,62"
05/12/2024,52270,,16115,Terminal SE - Transferencia TPV,19000,0,"-107000419,62"
05/12/2024,52275,,16128,Terminal SE - Transferencia TPV,"109850,01",0,"-106890569,61"
05/12/2024,52272,,16120,Terminal SE - Transferencia TPV,"87953,99",0,"-106802615,62"
05/12/2024,52295,,16163,Terminal SE - Transferencia TPV,170000,0,"-106632615,62"
05/12/2024,52293,,16160,Terminal SE - Transferencia TPV,127000,0,"-106505615,62"
05/12/2024,52271,,16117,Terminal SE - Transferencia TPV,62500,0,"-106443115,62"
05/12/2024,52300,,16171,Terminal SE - Transferencia TPV,56000,0,"-106387115,62"
05/13/2024,52886,,16278,Terminal SE - Transferencia TPV,"110897,99",0,"-106276217,63"
05/13/2024,52865,,16228,Terminal SE - Transferencia TPV,"261402,99",0,"-106014814,64"
05/13/2024,52877,,16260,Terminal SE - Transferencia TPV,"179403,98",0,"-105835410,66"
05/13/2024,52848,,16204,Terminal SE - Transferencia TPV,78700,0,"-105756710,66"
05/13/2024,52871,,16247,Terminal SE - Transferencia TPV,88281,0,"-105668429,66"
05/13/2024,52852,,16210,Terminal SE - Transferencia TPV,"146079,99",0,"-105522349,67"
05/13/2024,52856,,16217,Terminal SE - Transferencia TPV,"207999,99",0,"-105314349,68"
05/13/2024,52863,,16226,Terminal SE - Transferencia TPV,149000,0,"-105165349,68"
05/13/2024,52847,,16203,Terminal SE - Transferencia TPV,115000,0,"-105050349,68"
05/13/2024,52867,,16232,Terminal SE - Transferencia TPV,"90630,99",0,"-104959718,69"
05/13/2024,52888,,16282,Terminal SE - Transferencia TPV,"111116,99",0,"-104848601,7"
05/13/2024,52862,,16225,Terminal SE - Transferencia TPV,"78999,99",0,"-104769601,71"
05/13/2024,52845,,16201,Terminal SE - Transferencia TPV,85004,0,"-104684597,71"
05/13/2024,52869,,16244,Terminal SE - Transferencia TPV,183392,0,"-104501205,71"
05/13/2024,52882,,16267,Terminal SE - Transferencia TPV,"167999,99",0,"-104333205,72"
05/13/2024,52880,,16265,Terminal SE - Transferencia TPV,"170099,99",0,"-104163105,73"
05/13/2024,52889,,16284,Terminal SE - Transferencia TPV,81800,0,"-104081305,73"
05/13/2024,52868,,16235,Terminal SE - Transferencia TPV,64000,0,"-104017305,73"
05/13/2024,52306,,,Terminal SE - Transferencia TPV,0,4302201,"-108319506,73"
05/13/2024,52843,,16197,Terminal SE - Transferencia TPV,123400,0,"-108196106,73"
05/13/2024,52878,,16261,Terminal SE - Transferencia TPV,73149,0,"-108122957,73"
05/13/2024,52874,,16252,Terminal SE - Transferencia TPV,58000,0,"-108064957,73"
05/13/2024,52864,,16227,Terminal SE - Transferencia TPV,"158589,99",0,"-107906367,74"
05/13/2024,52861,,16223,Terminal SE - Transferencia TPV,105981,0,"-107800386,74"
05/13/2024,52870,,16246,Terminal SE - Transferencia TPV,82272,0,"-107718114,74"
05/13/2024,52858,,16219,Terminal SE - Transferencia TPV,64000,0,"-107654114,74"
05/13/2024,52849,,16206,Terminal SE - Transferencia TPV,"145915,99",0,"-107508198,75"
05/13/2024,52879,,16263,Terminal SE - Transferencia TPV,80469,0,"-107427729,75"
05/13/2024,52841,,16194,Terminal SE - Transferencia TPV,"271999,99",0,"-107155729,76"
05/13/2024,52851,,16209,Terminal SE - Transferencia TPV,"110679,98",0,"-107045049,78"
05/13/2024,52887,,16279,Terminal SE - Transferencia TPV,"80196,01",0,"-106964853,77"
05/13/2024,52876,,16259,Terminal SE - Transferencia TPV,136250,0,"-106828603,77"
05/13/2024,52842,,16196,Terminal SE - Transferencia TPV,121850,0,"-106706753,77"
05/13/2024,52884,,16273,Terminal SE - Transferencia TPV,100519,0,"-106606234,77"
05/13/2024,52872,,16248,Terminal SE - Transferencia TPV,201950,0,"-106404284,77"
05/13/2024,52850,,16208,Terminal SE - Transferencia TPV,"105052,99",0,"-106299231,78"
05/13/2024,52881,,16266,Terminal SE - Transferencia TPV,"168095,01",0,"-106131136,77"
05/13/2024,52846,,16202,Terminal SE - Transferencia TPV,145260,0,"-105985876,77"
05/13/2024,52883,,16268,Terminal SE - Transferencia TPV,"101899,99",0,"-105883976,78"
05/13/2024,52885,,16274,Terminal SE - Transferencia TPV,51000,0,"-105832976,78"
05/13/2024,52859,,16220,Terminal SE - Transferencia TPV,235050,0,"-105597926,78"
05/13/2024,52844,,16198,Terminal SE - Transferencia TPV,184976,0,"-105412950,78"
05/13/2024,52855,,16216,Terminal SE - Transferencia TPV,"60799,99",0,"-105352150,79"
05/13/2024,52873,,16249,Terminal SE - Transferencia TPV,69000,0,"-105283150,79"
05/13/2024,52854,,16215,Terminal SE - Transferencia TPV,118656,0,"-105164494,79"
05/13/2024,52875,,16253,Terminal SE - Transferencia TPV,75498,0,"-105088996,79"
05/13/2024,52853,,16212,Terminal SE - Transferencia TPV,"182571,99",0,"-104906424,8"
05/13/2024,52866,,16231,Terminal SE - Transferencia TPV,90300,0,"-104816124,8"
05/13/2024,52857,,16218,Terminal SE - Transferencia TPV,154000,0,"-104662124,8"
05/13/2024,52860,,16221,Terminal SE - Transferencia TPV,165801,0,"-104496323,8"
05/13/2024,52891,,16285,Terminal SE - Transferencia TPV,16000,0,"-104480323,8"
05/13/2024,52890,,16284,Terminal SE - Transferencia TPV,97502,0,"-104382821,8"
05/14/2024,52892,,,Terminal SE - Transferencia TPV,0,6304632,"-111955853,8"
05/15/2024,53148,,16318,Terminal SE - Transferencia TPV,71000,0,"-112532552,2"
05/15/2024,53152,,16328,Terminal SE - Transferencia TPV,62988,0,"-112469564,2"
05/15/2024,53151,,16327,Terminal SE - Transferencia TPV,"200596,99",0,"-112268967,21"
05/15/2024,53150,,16324,Terminal SE - Transferencia TPV,69500,0,"-112256594,35"
05/15/2024,53153,,16329,Terminal SE - Transferencia TPV,"158972,01",0,"-112097622,34"
05/15/2024,53154,,16333,Terminal SE - Transferencia TPV,"77000,01",0,"-112020622,33"
05/15/2024,53155,,16334,Terminal SE - Transferencia TPV,350000,0,"-111670622,33"
05/15/2024,53156,,16339,Terminal SE - Transferencia TPV,204096,0,"-111466526,33"
05/15/2024,53146,,16312,Terminal SE - Transferencia TPV,"89999,99",0,"-111376526,34"
05/15/2024,53147,,16314,Terminal SE - Transferencia TPV,51850,0,"-111324676,34"
05/15/2024,53149,,16319,Terminal SE - Transferencia TPV,132500,0,"-111192176,34"
05/16/2024,53309,,16363,Terminal SE - Transferencia TPV,7100,0,"-111185076,34"
05/16/2024,53308,,16363,Terminal SE - Transferencia TPV,7100,0,"-111177976,34"
05/16/2024,53157,,,Terminal SE - Transferencia TPV,0,1468515,"-112646491,34"
05/16/2024,53303,,16347,Terminal SE - Transferencia TPV,57800,0,"-112588691,34"
05/16/2024,53306,,16356,Terminal SE - Transferencia TPV,63000,0,"-112525691,34"
05/16/2024,53312,,16371,Terminal SE - Transferencia TPV,53900,0,"-112471791,34"
05/16/2024,53307,,16358,Terminal SE - Transferencia TPV,68500,0,"-112403291,34"
05/16/2024,53305,,16353,Terminal SE - Transferencia TPV,100846,0,"-112302445,34"
05/16/2024,53301,,16343,Terminal SE - Transferencia TPV,57000,0,"-112245445,34"
05/16/2024,53302,,16344,Terminal SE - Transferencia TPV,"86999,99",0,"-112158445,35"
05/16/2024,53304,,16351,Terminal SE - Transferencia TPV,"144999,99",0,"-112013445,36"
05/16/2024,53311,,16370,Terminal SE - Transferencia TPV,80000,0,"-111933445,36"
05/16/2024,53310,,16369,Terminal SE - Transferencia TPV,100000,0,"-111833445,36"
05/17/2024,53687,,16393,Terminal SE - Transferencia TPV,175000,0,"-111658445,36"
05/17/2024,53694,,16423,Terminal SE - Transferencia TPV,194000,0,"-111464445,36"
05/17/2024,53695,,16428,Terminal SE - Transferencia TPV,141928,0,"-111322517,36"
05/17/2024,53696,,16430,Terminal SE - Transferencia TPV,"81616,99",0,"-111240900,37"
05/17/2024,53697,,16434,Terminal SE - Transferencia TPV,160502,0,"-111080398,37"
05/17/2024,53686,,16388,Terminal SE - Transferencia TPV,88900,0,"-110991498,37"
05/17/2024,53685,,16384,Terminal SE - Transferencia TPV,"85768,99",0,"-110905729,38"
05/17/2024,53684,,16382,Terminal SE - Transferencia TPV,"475659,99",0,"-110430069,39"
05/17/2024,53313,,,Terminal SE - Transferencia TPV,0,827244,"-111257313,39"
05/17/2024,53688,,16397,Terminal SE - Transferencia TPV,"63000,01",0,"-111194313,38"
05/17/2024,53689,,16406,Terminal SE - Transferencia TPV,56000,0,"-111138313,38"
05/17/2024,53690,,16407,Terminal SE - Transferencia TPV,"170936,01",0,"-110967377,37"
05/17/2024,53691,,16415,Terminal SE - Transferencia TPV,140944,0,"-110826433,37"
05/17/2024,53692,,16420,Terminal SE - Transferencia TPV,232941,0,"-110593492,37"
05/17/2024,53693,,16421,Terminal SE - Transferencia TPV,"88700,01",0,"-110504792,36"
05/18/2024,54178,,16470,Terminal SE - Transferencia TPV,116031,0,"-110388761,36"
05/18/2024,54199,,16522,Terminal SE - Transferencia TPV,90500,0,"-110298261,36"
05/18/2024,54171,,16457,Terminal SE - Transferencia TPV,"113410,99",0,"-110184850,37"
05/18/2024,54182,,16476,Terminal SE - Transferencia TPV,52000,0,"-110132850,37"
05/18/2024,54204,,16536,Terminal SE - Transferencia TPV,"289864,99",0,"-109842985,38"
05/18/2024,54189,,16494,Terminal SE - Transferencia TPV,"67300,01",0,"-109775685,37"
05/18/2024,54175,,16463,Terminal SE - Transferencia TPV,73859,0,"-109701826,37"
05/18/2024,54179,,16472,Terminal SE - Transferencia TPV,67000,0,"-109634826,37"
05/18/2024,54192,,16503,Terminal SE - Transferencia TPV,57150,0,"-109577676,37"
05/18/2024,54198,,16521,Terminal SE - Transferencia TPV,107500,0,"-109470176,37"
05/18/2024,54203,,16531,Terminal SE - Transferencia TPV,7000,0,"-109463176,37"
05/18/2024,54170,,16452,Terminal SE - Transferencia TPV,60500,0,"-109402676,37"
05/18/2024,54202,,16530,Terminal SE - Transferencia TPV,"88999,99",0,"-109313676,38"
05/18/2024,54196,,16511,Terminal SE - Transferencia TPV,"68499,99",0,"-109245176,39"
05/18/2024,53698,,,Terminal SE - Transferencia TPV,0,2155793,"-111400969,39"
05/18/2024,54197,,16515,Terminal SE - Transferencia TPV,352634,0,"-111048335,39"
05/18/2024,54193,,16504,Terminal SE - Transferencia TPV,"53000,01",0,"-110995335,38"
05/18/2024,54181,,16475,Terminal SE - Transferencia TPV,"76599,99",0,"-110918735,39"
05/18/2024,54176,,16464,Terminal SE - Transferencia TPV,"147849,99",0,"-110770885,4"
05/18/2024,54201,,16528,Terminal SE - Transferencia TPV,174159,0,"-110596726,4"
05/18/2024,54187,,16489,Terminal SE - Transferencia TPV,95000,0,"-110501726,4"
05/18/2024,54173,,16461,Terminal SE - Transferencia TPV,81100,0,"-110420626,4"
05/18/2024,54191,,16500,Terminal SE - Transferencia TPV,"171500,01",0,"-110249126,39"
05/18/2024,54195,,16509,Terminal SE - Transferencia TPV,51850,0,"-110197276,39"
05/18/2024,54172,,16460,Terminal SE - Transferencia TPV,83256,0,"-110114020,39"
05/18/2024,54185,,16485,Terminal SE - Transferencia TPV,"525096,99",0,"-109588923,4"
05/18/2024,54190,,16495,Terminal SE - Transferencia TPV,"209011,99",0,"-109379911,41"
05/18/2024,54169,,16451,Terminal SE - Transferencia TPV,109600,0,"-109270311,41"
05/18/2024,54183,,16477,Terminal SE - Transferencia TPV,"334223,99",0,"-108936087,42"
05/18/2024,54188,,16490,Terminal SE - Transferencia TPV,"94727,99",0,"-108841359,43"
05/18/2024,54200,,16523,Terminal SE - Transferencia TPV,"185000,81",0,"-108656358,62"
05/18/2024,54194,,16507,Terminal SE - Transferencia TPV,56000,0,"-108600358,62"
05/18/2024,54180,,16474,Terminal SE - Transferencia TPV,65000,0,"-108535358,62"
05/18/2024,54184,,16478,Terminal SE - Transferencia TPV,89046,0,"-108446312,62"
05/18/2024,54174,,16462,Terminal SE - Transferencia TPV,"91999,99",0,"-108354312,63"
05/18/2024,54177,,16467,Terminal SE - Transferencia TPV,140234,0,"-108214078,63"
05/18/2024,54186,,16487,Terminal SE - Transferencia TPV,93300,0,"-108120778,63"
05/19/2024,54661,,16551,Terminal SE - Transferencia TPV,"157000,01",0,"-107963778,62"
05/19/2024,54205,,,Terminal SE - Transferencia TPV,0,4539804,"-112503582,62"
05/19/2024,54699,,16623,Terminal SE - Transferencia TPV,132040,0,"-112371542,62"
05/19/2024,54660,,16550,Terminal SE - Transferencia TPV,57000,0,"-112314542,62"
05/19/2024,54668,,16564,Terminal SE - Transferencia TPV,68287,0,"-112246255,62"
05/19/2024,54670,,16568,Terminal SE - Transferencia TPV,87500,0,"-112158755,62"
05/19/2024,54673,,16574,Terminal SE - Transferencia TPV,"200873,01",0,"-111957882,61"
05/19/2024,54666,,16562,Terminal SE - Transferencia TPV,8000,0,"-111949882,61"
05/19/2024,54695,,16612,Terminal SE - Transferencia TPV,92706,0,"-111857176,61"
05/19/2024,54686,,16592,Terminal SE - Transferencia TPV,216000,0,"-111641176,61"
05/19/2024,54674,,16575,Terminal SE - Transferencia TPV,116197,0,"-111524979,61"
05/19/2024,54678,,16580,Terminal SE - Transferencia TPV,"184999,99",0,"-111339979,62"
05/19/2024,54665,,16557,Terminal SE - Transferencia TPV,97000,0,"-111242979,62"
05/19/2024,54662,,16553,Terminal SE - Transferencia TPV,"103999,99",0,"-111138979,63"
05/19/2024,54698,,16622,Terminal SE - Transferencia TPV,230000,0,"-110908979,63"
05/19/2024,54697,,16621,Terminal SE - Transferencia TPV,"86970,01",0,"-110822009,62"
05/19/2024,54675,,16576,Terminal SE - Transferencia TPV,"129000,01",0,"-110693009,61"
05/19/2024,54671,,16572,Terminal SE - Transferencia TPV,157006,0,"-110536003,61"
05/19/2024,54679,,16581,Terminal SE - Transferencia TPV,101065,0,"-110434938,61"
05/19/2024,54667,,16563,Terminal SE - Transferencia TPV,1800,0,"-110433138,61"
05/19/2024,54687,,16594,Terminal SE - Transferencia TPV,"335799,99",0,"-110097338,62"
05/19/2024,54693,,16606,Terminal SE - Transferencia TPV,"108712,99",0,"-109988625,63"
05/19/2024,54694,,16609,Terminal SE - Transferencia TPV,199000,0,"-109789625,63"
05/19/2024,54692,,16605,Terminal SE - Transferencia TPV,284183,0,"-109505442,63"
05/19/2024,54680,,16582,Terminal SE - Transferencia TPV,93000,0,"-109412442,63"
05/19/2024,54684,,16589,Terminal SE - Transferencia TPV,63000,0,"-109349442,63"
05/19/2024,54682,,16585,Terminal SE - Transferencia TPV,"277459,98",0,"-109071982,65"
05/19/2024,54688,,16595,Terminal SE - Transferencia TPV,"131399,99",0,"-108940582,66"
05/19/2024,54672,,16573,Terminal SE - Transferencia TPV,96694,0,"-108843888,66"
05/19/2024,54691,,16603,Terminal SE - Transferencia TPV,"91599,99",0,"-108752288,67"
05/19/2024,54681,,16583,Terminal SE - Transferencia TPV,200000,0,"-108552288,67"
05/19/2024,54664,,16556,Terminal SE - Transferencia TPV,58781,0,"-108493507,67"
05/19/2024,54677,,16579,Terminal SE - Transferencia TPV,"87099,99",0,"-108406407,68"
05/19/2024,54690,,16602,Terminal SE - Transferencia TPV,"88936,99",0,"-108317470,69"
05/19/2024,54685,,16590,Terminal SE - Transferencia TPV,93089,0,"-108224381,69"
05/19/2024,54683,,16586,Terminal SE - Transferencia TPV,127000,0,"-108097381,69"
05/19/2024,54676,,16577,Terminal SE - Transferencia TPV,77246,0,"-108020135,69"
05/19/2024,54669,,16567,Terminal SE - Transferencia TPV,118437,0,"-107901698,69"
05/19/2024,54696,,16617,Terminal SE - Transferencia TPV,246200,0,"-107655498,69"
05/19/2024,54689,,16599,Terminal SE - Transferencia TPV,"157224,01",0,"-107498274,68"
05/19/2024,54663,,16554,Terminal SE - Transferencia TPV,"61403,99",0,"-107436870,69"
05/20/2024,54700,,,Terminal SE - Transferencia TPV,0,5223710,"-112660580,69"
05/22/2024,55039,,16652,Terminal SE - Transferencia TPV,"61800,01",0,"-112598780,68"
05/22/2024,55040,,16653,Terminal SE - Transferencia TPV,82163,0,"-112516617,68"
05/22/2024,55041,,16655,Terminal SE - Transferencia TPV,86000,0,"-112430617,68"
05/22/2024,55042,,16673,Terminal SE - Transferencia TPV,105000,0,"-112325617,68"
05/23/2024,55217,,16718,Terminal SE - Transferencia TPV,"218300,01",0,"-112107317,67"
05/23/2024,55043,,,Terminal SE - Transferencia TPV,0,334963,"-112442280,67"
05/23/2024,55218,,16719,Terminal SE - Transferencia TPV,81900,0,"-112360380,67"
05/23/2024,55211,,16689,Terminal SE - Transferencia TPV,70800,0,"-112289580,67"
05/23/2024,55212,,16691,Terminal SE - Transferencia TPV,"139000,01",0,"-112150580,66"
05/23/2024,55213,,16692,Terminal SE - Transferencia TPV,"77792,99",0,"-112072787,67"
05/23/2024,55214,,16694,Terminal SE - Transferencia TPV,168095,0,"-111904692,67"
05/23/2024,55215,,16701,Terminal SE - Transferencia TPV,83000,0,"-111821692,67"
05/23/2024,55216,,16706,Terminal SE - Transferencia TPV,"88000,01",0,"-111733692,66"
05/24/2024,55500,,16772,Terminal SE - Transferencia TPV,72500,0,"-111661192,66"
05/24/2024,55501,,16773,Terminal SE - Transferencia TPV,66976,0,"-111594216,66"
05/24/2024,55502,,16790,Terminal SE - Transferencia TPV,87735,0,"-111506481,66"
05/24/2024,55503,,16791,Terminal SE - Transferencia TPV,89483,0,"-111416998,66"
05/24/2024,55504,,16794,Terminal SE - Transferencia TPV,10000,0,"-111406998,66"
05/24/2024,55219,,,Terminal SE - Transferencia TPV,0,926888,"-112333886,66"
05/24/2024,55505,,16796,Terminal SE - Transferencia TPV,"107401,99",0,"-112226484,67"
05/24/2024,55493,,16741,Terminal SE - Transferencia TPV,"110000,01",0,"-112116484,66"
05/24/2024,55494,,16745,Terminal SE - Transferencia TPV,"81999,99",0,"-112034484,67"
05/24/2024,55495,,16746,Terminal SE - Transferencia TPV,62000,0,"-111972484,67"
05/24/2024,55496,,16747,Terminal SE - Transferencia TPV,"63000,01",0,"-111909484,66"
05/24/2024,55497,,16748,Terminal SE - Transferencia TPV,"91999,99",0,"-111817484,67"
05/24/2024,55498,,16759,Terminal SE - Transferencia TPV,62000,0,"-111755484,67"
05/24/2024,55499,,16770,Terminal SE - Transferencia TPV,67522,0,"-111687962,67"
05/25/2024,56007,,16853,Terminal SE - Transferencia TPV,"157879,99",0,"-111530082,68"
05/25/2024,56022,,16892,Terminal SE - Transferencia TPV,123681,0,"-111406401,68"
05/25/2024,56019,,16882,Terminal SE - Transferencia TPV,"237911,99",0,"-111168489,69"
05/25/2024,56003,,16845,Terminal SE - Transferencia TPV,71674,0,"-111096815,69"
05/25/2024,56020,,16883,Terminal SE - Transferencia TPV,"96912,99",0,"-110999902,7"
05/25/2024,56000,,16831,Terminal SE - Transferencia TPV,70850,0,"-110929052,7"
05/25/2024,56009,,16856,Terminal SE - Transferencia TPV,117000,0,"-110812052,7"
05/25/2024,56005,,16849,Terminal SE - Transferencia TPV,64463,0,"-110747589,7"
05/25/2024,56008,,16855,Terminal SE - Transferencia TPV,77300,0,"-110670289,7"
05/25/2024,55999,,16830,Terminal SE - Transferencia TPV,62000,0,"-110608289,7"
05/25/2024,55995,,16818,Terminal SE - Transferencia TPV,102048,0,"-110506241,7"
05/25/2024,56017,,16880,Terminal SE - Transferencia TPV,"82162,99",0,"-110424078,71"
05/25/2024,56001,,16832,Terminal SE - Transferencia TPV,69000,0,"-110355078,71"
05/25/2024,56004,,16847,Terminal SE - Transferencia TPV,87353,0,"-110267725,71"
05/25/2024,56018,,16881,Terminal SE - Transferencia TPV,54000,0,"-110213725,71"
05/25/2024,56013,,16873,Terminal SE - Transferencia TPV,63500,0,"-110150225,71"
05/25/2024,56012,,16872,Terminal SE - Transferencia TPV,213984,0,"-109936241,71"
05/25/2024,55506,,,Terminal SE - Transferencia TPV,0,972617,"-110908858,71"
05/25/2024,56015,,16878,Terminal SE - Transferencia TPV,"64999,99",0,"-110843858,72"
05/25/2024,55997,,16828,Terminal SE - Transferencia TPV,"106636,99",0,"-110737221,73"
05/25/2024,56010,,16861,Terminal SE - Transferencia TPV,"177436,99",0,"-110559784,74"
05/25/2024,56002,,16834,Terminal SE - Transferencia TPV,"99426,01",0,"-110460358,73"
05/25/2024,55998,,16829,Terminal SE - Transferencia TPV,149900,0,"-110310458,73"
05/25/2024,56016,,16879,Terminal SE - Transferencia TPV,"188908,99",0,"-110121549,74"
05/25/2024,56006,,16852,Terminal SE - Transferencia TPV,"232503,98",0,"-109889045,76"
05/25/2024,55996,,16820,Terminal SE - Transferencia TPV,52000,0,"-109837045,76"
05/25/2024,56011,,16865,Terminal SE - Transferencia TPV,133351,0,"-109703694,76"
05/25/2024,56021,,16889,Terminal SE - Transferencia TPV,"100081,01",0,"-109603613,75"
05/25/2024,56014,,16874,Terminal SE - Transferencia TPV,85500,0,"-109518113,75"
05/26/2024,56522,,16929,Terminal SE - Transferencia TPV,79000,0,"-109439113,75"
05/26/2024,56532,,16950,Terminal SE - Transferencia TPV,"202566,98",0,"-109236546,77"
05/26/2024,56517,,16921,Terminal SE - Transferencia TPV,438840,0,"-108797706,77"
05/26/2024,56542,,16978,Terminal SE - Transferencia TPV,144168,0,"-108653538,77"
05/26/2024,56508,,16905,Terminal SE - Transferencia TPV,71000,0,"-108582538,77"
05/26/2024,56023,,,Terminal SE - Transferencia TPV,0,3142692,"-111725230,77"
05/26/2024,56538,,16970,Terminal SE - Transferencia TPV,"98551,99",0,"-111626678,78"
05/26/2024,56524,,16934,Terminal SE - Transferencia TPV,92433,0,"-111534245,78"
05/26/2024,56516,,16920,Terminal SE - Transferencia TPV,"161550,01",0,"-111372695,77"
05/26/2024,56521,,16925,Terminal SE - Transferencia TPV,114394,0,"-111258301,77"
05/26/2024,56540,,16973,Terminal SE - Transferencia TPV,68000,0,"-111190301,77"
05/26/2024,56543,,16979,Terminal SE - Transferencia TPV,78448,0,"-111111853,77"
05/26/2024,56512,,16911,Terminal SE - Transferencia TPV,"246215,99",0,"-110865637,78"
05/26/2024,56526,,16936,Terminal SE - Transferencia TPV,"261893,99",0,"-110603743,79"
05/26/2024,56527,,16940,Terminal SE - Transferencia TPV,111800,0,"-110491943,79"
05/26/2024,56536,,16959,Terminal SE - Transferencia TPV,3200,0,"-110488743,79"
05/26/2024,56539,,16972,Terminal SE - Transferencia TPV,198000,0,"-110290743,79"
05/26/2024,56518,,16922,Terminal SE - Transferencia TPV,60500,0,"-110230243,79"
05/26/2024,56528,,16945,Terminal SE - Transferencia TPV,73000,0,"-110157243,79"
05/26/2024,56523,,16930,Terminal SE - Transferencia TPV,105763,0,"-110051480,79"
05/26/2024,56513,,16913,Terminal SE - Transferencia TPV,"174213,98",0,"-109877266,81"
05/26/2024,56531,,16949,Terminal SE - Transferencia TPV,154820,0,"-109722446,81"
05/26/2024,56530,,16948,Terminal SE - Transferencia TPV,"362500,99",0,"-109359945,82"
05/26/2024,56520,,16924,Terminal SE - Transferencia TPV,90139,0,"-109269806,82"
05/26/2024,56514,,16914,Terminal SE - Transferencia TPV,"225838,99",0,"-109043967,83"
05/26/2024,56515,,16919,Terminal SE - Transferencia TPV,79158,0,"-108964809,83"
05/26/2024,56537,,16965,Terminal SE - Transferencia TPV,"54900,01",0,"-108909909,82"
05/26/2024,56519,,16923,Terminal SE - Transferencia TPV,160010,0,"-108749899,82"
05/26/2024,56529,,16946,Terminal SE - Transferencia TPV,197104,0,"-108552795,82"
05/26/2024,56525,,16935,Terminal SE - Transferencia TPV,124610,0,"-108428185,82"
05/26/2024,56541,,16975,Terminal SE - Transferencia TPV,67500,0,"-108360685,82"
05/26/2024,56511,,16910,Terminal SE - Transferencia TPV,"75000,01",0,"-108285685,81"
05/26/2024,56510,,16908,Terminal SE - Transferencia TPV,65000,0,"-108220685,81"
05/26/2024,56509,,16906,Terminal SE - Transferencia TPV,129581,0,"-108091104,81"
05/26/2024,56533,,16951,Terminal SE - Transferencia TPV,58000,0,"-108033104,81"
05/26/2024,56535,,16958,Terminal SE - Transferencia TPV,"89999,99",0,"-107943104,82"
05/26/2024,56534,,16958,Terminal SE - Transferencia TPV,90000,0,"-107853104,82"
05/27/2024,56544,,,Terminal SE - Transferencia TPV,0,4807720,"-112660824,82"
05/29/2024,56661,,17000,Terminal SE - Transferencia TPV,72657,0,"-112588167,82"
05/29/2024,56660,,16991,Terminal SE - Transferencia TPV,122000,0,"-112466167,82"
05/30/2024,56861,,17013,Terminal SE - Transferencia TPV,"119000,01",0,"-112347167,81"
05/30/2024,56863,,17046,Terminal SE - Transferencia TPV,10000,0,"-112337167,81"
05/30/2024,56864,,17053,Terminal SE - Transferencia TPV,"106418,99",0,"-112230748,82"
05/30/2024,56862,,17045,Terminal SE - Transferencia TPV,189000,0,"-112041748,82"
05/30/2024,56860,,17011,Terminal SE - Transferencia TPV,"137000,01",0,"-111904748,81"
05/30/2024,56662,,,Terminal SE - Transferencia TPV,0,194657,"-112099405,81"
05/31/2024,57388,,17124,Terminal SE - Transferencia TPV,"166510,99",0,"-111932894,82"
05/31/2024,57389,,17132,Terminal SE - Transferencia TPV,"66999,99",0,"-111865894,83"
05/31/2024,57375,,17073,Terminal SE - Transferencia TPV,"88827,99",0,"-111777066,84"
05/31/2024,57381,,17094,Terminal SE - Transferencia TPV,34800,0,"-111742266,84"
05/31/2024,57382,,17094,Terminal SE - Transferencia TPV,166000,0,"-111576266,84"
05/31/2024,57395,,17147,Terminal SE - Transferencia TPV,30000,0,"-111546266,84"
05/31/2024,57396,,17147,Terminal SE - Transferencia TPV,78500,0,"-111467766,84"
05/31/2024,57387,,17119,Terminal SE - Transferencia TPV,"87500,01",0,"-111380266,83"
05/31/2024,57392,,17136,Terminal SE - Transferencia TPV,"191203,99",0,"-111189062,84"
05/31/2024,57391,,17134,Terminal SE - Transferencia TPV,"82600,01",0,"-111106462,83"
05/31/2024,57377,,17079,Terminal SE - Transferencia TPV,"63000,01",0,"-111043462,82"
05/31/2024,57376,,17078,Terminal SE - Transferencia TPV,80524,0,"-110962938,82"
05/31/2024,57374,,17065,Terminal SE - Transferencia TPV,61800,0,"-110901138,82"
05/31/2024,57380,,17089,Terminal SE - Transferencia TPV,"125429,99",0,"-110775708,83"
05/31/2024,57383,,17098,Terminal SE - Transferencia TPV,91559,0,"-110684149,83"
05/31/2024,57390,,17133,Terminal SE - Transferencia TPV,"61999,99",0,"-110622149,84"
05/31/2024,57384,,17099,Terminal SE - Transferencia TPV,"71783,01",0,"-110550366,83"
05/31/2024,57385,,17101,Terminal SE - Transferencia TPV,82709,0,"-110467657,83"
05/31/2024,57386,,17111,Terminal SE - Transferencia TPV,146000,0,"-110321657,83"
05/31/2024,57398,,17157,Terminal SE - Transferencia TPV,176352,0,"-110145305,83"
05/31/2024,57397,,17156,Terminal SE - Transferencia TPV,"215240,99",0,"-109930064,84"
05/31/2024,57394,,17146,Terminal SE - Transferencia TPV,89429,0,"-109840635,84"
05/31/2024,57379,,17084,Terminal SE - Transferencia TPV,114850,0,"-109725785,84"
05/31/2024,57373,,17063,Terminal SE - Transferencia TPV,127000,0,"-109598785,84"
05/31/2024,56865,,,Terminal SE - Transferencia TPV,0,561418,"-110160203,84"
05/31/2024,57378,,17082,Terminal SE - Transferencia TPV,"195081,99",0,"-109965121,85"
05/31/2024,57393,,17139,Terminal SE - Transferencia TPV,9500,0,"-109955621,85"
