FECHA,N° DOC,TERCERO,DESCRIPCIÓN,ORIGEN,DEBITO,CREDITO,SALDO
01/04/2024,12179,,9212,Terminal SE - Efectivo TPV,50000,0,"8132,44"
01/04/2024,12177,,9198,Terminal SE - Efectivo TPV,85400,0,"93532,44"
01/04/2024,12180,,9221,Terminal SE - Efectivo TPV,"70950,01",0,"164482,45"
01/04/2024,12181,,9228,Terminal SE - Efectivo TPV,"144999,99",0,"309482,44"
01/04/2024,12178,,9200,Terminal SE - Efectivo TPV,140000,0,"449482,44"
01/04/2024,12182,,9251,Terminal SE - Efectivo TPV,"109000,02",0,"558482,46"
01/05/2024,12679,,9280,Terminal SE - Efectivo TPV,"46000,01",0,"604482,47"
01/05/2024,12784,,9312,Terminal LS - Efectivo TPV,72050,0,"676532,47"
01/05/2024,12680,,9285,Terminal SE - Efectivo TPV,"175650,01",0,"852182,48"
01/05/2024,12681,,9287,Terminal SE - Efectivo TPV,6800,0,"858982,48"
01/05/2024,12682,,9288,Terminal SE - Efectivo TPV,38060,0,"897042,48"
01/05/2024,12683,,9289,Terminal SE - Efectivo TPV,74470,0,"971512,48"
01/05/2024,12183,,,Terminal SE - Efectivo TPV,600450,0,"1571962,48"
01/05/2024,12183,,,Terminal SE - Efectivo TPV,0,600450,"971512,48"
01/05/2024,12684,,9290,Terminal SE - Efectivo TPV,"63800,01",0,"1035312,49"
01/05/2024,12685,,9301,Terminal SE - Efectivo TPV,99220,0,"1134532,49"
01/05/2024,12686,,9304,Terminal SE - Efectivo TPV,"64900,01",0,"1199432,5"
01/05/2024,12687,,9329,Terminal SE - Efectivo TPV,83952,0,"1283384,5"
01/05/2024,12778,,9277,Terminal LS - Efectivo TPV,50500,0,"1333884,5"
01/05/2024,12688,,9337,Terminal SE - Efectivo TPV,49000,0,"1382884,5"
01/05/2024,12785,,9316,Terminal LS - Efectivo TPV,91000,0,"1473884,5"
01/05/2024,12779,,9279,Terminal LS - Efectivo TPV,"62700,01",0,"1536584,51"
01/05/2024,12676,,9270,Terminal SE - Efectivo TPV,186300,0,"1722884,51"
01/05/2024,12677,,9275,Terminal SE - Efectivo TPV,"144430,01",0,"1867314,52"
01/05/2024,12678,,9276,Terminal SE - Efectivo TPV,56000,0,"1923314,52"
01/05/2024,12787,,9333,Terminal LS - Efectivo TPV,6800,0,"1930114,52"
01/05/2024,12781,,9286,Terminal LS - Efectivo TPV,52000,0,"1982114,52"
01/05/2024,12788,,9336,Terminal LS - Efectivo TPV,185900,0,"2168014,52"
01/05/2024,12782,,9299,Terminal LS - Efectivo TPV,75500,0,"2243514,52"
01/05/2024,12780,,9284,Terminal LS - Efectivo TPV,73546,0,"2317060,52"
01/05/2024,12786,,9326,Terminal LS - Efectivo TPV,71500,0,"2388560,52"
01/05/2024,12777,,9268,Terminal LS - Efectivo TPV,"12000,99",0,"2400561,51"
01/05/2024,12783,,9308,Terminal LS - Efectivo TPV,76010,0,"2476571,51"
01/05/2024,12789,,9341,Terminal LS - Efectivo TPV,192830,0,"2669401,51"
01/06/2024,13454,,9460,Terminal SE - Efectivo TPV,"235059,01",0,"2904460,52"
01/06/2024,13446,,9423,Terminal SE - Efectivo TPV,108000,0,"3012460,52"
01/06/2024,13432,,9366,Terminal SE - Efectivo TPV,112000,0,"3124460,52"
01/06/2024,13455,,9478,Terminal SE - Efectivo TPV,90200,0,"3214660,52"
01/06/2024,13434,,9372,Terminal SE - Efectivo TPV,59000,0,"3273660,52"
01/06/2024,13449,,9434,Terminal SE - Efectivo TPV,"67210,01",0,"3340870,53"
01/06/2024,13440,,9385,Terminal SE - Efectivo TPV,"158400,02",0,"3499270,55"
01/06/2024,12689,,,Terminal SE - Efectivo TPV,1089500,0,"4588770,55"
01/06/2024,12689,,,Terminal SE - Efectivo TPV,0,1089500,"3499270,55"
01/06/2024,13437,,9379,Terminal SE - Efectivo TPV,239318,0,"3696708,55"
01/06/2024,13451,,9442,Terminal SE - Efectivo TPV,41000,0,"3737708,55"
01/06/2024,13456,,9489,Terminal SE - Efectivo TPV,"215270,02",0,"3952978,57"
01/06/2024,13438,,9380,Terminal SE - Efectivo TPV,43500,0,"3996478,57"
01/06/2024,13439,,9384,Terminal SE - Efectivo TPV,123752,0,"4120230,57"
01/06/2024,13436,,9376,Terminal SE - Efectivo TPV,"148280,01",0,"4268510,58"
01/06/2024,13430,,9362,Terminal SE - Efectivo TPV,61600,0,"4330110,58"
01/06/2024,13433,,9367,Terminal SE - Efectivo TPV,"89100,02",0,"4419210,6"
01/06/2024,13450,,9441,Terminal SE - Efectivo TPV,"69300,01",0,"4488510,61"
01/06/2024,13431,,9365,Terminal SE - Efectivo TPV,"233530,02",0,"4722040,63"
01/06/2024,13447,,9426,Terminal SE - Efectivo TPV,76000,0,"4798040,63"
01/06/2024,13453,,9458,Terminal SE - Efectivo TPV,52500,0,"4850540,63"
01/06/2024,13443,,9395,Terminal SE - Efectivo TPV,"122859,99",0,"4973400,62"
01/06/2024,13441,,9386,Terminal SE - Efectivo TPV,71896,0,"5045296,62"
01/06/2024,13442,,9393,Terminal SE - Efectivo TPV,162550,0,"5207846,62"
01/06/2024,13445,,9399,Terminal SE - Efectivo TPV,128150,0,"5335996,62"
01/06/2024,13448,,9427,Terminal SE - Efectivo TPV,"71240,02",0,"5407236,64"
01/06/2024,13435,,9373,Terminal SE - Efectivo TPV,"69960,01",0,"5477196,65"
01/06/2024,13452,,9451,Terminal SE - Efectivo TPV,62370,0,"5539566,65"
01/06/2024,13444,,9396,Terminal SE - Efectivo TPV,"49999,99",0,"5503078,91"
01/07/2024,14304,,9599,Terminal SE - Efectivo TPV,81200,0,"5584278,91"
01/07/2024,14294,,9560,Terminal SE - Efectivo TPV,"68500,01",0,"5652778,92"
01/07/2024,14288,,9533,Terminal SE - Efectivo TPV,55000,0,"5707778,92"
01/07/2024,14285,,9523,Terminal SE - Efectivo TPV,"155100,02",0,"5862878,94"
01/07/2024,14297,,9571,Terminal SE - Efectivo TPV,98450,0,"5961328,94"
01/07/2024,14293,,9557,Terminal SE - Efectivo TPV,"160490,01",0,"6121818,95"
01/07/2024,14299,,9586,Terminal SE - Efectivo TPV,38250,0,"6160068,95"
01/07/2024,14281,,9512,Terminal SE - Efectivo TPV,"287800,01",0,"6447868,96"
01/07/2024,14282,,9517,Terminal SE - Efectivo TPV,3700,0,"6451568,96"
01/07/2024,14292,,9556,Terminal SE - Efectivo TPV,"86324,01",0,"6537892,97"
01/07/2024,14284,,9521,Terminal SE - Efectivo TPV,168934,0,"6706826,97"
01/07/2024,14306,,9613,Terminal SE - Efectivo TPV,"93170,01",0,"6799996,98"
01/07/2024,14312,,9638,Terminal SE - Efectivo TPV,"228030,01",0,"7028026,99"
01/07/2024,14289,,9535,Terminal SE - Efectivo TPV,"77330,01",0,7105357
01/07/2024,14300,,9588,Terminal SE - Efectivo TPV,108338,0,7213695
01/07/2024,14307,,9616,Terminal SE - Efectivo TPV,83820,0,7297515
01/07/2024,14309,,9626,Terminal SE - Efectivo TPV,123420,0,7420935
01/07/2024,14296,,9564,Terminal SE - Efectivo TPV,"151514,01",0,"7572449,01"
01/07/2024,14302,,9594,Terminal SE - Efectivo TPV,169950,0,"7742399,01"
01/07/2024,14290,,9549,Terminal SE - Efectivo TPV,"110999,99",0,7853399
01/07/2024,14280,,9502,Terminal SE - Efectivo TPV,68200,0,7921599
01/07/2024,14310,,9634,Terminal SE - Efectivo TPV,"98000,01",0,"7875513,37"
01/07/2024,14287,,9532,Terminal SE - Efectivo TPV,157137,0,"8032650,37"
01/07/2024,13457,,,Terminal SE - Efectivo TPV,2962100,0,"10994750,37"
01/07/2024,13457,,,Terminal SE - Efectivo TPV,0,2962100,"8032650,37"
01/07/2024,14303,,9597,Terminal SE - Efectivo TPV,"12529,99",0,"8045180,36"
01/07/2024,14308,,9617,Terminal SE - Efectivo TPV,200000,0,"8245180,36"
01/07/2024,14283,,9519,Terminal SE - Efectivo TPV,"181170,01",0,"8426350,37"
01/07/2024,14291,,9550,Terminal SE - Efectivo TPV,122927,0,"8549277,37"
01/07/2024,14301,,9590,Terminal SE - Efectivo TPV,"90750,01",0,"8640027,38"
01/07/2024,14305,,9604,Terminal SE - Efectivo TPV,"92400,01",0,"8732427,39"
01/07/2024,14311,,9635,Terminal SE - Efectivo TPV,57000,0,"8789427,39"
01/07/2024,14298,,9572,Terminal SE - Efectivo TPV,"57400,01",0,"8846827,4"
01/07/2024,14295,,9563,Terminal SE - Efectivo TPV,59950,0,"8906777,4"
01/07/2024,14286,,9528,Terminal SE - Efectivo TPV,7650,0,"8914427,4"
01/08/2024,14858,,9696,Terminal SE - Efectivo TPV,115500,0,"9029927,4"
01/08/2024,14314,,,Terminal SE - Efectivo TPV,0,"465302,13","8564625,27"
01/08/2024,14313,,,Terminal SE - Efectivo TPV,3567000,0,"12131625,27"
01/08/2024,14850,,9665,Terminal SE - Efectivo TPV,237710,0,"12369335,27"
01/08/2024,14852,,9672,Terminal SE - Efectivo TPV,"15600,01",0,"12384935,28"
01/08/2024,14856,,9690,Terminal SE - Efectivo TPV,"52500,01",0,"12437435,29"
01/08/2024,14857,,9693,Terminal SE - Efectivo TPV,"91696,01",0,"12529131,3"
01/08/2024,14849,,9657,Terminal SE - Efectivo TPV,224400,0,"12753531,3"
01/08/2024,14851,,9670,Terminal SE - Efectivo TPV,327690,0,"13081221,3"
01/08/2024,14847,,9651,Terminal SE - Efectivo TPV,"121950,01",0,"13203171,31"
01/08/2024,14859,,9697,Terminal SE - Efectivo TPV,"73499,99",0,"13276671,3"
01/08/2024,14854,,9685,Terminal SE - Efectivo TPV,"59400,01",0,"13336071,31"
01/08/2024,14855,,9689,Terminal SE - Efectivo TPV,116050,0,"13368261,24"
01/08/2024,14860,,9718,Terminal SE - Efectivo TPV,68750,0,"13437011,24"
01/08/2024,14853,,9675,Terminal SE - Efectivo TPV,"207020,01",0,"13642031,25"
01/08/2024,14313,,,Terminal SE - Efectivo TPV,0,3567000,"10075031,25"
01/09/2024,14861,,,Terminal SE - Efectivo TPV,0,2021300,"8053731,25"
01/09/2024,14861,,,Terminal SE - Efectivo TPV,2021300,0,"6375031,25"
01/11/2024,15550,,9836,Terminal SE - Efectivo TPV,"95259,99",0,"6419791,21"
01/11/2024,15547,,9816,Terminal SE - Efectivo TPV,"105929,99",0,"6525721,2"
01/11/2024,15546,,9804,Terminal SE - Efectivo TPV,95000,0,"6620721,2"
01/11/2024,15548,,9820,Terminal SE - Efectivo TPV,7600,0,"6628321,2"
01/11/2024,15545,,9799,Terminal SE - Efectivo TPV,"99440,01",0,"6727761,21"
01/11/2024,15549,,9821,Terminal SE - Efectivo TPV,135300,0,"6863061,21"
01/12/2024,15551,,,Terminal SE - Efectivo TPV,0,538600,"6324461,21"
01/12/2024,15932,,9849,Terminal SE - Efectivo TPV,22800,0,"6347261,21"
01/12/2024,15933,,9852,Terminal SE - Efectivo TPV,95150,0,"6442411,21"
01/12/2024,15934,,9853,Terminal SE - Efectivo TPV,80000,0,"6522411,21"
01/12/2024,15935,,9855,Terminal SE - Efectivo TPV,"76800,01",0,"6599211,22"
01/12/2024,15938,,9874,Terminal SE - Efectivo TPV,"139919,99",0,"6739131,21"
01/12/2024,15551,,,Terminal SE - Efectivo TPV,538600,0,"7277731,21"
01/12/2024,15939,,9896,Terminal SE - Efectivo TPV,98780,0,"7376511,21"
01/12/2024,15940,,9899,Terminal SE - Efectivo TPV,8000,0,"7384511,21"
01/12/2024,15941,,9900,Terminal SE - Efectivo TPV,"118999,99",0,"7503511,2"
01/12/2024,15937,,9870,Terminal SE - Efectivo TPV,"223300,01",0,"7726811,21"
01/12/2024,15936,,9859,Terminal SE - Efectivo TPV,20000,0,"7746811,21"
01/13/2024,16639,,9965,Terminal SE - Efectivo TPV,81081,0,"7827892,21"
01/13/2024,16634,,9938,Terminal SE - Efectivo TPV,"197669,99",0,"8025562,2"
01/13/2024,16640,,9975,Terminal SE - Efectivo TPV,128370,0,"8153932,2"
01/13/2024,16641,,9990,Terminal SE - Efectivo TPV,60000,0,"8213932,2"
01/13/2024,16638,,9960,Terminal SE - Efectivo TPV,"211719,99",0,"8425652,19"
01/13/2024,16633,,9933,Terminal SE - Efectivo TPV,222000,0,"8647652,19"
01/13/2024,16647,,10014,Terminal SE - Efectivo TPV,"62799,99",0,"8710452,18"
01/13/2024,16651,,10034,Terminal SE - Efectivo TPV,86900,0,"8797352,18"
01/13/2024,16644,,9998,Terminal SE - Efectivo TPV,85800,0,"8883152,18"
01/13/2024,16643,,9996,Terminal SE - Efectivo TPV,60500,0,"8943652,18"
01/13/2024,16646,,10011,Terminal SE - Efectivo TPV,"71499,99",0,"9015152,17"
01/13/2024,16645,,10000,Terminal SE - Efectivo TPV,222090,0,"9237242,17"
01/13/2024,16649,,10022,Terminal SE - Efectivo TPV,"170610,01",0,"9407852,18"
01/13/2024,16636,,9947,Terminal SE - Efectivo TPV,"395889,98",0,"9803742,16"
01/13/2024,16637,,9950,Terminal SE - Efectivo TPV,75350,0,"9879092,16"
01/13/2024,16632,,9932,Terminal SE - Efectivo TPV,111980,0,"9991072,16"
01/13/2024,16650,,10030,Terminal SE - Efectivo TPV,"88620,24",0,"10079692,4"
01/13/2024,16642,,9995,Terminal SE - Efectivo TPV,"110549,99",0,"10190242,39"
01/13/2024,16635,,9939,Terminal SE - Efectivo TPV,82830,0,"10273072,39"
01/13/2024,16652,,10041,Terminal SE - Efectivo TPV,155760,0,"10428832,39"
01/13/2024,16648,,10016,Terminal SE - Efectivo TPV,104830,0,"10533662,39"
01/13/2024,15942,,,Terminal SE - Efectivo TPV,883750,0,"11417412,39"
01/13/2024,15942,,,Terminal SE - Efectivo TPV,0,883750,"10533662,39"
01/14/2024,17308,,10135,Terminal SE - Efectivo TPV,"37296,99",0,"10450946,36"
01/14/2024,17292,,10084,Terminal SE - Efectivo TPV,6880,0,"10457826,36"
01/14/2024,17306,,10119,Terminal SE - Efectivo TPV,90200,0,"10548026,36"
01/14/2024,17307,,10123,Terminal SE - Efectivo TPV,18000,0,"10566026,36"
01/14/2024,17291,,10082,Terminal SE - Efectivo TPV,252450,0,"10818476,36"
01/14/2024,17310,,10149,Terminal SE - Efectivo TPV,171000,0,"10989476,36"
01/14/2024,17289,,10068,Terminal SE - Efectivo TPV,78540,0,"11068016,36"
01/14/2024,17305,,10114,Terminal SE - Efectivo TPV,"218240,23",0,"11286256,59"
01/14/2024,17290,,10080,Terminal SE - Efectivo TPV,85910,0,"11372166,59"
01/14/2024,17301,,10108,Terminal SE - Efectivo TPV,81180,0,"11453346,59"
01/14/2024,16653,,,Terminal SE - Efectivo TPV,2785900,0,"14239246,59"
01/14/2024,16653,,,Terminal SE - Efectivo TPV,0,2785900,"11453346,59"
01/14/2024,17302,,10109,Terminal SE - Efectivo TPV,44000,0,"11497346,59"
01/14/2024,17286,,10057,Terminal SE - Efectivo TPV,149380,0,"11646726,59"
01/14/2024,17287,,10060,Terminal SE - Efectivo TPV,76700,0,"11723426,59"
01/14/2024,17304,,10113,Terminal SE - Efectivo TPV,"84920,01",0,"11808346,6"
01/14/2024,17295,,10088,Terminal SE - Efectivo TPV,"83379,99",0,"11891726,59"
01/14/2024,17299,,10105,Terminal SE - Efectivo TPV,6000,0,"11897726,59"
01/14/2024,17296,,10090,Terminal SE - Efectivo TPV,167970,0,"12065696,59"
01/14/2024,17309,,10143,Terminal SE - Efectivo TPV,"78869,99",0,"12144566,58"
01/14/2024,17297,,10095,Terminal SE - Efectivo TPV,53000,0,"12197566,58"
01/14/2024,17300,,10106,Terminal SE - Efectivo TPV,296000,0,"12493566,58"
01/14/2024,17294,,10087,Terminal SE - Efectivo TPV,"109670,01",0,"12603236,59"
01/14/2024,17285,,10054,Terminal SE - Efectivo TPV,"98669,98",0,"12701906,57"
01/14/2024,17303,,10111,Terminal SE - Efectivo TPV,31000,0,"12732906,57"
01/14/2024,17288,,10061,Terminal SE - Efectivo TPV,"93719,99",0,"12826626,56"
01/14/2024,17293,,10085,Terminal SE - Efectivo TPV,"250249,99",0,"13076876,55"
01/14/2024,17298,,10104,Terminal SE - Efectivo TPV,51000,0,"13127876,55"
01/15/2024,17311,,,Terminal SE - Efectivo TPV,0,2714300,"10413576,55"
01/15/2024,17311,,,Terminal SE - Efectivo TPV,2714300,0,"13127876,55"
01/19/2024,18225,,10288,Terminal SE - Efectivo TPV,74500,0,"12917476,55"
01/19/2024,18221,,10244,Terminal SE - Efectivo TPV,"105820,01",0,"13023296,56"
01/19/2024,18222,,10269,Terminal SE - Efectivo TPV,102300,0,"13125596,56"
01/19/2024,18223,,10282,Terminal SE - Efectivo TPV,95150,0,"13220746,56"
01/19/2024,18224,,10283,Terminal SE - Efectivo TPV,"107030,01",0,"13327776,57"
01/19/2024,18226,,10291,Terminal SE - Efectivo TPV,"183920,01",0,"13511696,58"
01/19/2024,18385,,10313,Terminal LS - Tarjeta TPV,111430,0,"13623126,58"
01/19/2024,18387,,10318,Terminal LS - Tarjeta TPV,"581679,99",0,"14204806,57"
01/19/2024,18389,,10321,Terminal LS - Tarjeta TPV,"181059,99",0,"14385866,56"
01/19/2024,18388,,10319,Terminal LS - Tarjeta TPV,"89869,99",0,"14475736,55"
01/19/2024,18386,,10316,Terminal LS - Tarjeta TPV,186200,0,"14661936,55"
01/19/2024,18227,,10299,Terminal SE - Efectivo TPV,"5999,99",0,"14667936,54"
01/20/2024,19208,,10357,Terminal SE - Efectivo TPV,176220,0,"14844156,54"
01/20/2024,19207,,10355,Terminal SE - Efectivo TPV,"191289,99",0,"15035446,53"
01/20/2024,19204,,10336,Terminal SE - Efectivo TPV,4640,0,"15040086,53"
01/20/2024,19219,,10423,Terminal SE - Efectivo TPV,75570,0,"15115656,53"
01/20/2024,19216,,10403,Terminal SE - Efectivo TPV,"63499,99",0,"15179156,52"
01/20/2024,19217,,10404,Terminal SE - Efectivo TPV,155870,0,"15335026,52"
01/20/2024,19220,,10429,Terminal SE - Efectivo TPV,"162469,99",0,"15497496,51"
01/20/2024,19205,,10339,Terminal SE - Efectivo TPV,174350,0,"15671846,51"
01/20/2024,19218,,10416,Terminal SE - Efectivo TPV,69000,0,"15740846,51"
01/20/2024,19227,,10467,Terminal SE - Efectivo TPV,11700,0,"15752546,51"
01/20/2024,19209,,10363,Terminal SE - Efectivo TPV,"125500,24",0,"15878046,75"
01/20/2024,18228,,,Terminal SE - Efectivo TPV,674800,0,"16038336,63"
01/20/2024,18228,,,Terminal SE - Efectivo TPV,0,674800,"15363536,63"
01/20/2024,19226,,10464,Terminal SE - Efectivo TPV,102850,0,"15466386,63"
01/20/2024,19214,,10391,Terminal SE - Efectivo TPV,"140139,99",0,"15606526,62"
01/20/2024,19212,,10376,Terminal SE - Efectivo TPV,"81599,99",0,"15688126,61"
01/20/2024,19203,,10334,Terminal SE - Efectivo TPV,346940,0,"16035066,61"
01/20/2024,19221,,10432,Terminal SE - Efectivo TPV,300000,0,"16335066,61"
01/20/2024,19223,,10450,Terminal SE - Efectivo TPV,"171719,99",0,"16506786,6"
01/20/2024,19224,,10458,Terminal SE - Efectivo TPV,"11319,99",0,"16518106,59"
01/20/2024,19211,,10367,Terminal SE - Efectivo TPV,62500,0,"16580606,59"
01/20/2024,19206,,10343,Terminal SE - Efectivo TPV,167310,0,"16747916,59"
01/20/2024,19213,,10388,Terminal SE - Efectivo TPV,60000,0,"16807916,59"
01/20/2024,19215,,10396,Terminal SE - Efectivo TPV,"47240,01",0,"16855156,6"
01/20/2024,19210,,10365,Terminal SE - Efectivo TPV,"58000,01",0,"16913156,61"
01/20/2024,19222,,10435,Terminal SE - Efectivo TPV,78100,0,"16991256,61"
01/20/2024,19225,,10460,Terminal SE - Efectivo TPV,"216149,99",0,"17207406,6"
01/21/2024,19784,,10482,Terminal SE - Efectivo TPV,"175449,98",0,"17382856,58"
01/21/2024,19788,,10500,Terminal SE - Efectivo TPV,"132219,99",0,"17515076,57"
01/21/2024,19786,,10489,Terminal SE - Efectivo TPV,"98009,99",0,"17613086,56"
01/21/2024,19790,,10507,Terminal SE - Efectivo TPV,129800,0,"17742886,56"
01/21/2024,19794,,10549,Terminal SE - Efectivo TPV,"96579,99",0,"17839466,55"
01/21/2024,19789,,10504,Terminal SE - Efectivo TPV,94710,0,"17934176,55"
01/21/2024,19785,,10484,Terminal SE - Efectivo TPV,"88109,99",0,"18022286,54"
01/21/2024,19793,,10541,Terminal SE - Efectivo TPV,73700,0,"18095986,54"
01/21/2024,19795,,10550,Terminal SE - Efectivo TPV,"95900,01",0,"18191886,55"
01/21/2024,19228,,,Terminal SE - Efectivo TPV,0,3053600,"15138286,55"
01/21/2024,19228,,,Terminal SE - Efectivo TPV,3053600,0,"18191886,55"
01/21/2024,19792,,10528,Terminal SE - Efectivo TPV,"90529,99",0,"18282416,54"
01/21/2024,19787,,10496,Terminal SE - Efectivo TPV,53387,0,"18335803,54"
01/21/2024,19791,,10513,Terminal SE - Efectivo TPV,88550,0,"18411653,54"
01/22/2024,19796,,,Terminal SE - Efectivo TPV,0,1217200,"17006453,54"
01/22/2024,19796,,,Terminal SE - Efectivo TPV,1217200,0,"18223653,54"
01/24/2024,20143,,10624,Terminal LS - Efectivo TPV,"50000,01",0,"18273653,55"
01/24/2024,20146,,10604,Terminal LS - Tarjeta TPV,"86899,99",0,"18360553,54"
01/24/2024,20137,,10605,Terminal LS - Efectivo TPV,34875,0,"18395428,54"
01/24/2024,20142,,10623,Terminal LS - Efectivo TPV,90530,0,"18485958,54"
01/24/2024,20138,,10608,Terminal LS - Efectivo TPV,"136399,99",0,"18622358,53"
01/24/2024,20148,,10606,Terminal LS - Tarjeta TPV,21300,0,"18643658,53"
01/24/2024,20150,,10610,Terminal LS - Tarjeta TPV,103730,0,"18747388,53"
01/24/2024,20145,,10603,Terminal LS - Tarjeta TPV,"95150,01",0,"18842538,54"
01/24/2024,20139,,10618,Terminal LS - Efectivo TPV,"104999,99",0,"18947538,53"
01/24/2024,20147,,10605,Terminal LS - Tarjeta TPV,48675,0,"18996213,53"
01/24/2024,20149,,10609,Terminal LS - Tarjeta TPV,"81620,01",0,"19077833,54"
01/24/2024,20141,,10622,Terminal LS - Efectivo TPV,"82169,99",0,"19160003,53"
01/24/2024,20140,,10620,Terminal LS - Efectivo TPV,"158729,99",0,"19318733,52"
01/25/2024,20383,,10638,Terminal SE - Efectivo TPV,146000,0,"19464733,52"
01/25/2024,20144,,,Terminal LS - Efectivo TPV,657750,0,"20122483,52"
01/25/2024,20144,,,Terminal LS - Efectivo TPV,0,657750,"19464733,52"
01/25/2024,20384,,10644,Terminal SE - Efectivo TPV,90357,0,"19471330,52"
01/25/2024,20386,,10662,Terminal SE - Efectivo TPV,95000,0,"19566330,52"
01/25/2024,20385,,10661,Terminal SE - Efectivo TPV,"71673,99",0,"19638004,51"
01/25/2024,20381,,10632,Terminal SE - Efectivo TPV,90685,0,"19728689,51"
01/25/2024,20382,,10633,Terminal SE - Efectivo TPV,105000,0,"19833689,51"
01/26/2024,20867,,10760,Terminal LS - Tarjeta TPV,88500,0,"19922189,51"
01/26/2024,20762,,10741,Terminal SE - Efectivo TPV,68615,0,"19990804,51"
01/26/2024,20763,,10744,Terminal SE - Efectivo TPV,93635,0,"20084439,51"
01/26/2024,20759,,10715,Terminal SE - Efectivo TPV,7000,0,"20091439,51"
01/26/2024,20753,,10689,Terminal SE - Efectivo TPV,98006,0,"20189445,51"
01/26/2024,20754,,10691,Terminal SE - Efectivo TPV,"72700,01",0,"20262145,52"
01/26/2024,20755,,10692,Terminal SE - Efectivo TPV,49800,0,"20311945,52"
01/26/2024,20756,,10695,Terminal SE - Efectivo TPV,181807,0,"20493752,52"
01/26/2024,20757,,10708,Terminal SE - Efectivo TPV,68100,0,"20561852,52"
01/26/2024,20758,,10714,Terminal SE - Efectivo TPV,15000,0,"20576852,52"
01/26/2024,20760,,10720,Terminal SE - Efectivo TPV,"144999,99",0,"20721852,51"
01/26/2024,20761,,10730,Terminal SE - Efectivo TPV,"182299,98",0,"20904152,49"
01/26/2024,20764,,10747,Terminal SE - Efectivo TPV,"70000,01",0,"20974152,5"
01/26/2024,20765,,10748,Terminal SE - Efectivo TPV,83400,0,"21057552,5"
01/26/2024,20766,,10749,Terminal SE - Efectivo TPV,"75000,01",0,"21132552,51"
01/26/2024,20871,,10696,Terminal LS - Transferencia TPV,"173999,99",0,"21306552,5"
01/26/2024,20853,,10755,Terminal LS - Efectivo TPV,"251623,99",0,"21558176,49"
01/26/2024,20865,,10740,Terminal LS - Tarjeta TPV,"162795,99",0,"21720972,48"
01/26/2024,20856,,10686,Terminal LS - Tarjeta TPV,213930,0,"21934902,48"
01/26/2024,20849,,10729,Terminal LS - Efectivo TPV,179731,0,"22114633,48"
01/26/2024,20387,,,Terminal SE - Efectivo TPV,598900,0,"22069241,68"
01/26/2024,20387,,,Terminal SE - Efectivo TPV,0,598900,"21470341,68"
01/26/2024,20858,,10717,Terminal LS - Tarjeta TPV,81944,0,"21552285,68"
01/26/2024,20862,,10732,Terminal LS - Tarjeta TPV,83146,0,"21635431,68"
01/26/2024,20872,,10697,Terminal LS - Transferencia TPV,212837,0,"21848268,68"
01/26/2024,20861,,10731,Terminal LS - Tarjeta TPV,"77682,99",0,"21925951,67"
01/26/2024,20850,,10733,Terminal LS - Efectivo TPV,"99862,99",0,"22025814,66"
01/26/2024,20854,,10756,Terminal LS - Efectivo TPV,50000,0,"22075814,66"
01/26/2024,20874,,10701,Terminal LS - Transferencia TPV,"92323,99",0,"22168138,65"
01/26/2024,20848,,10727,Terminal LS - Efectivo TPV,114000,0,"22282138,65"
01/26/2024,20863,,10736,Terminal LS - Tarjeta TPV,"85003,99",0,"22367142,64"
01/26/2024,20868,,10761,Terminal LS - Tarjeta TPV,201037,0,"22568179,64"
01/26/2024,20857,,10716,Terminal LS - Tarjeta TPV,85222,0,"22653401,64"
01/26/2024,20852,,10751,Terminal LS - Efectivo TPV,"24692,99",0,"22678094,63"
01/26/2024,20864,,10739,Terminal LS - Tarjeta TPV,87517,0,"22765611,63"
01/26/2024,20851,,10742,Terminal LS - Efectivo TPV,100000,0,"22865611,63"
01/26/2024,20859,,10718,Terminal LS - Tarjeta TPV,"130345,98",0,"22995957,61"
01/26/2024,20860,,10728,Terminal LS - Tarjeta TPV,94000,0,"23089957,61"
01/26/2024,20866,,10759,Terminal LS - Tarjeta TPV,"73203,99",0,"23163161,6"
01/26/2024,20873,,10700,Terminal LS - Transferencia TPV,62500,0,"23225661,6"
01/26/2024,20870,,10694,Terminal LS - Transferencia TPV,56000,0,"23281661,6"
01/27/2024,21429,,10853,Terminal SE - Efectivo TPV,"235999,99",0,"23517661,59"
01/27/2024,21426,,10842,Terminal SE - Efectivo TPV,67522,0,"23585183,59"
01/27/2024,21430,,10868,Terminal SE - Efectivo TPV,"99862,99",0,"23685046,58"
01/27/2024,20855,,,Terminal LS - Efectivo TPV,1348300,0,"25033346,58"
01/27/2024,20767,,,Terminal SE - Efectivo TPV,1210400,0,"26243746,58"
01/27/2024,20855,,,Terminal LS - Efectivo TPV,0,1348300,"24895446,58"
01/27/2024,20869,,,Terminal LS - Tarjeta TPV,0,1464321,"23431125,58"
01/27/2024,20869,,,Terminal LS - Tarjeta TPV,1464321,0,"24895446,58"
01/27/2024,21423,,10802,Terminal SE - Efectivo TPV,29300,0,"24760260,26"
01/27/2024,21418,,10791,Terminal SE - Efectivo TPV,100000,0,"24860260,26"
01/27/2024,21428,,10852,Terminal SE - Efectivo TPV,"61999,99",0,"24922260,25"
01/27/2024,20767,,,Terminal SE - Efectivo TPV,0,1210400,"23711860,25"
01/27/2024,21420,,10794,Terminal SE - Efectivo TPV,83911,0,"23795771,25"
01/27/2024,21417,,10781,Terminal SE - Efectivo TPV,111335,0,"23907106,25"
01/27/2024,21431,,10873,Terminal SE - Efectivo TPV,184648,0,"24091754,25"
01/27/2024,21432,,10874,Terminal SE - Efectivo TPV,62500,0,"24154254,25"
01/27/2024,21414,,10772,Terminal SE - Efectivo TPV,"201999,98",0,"24356254,23"
01/27/2024,21419,,10793,Terminal SE - Efectivo TPV,98989,0,"24455243,23"
01/27/2024,21421,,10795,Terminal SE - Efectivo TPV,"58999,99",0,"24514243,22"
01/27/2024,21416,,10779,Terminal SE - Efectivo TPV,83000,0,"24597243,22"
01/27/2024,21433,,10882,Terminal SE - Efectivo TPV,69800,0,"24667043,22"
01/27/2024,21422,,10800,Terminal SE - Efectivo TPV,79213,0,"24746256,22"
01/27/2024,21424,,10815,Terminal SE - Efectivo TPV,"74077,99",0,"24820334,21"
01/27/2024,21425,,10821,Terminal SE - Efectivo TPV,"110460,99",0,"24930795,2"
01/27/2024,21427,,10851,Terminal SE - Efectivo TPV,217000,0,"25147795,2"
01/27/2024,21415,,10773,Terminal SE - Efectivo TPV,"239386,99",0,"25387182,19"
01/28/2024,22029,,10926,Terminal SE - Efectivo TPV,73204,0,"25460386,19"
01/28/2024,21434,,,Terminal SE - Efectivo TPV,2270000,0,"27730386,19"
01/28/2024,21434,,,Terminal SE - Efectivo TPV,0,2270000,"25460386,19"
01/28/2024,22037,,10950,Terminal SE - Efectivo TPV,"88718,99",0,"25549105,18"
01/28/2024,22040,,10969,Terminal SE - Efectivo TPV,168259,0,"25717364,18"
01/28/2024,22036,,10949,Terminal SE - Efectivo TPV,"233486,99",0,"25950851,17"
01/28/2024,22023,,10904,Terminal SE - Efectivo TPV,87080,0,"26037931,17"
01/28/2024,22041,,10972,Terminal SE - Efectivo TPV,57000,0,"26094931,17"
01/28/2024,22020,,10898,Terminal SE - Efectivo TPV,155694,0,"26250625,17"
01/28/2024,22021,,10899,Terminal SE - Efectivo TPV,121000,0,"26371625,17"
01/28/2024,22030,,10929,Terminal SE - Efectivo TPV,98880,0,"26470505,17"
01/28/2024,22032,,10940,Terminal SE - Efectivo TPV,"164300,24",0,"26634805,41"
01/28/2024,22033,,10943,Terminal SE - Efectivo TPV,"6185,01",0,"26640990,42"
01/28/2024,22022,,10901,Terminal SE - Efectivo TPV,"375312,98",0,"27016303,4"
01/28/2024,22026,,10922,Terminal SE - Efectivo TPV,"308832,01",0,"27325135,41"
01/28/2024,22034,,10944,Terminal SE - Efectivo TPV,125648,0,"27450783,41"
01/28/2024,22028,,10925,Terminal SE - Efectivo TPV,"98333,01",0,"27549116,42"
01/28/2024,22027,,10923,Terminal SE - Efectivo TPV,"76918,99",0,"27626035,41"
01/28/2024,22038,,10954,Terminal SE - Efectivo TPV,"133843,01",0,"27759878,42"
01/28/2024,22039,,10956,Terminal SE - Efectivo TPV,"154055,99",0,"27913934,41"
01/28/2024,22035,,10947,Terminal SE - Efectivo TPV,113302,0,"28027236,41"
01/28/2024,22031,,10935,Terminal SE - Efectivo TPV,75935,0,"28103171,41"
01/28/2024,22024,,10911,Terminal SE - Efectivo TPV,107620,0,"28210791,41"
01/28/2024,22025,,10912,Terminal SE - Efectivo TPV,4000,0,"28214791,41"
01/29/2024,22042,,,Terminal SE - Efectivo TPV,2827550,0,"31042341,41"
01/29/2024,22042,,,Terminal SE - Efectivo TPV,0,2827550,"28214791,41"
02/01/2024,22534,,11042,Terminal SE - Efectivo TPV,58500,0,"28273291,41"
02/01/2024,22535,,11057,Terminal SE - Efectivo TPV,131200,0,"28344611,41"
02/01/2024,22533,,11040,Terminal SE - Efectivo TPV,"33870,02",0,"28378481,43"
02/01/2024,22532,,11026,Terminal SE - Efectivo TPV,70472,0,"19488953,43"
02/02/2024,22952,,11117,Terminal SE - Efectivo TPV,64000,0,"19552953,43"
02/02/2024,22953,,11125,Terminal SE - Efectivo TPV,"249999,99",0,"19802953,42"
02/02/2024,22954,,11128,Terminal SE - Efectivo TPV,"201999,99",0,"20004953,41"
02/02/2024,22536,,,Terminal SE - Efectivo TPV,0,294100,"19710853,41"
02/02/2024,22536,,,Terminal SE - Efectivo TPV,294100,0,"20004953,41"
02/02/2024,22947,,11072,Terminal SE - Efectivo TPV,"110242,99",0,"20115196,4"
02/02/2024,22948,,11073,Terminal SE - Efectivo TPV,"170553,98",0,"20285750,38"
02/02/2024,22949,,11076,Terminal SE - Efectivo TPV,"128599,99",0,"20414350,37"
02/02/2024,22950,,11096,Terminal SE - Efectivo TPV,40046,0,"20454396,37"
02/02/2024,22951,,11115,Terminal SE - Efectivo TPV,80000,0,"20534396,37"
02/03/2024,23633,,11221,Terminal SE - Efectivo TPV,176563,0,"20710959,37"
02/03/2024,23625,,11189,Terminal SE - Efectivo TPV,65000,0,"20775959,37"
02/03/2024,23631,,11211,Terminal SE - Efectivo TPV,84894,0,"20860853,37"
02/03/2024,23634,,11222,Terminal SE - Efectivo TPV,"192405,99",0,"21053259,36"
02/03/2024,23622,,11167,Terminal SE - Efectivo TPV,"78229,99",0,"21131489,35"
02/03/2024,22955,,,Terminal SE - Efectivo TPV,0,1045450,"20086039,35"
02/03/2024,23638,,11254,Terminal SE - Efectivo TPV,"261292,99",0,"20347332,34"
02/03/2024,23636,,11245,Terminal SE - Efectivo TPV,150000,0,"20497332,34"
02/03/2024,23637,,11252,Terminal SE - Efectivo TPV,105107,0,"20602439,34"
02/03/2024,23630,,11209,Terminal SE - Efectivo TPV,"331055,99",0,"20933495,33"
02/03/2024,23627,,11200,Terminal SE - Efectivo TPV,198633,0,"21132128,33"
02/03/2024,23635,,11223,Terminal SE - Efectivo TPV,77000,0,"21209128,33"
02/03/2024,23626,,11190,Terminal SE - Efectivo TPV,96200,0,"21305328,33"
02/03/2024,23620,,11154,Terminal SE - Efectivo TPV,127506,0,"21432834,33"
02/03/2024,23629,,11206,Terminal SE - Efectivo TPV,10000,0,"21442834,33"
02/03/2024,23628,,11204,Terminal SE - Efectivo TPV,53000,0,"21495834,33"
02/03/2024,22955,,,Terminal SE - Efectivo TPV,1045450,0,"22541284,33"
02/03/2024,23619,,11153,Terminal SE - Efectivo TPV,220537,0,"22761821,33"
02/03/2024,23632,,11214,Terminal SE - Efectivo TPV,"59999,99",0,"22821821,32"
02/03/2024,23621,,11160,Terminal SE - Efectivo TPV,"156241,01",0,"22978062,33"
02/03/2024,23618,,11152,Terminal SE - Efectivo TPV,"75060,99",0,"23053123,32"
02/03/2024,23624,,11185,Terminal SE - Efectivo TPV,56000,0,"23109123,32"
02/03/2024,23623,,11175,Terminal SE - Efectivo TPV,"50364,99",0,"23159488,31"
02/04/2024,24244,,11337,Terminal SE - Efectivo TPV,"186999,98",0,"23243475,27"
02/04/2024,24232,,11286,Terminal SE - Efectivo TPV,33685,0,"23277160,27"
02/04/2024,24236,,11304,Terminal SE - Efectivo TPV,92215,0,"23369375,27"
02/04/2024,24226,,11278,Terminal SE - Efectivo TPV,44000,0,"23413375,27"
02/04/2024,24222,,11271,Terminal SE - Efectivo TPV,166763,0,"23580138,27"
02/04/2024,24237,,11305,Terminal SE - Efectivo TPV,59500,0,"23639638,27"
02/04/2024,24235,,11294,Terminal SE - Efectivo TPV,79322,0,"23718960,27"
02/04/2024,24239,,11308,Terminal SE - Efectivo TPV,"139524,01",0,"23858484,28"
02/04/2024,24243,,11327,Terminal SE - Efectivo TPV,"106418,99",0,"23964903,27"
02/04/2024,24227,,11279,Terminal SE - Efectivo TPV,53000,0,"24017903,27"
02/04/2024,24228,,11280,Terminal SE - Efectivo TPV,"293006,98",0,"24310910,25"
02/04/2024,23639,,,Terminal SE - Efectivo TPV,0,2625100,"21685810,25"
02/04/2024,24238,,11307,Terminal SE - Efectivo TPV,137120,0,"21822930,25"
02/04/2024,24241,,11311,Terminal SE - Efectivo TPV,65100,0,"21888030,25"
02/04/2024,24242,,11319,Terminal SE - Efectivo TPV,101174,0,"21989204,25"
02/04/2024,24224,,11275,Terminal SE - Efectivo TPV,"83036,99",0,"22072241,24"
02/04/2024,24225,,11276,Terminal SE - Efectivo TPV,"66167,01",0,"22138408,25"
02/04/2024,24240,,11309,Terminal SE - Efectivo TPV,65000,0,"22203408,25"
02/04/2024,24245,,11346,Terminal SE - Efectivo TPV,105435,0,"22308843,25"
02/04/2024,24234,,11293,Terminal SE - Efectivo TPV,198306,0,"22507149,25"
02/04/2024,23639,,,Terminal SE - Efectivo TPV,2625100,0,"25090369,25"
02/04/2024,24230,,11284,Terminal SE - Efectivo TPV,250000,0,"25340369,25"
02/04/2024,24223,,11273,Terminal SE - Efectivo TPV,"736835,01",0,"26077204,26"
02/04/2024,24233,,11288,Terminal SE - Efectivo TPV,"108057,01",0,"26185261,27"
02/04/2024,24229,,11281,Terminal SE - Efectivo TPV,115378,0,"26300639,27"
02/04/2024,24231,,11285,Terminal SE - Efectivo TPV,"141818,99",0,"26442458,26"
02/05/2024,24246,,,Terminal SE - Efectivo TPV,3427850,0,"29870308,26"
02/05/2024,24246,,,Terminal SE - Efectivo TPV,0,3427850,"26442458,26"
02/08/2024,24397,,11364,Terminal SE - Efectivo TPV,"49500,01",0,"26479958,27"
02/08/2024,24398,,11365,Terminal SE - Efectivo TPV,61000,0,"26540958,27"
02/08/2024,24399,,11366,Terminal SE - Efectivo TPV,77902,0,"26618860,27"
02/08/2024,24400,,11374,Terminal SE - Efectivo TPV,"63000,01",0,"26681860,28"
02/09/2024,24517,,11401,Terminal SE - Efectivo TPV,91778,0,"26773638,28"
02/09/2024,24401,,,Terminal SE - Efectivo TPV,334900,0,"27108538,28"
02/09/2024,24401,,,Terminal SE - Efectivo TPV,0,334900,"26773638,28"
02/09/2024,24513,,11377,Terminal SE - Efectivo TPV,58000,0,"26831638,28"
02/09/2024,24514,,11383,Terminal SE - Efectivo TPV,"106999,99",0,"26938638,27"
02/09/2024,24515,,11387,Terminal SE - Efectivo TPV,"81725,99",0,"27020364,26"
02/09/2024,24516,,11397,Terminal SE - Efectivo TPV,66320,0,"27086684,26"
02/10/2024,24851,,11414,Terminal SE - Efectivo TPV,"82500,01",0,"27074154,27"
02/10/2024,24518,,,Terminal SE - Efectivo TPV,404850,0,"27479004,27"
02/10/2024,24848,,11409,Terminal SE - Efectivo TPV,101611,0,"27580615,27"
02/10/2024,24858,,11433,Terminal SE - Efectivo TPV,85222,0,"27665837,27"
02/10/2024,24518,,,Terminal SE - Efectivo TPV,0,404850,"27260987,27"
02/10/2024,24864,,11447,Terminal SE - Efectivo TPV,100700,0,"27361687,27"
02/10/2024,24863,,11445,Terminal SE - Efectivo TPV,195683,0,"27557370,27"
02/10/2024,24859,,11434,Terminal SE - Efectivo TPV,"113999,99",0,"27671370,26"
02/10/2024,24865,,11452,Terminal SE - Efectivo TPV,"178092,99",0,"27849463,25"
02/10/2024,24849,,11410,Terminal SE - Efectivo TPV,143894,0,"27993357,25"
02/10/2024,24852,,11415,Terminal SE - Efectivo TPV,86200,0,"28079557,25"
02/10/2024,24860,,11436,Terminal SE - Efectivo TPV,64500,0,"28144057,25"
02/10/2024,24857,,11431,Terminal SE - Efectivo TPV,69000,0,"28213057,25"
02/10/2024,24862,,11439,Terminal SE - Efectivo TPV,"281889,01",0,"28494946,26"
02/10/2024,24861,,11438,Terminal SE - Efectivo TPV,"502155,99",0,"28997102,25"
02/10/2024,24854,,11422,Terminal SE - Efectivo TPV,87954,0,"29070056,25"
02/10/2024,24856,,11430,Terminal SE - Efectivo TPV,"92999,99",0,"29163056,24"
02/10/2024,24855,,11427,Terminal SE - Efectivo TPV,86096,0,"29158152,46"
02/10/2024,24847,,11408,Terminal SE - Efectivo TPV,253481,0,"29411633,46"
02/10/2024,24853,,11419,Terminal SE - Efectivo TPV,81398,0,"29493031,46"
02/10/2024,24850,,11413,Terminal SE - Efectivo TPV,78448,0,"29571479,46"
02/11/2024,25166,,11471,Terminal SE - Efectivo TPV,"142646,99",0,"29714126,45"
02/11/2024,25165,,11468,Terminal SE - Efectivo TPV,82400,0,"29796526,45"
02/11/2024,25168,,11481,Terminal SE - Efectivo TPV,113957,0,"29910483,45"
02/11/2024,25163,,11466,Terminal SE - Efectivo TPV,174815,0,"30085298,45"
02/11/2024,25164,,11467,Terminal SE - Efectivo TPV,85987,0,"30171285,45"
02/11/2024,25162,,11463,Terminal SE - Efectivo TPV,118219,0,"30289504,45"
02/11/2024,25167,,11479,Terminal SE - Efectivo TPV,"90300,01",0,"30379804,46"
02/11/2024,25161,,11461,Terminal SE - Efectivo TPV,"188893,99",0,"30568698,45"
02/11/2024,24846,,,Terminal SE - Transferencia TPV,4655916,0,"35224614,45"
02/11/2024,24866,,,Terminal SE - Efectivo TPV,0,2685900,"32538714,45"
02/15/2024,25642,,11558,Terminal SE - Efectivo TPV,"136574,01",0,"30375288,46"
02/15/2024,25643,,11559,Terminal SE - Efectivo TPV,83600,0,"30458888,46"
02/15/2024,25645,,11585,Terminal SE - Efectivo TPV,3226,0,"29737030,45"
02/15/2024,25644,,11584,Terminal SE - Efectivo TPV,"68099,99",0,"25205130,44"
02/16/2024,25982,,11645,Terminal SE - Efectivo TPV,96148,0,"25301278,44"
02/16/2024,25979,,11620,Terminal SE - Efectivo TPV,132000,0,"25433278,44"
02/16/2024,25973,,11590,Terminal SE - Efectivo TPV,58600,0,"25491878,44"
02/16/2024,25974,,11596,Terminal SE - Efectivo TPV,49000,0,"25540878,44"
02/16/2024,25975,,11604,Terminal SE - Efectivo TPV,85441,0,"25626319,44"
02/16/2024,25976,,11606,Terminal SE - Efectivo TPV,73000,0,"25699319,44"
02/16/2024,25977,,11607,Terminal SE - Efectivo TPV,59800,0,"25759119,44"
02/16/2024,25978,,11609,Terminal SE - Efectivo TPV,199398,0,"25958517,44"
02/16/2024,25980,,11637,Terminal SE - Efectivo TPV,163780,0,"26122297,44"
02/16/2024,25981,,11644,Terminal SE - Efectivo TPV,"73999,99",0,"26196297,43"
02/16/2024,25646,,,Terminal SE - Efectivo TPV,0,291500,"25904797,43"
02/16/2024,25646,,,Terminal SE - Efectivo TPV,291500,0,"26196297,43"
02/17/2024,26691,,11771,Terminal SE - Efectivo TPV,"172410,99",0,"25853726,11"
02/17/2024,25983,,,Terminal SE - Efectivo TPV,0,990350,"24863376,11"
02/17/2024,25983,,,Terminal SE - Efectivo TPV,990350,0,"25853726,11"
02/17/2024,26678,,11682,Terminal SE - Efectivo TPV,"31400,01",0,"25885126,12"
02/17/2024,26679,,11689,Terminal SE - Efectivo TPV,"154055,99",0,"26039182,11"
02/17/2024,26692,,11776,Terminal SE - Efectivo TPV,"272929,99",0,"26312112,1"
02/17/2024,26682,,11698,Terminal SE - Efectivo TPV,"67358,7",0,"26379470,8"
02/17/2024,26688,,11756,Terminal SE - Efectivo TPV,"110699,99",0,"26490170,79"
02/17/2024,26677,,11681,Terminal SE - Efectivo TPV,256650,0,"26746820,79"
02/17/2024,26683,,11708,Terminal SE - Efectivo TPV,70600,0,"26817420,79"
02/17/2024,26687,,11743,Terminal SE - Efectivo TPV,70300,0,"26887720,79"
02/17/2024,26684,,11721,Terminal SE - Efectivo TPV,"56500,01",0,"26944220,8"
02/17/2024,26686,,11728,Terminal SE - Efectivo TPV,6700,0,"26950920,8"
02/17/2024,26690,,11767,Terminal SE - Efectivo TPV,38000,0,"26988920,8"
02/17/2024,26685,,11727,Terminal SE - Efectivo TPV,138213,0,"27127133,8"
02/17/2024,26681,,11696,Terminal SE - Efectivo TPV,101611,0,"27228744,8"
02/17/2024,26689,,11760,Terminal SE - Efectivo TPV,74000,0,"27302744,8"
02/17/2024,26693,,11777,Terminal SE - Efectivo TPV,227000,0,"27529744,8"
02/17/2024,26680,,11694,Terminal SE - Efectivo TPV,148700,0,"27678444,8"
02/18/2024,27362,,11825,Terminal SE - Efectivo TPV,"144003,99",0,"27822448,79"
02/18/2024,26694,,,Terminal SE - Efectivo TPV,1997800,0,"29779568,79"
02/18/2024,26694,,,Terminal SE - Efectivo TPV,0,1997800,"27781768,79"
02/18/2024,27372,,11870,Terminal SE - Efectivo TPV,4000,0,"27785768,79"
02/18/2024,27358,,11819,Terminal SE - Efectivo TPV,165609,0,"27951377,79"
02/18/2024,27361,,11824,Terminal SE - Efectivo TPV,526,0,"27951903,79"
02/18/2024,27374,,11879,Terminal SE - Efectivo TPV,"56500,01",0,"28008403,8"
02/18/2024,27357,,11818,Terminal SE - Efectivo TPV,"111443,99",0,"28119847,79"
02/18/2024,27376,,11886,Terminal SE - Efectivo TPV,"187816,98",0,"28307664,77"
02/18/2024,27359,,11820,Terminal SE - Efectivo TPV,"147281,01",0,"28454945,78"
02/18/2024,27369,,11847,Terminal SE - Efectivo TPV,128950,0,"28583895,78"
02/18/2024,27375,,11885,Terminal SE - Efectivo TPV,22537,0,"28606432,78"
02/18/2024,27373,,11874,Terminal SE - Efectivo TPV,"103140,99",0,"28709573,77"
02/18/2024,27366,,11838,Terminal SE - Efectivo TPV,124774,0,"28834347,77"
02/18/2024,27354,,11809,Terminal SE - Efectivo TPV,"141272,01",0,"28975619,78"
02/18/2024,27364,,11834,Terminal SE - Efectivo TPV,"72799,99",0,"29048419,77"
02/18/2024,27370,,11856,Terminal SE - Efectivo TPV,47000,0,"29095419,77"
02/18/2024,27371,,11863,Terminal SE - Efectivo TPV,"49500,01",0,"29144919,78"
02/18/2024,27367,,11841,Terminal SE - Efectivo TPV,74952,0,"29219871,78"
02/18/2024,27356,,11812,Terminal SE - Efectivo TPV,107839,0,"29327710,78"
02/18/2024,27355,,11810,Terminal SE - Efectivo TPV,117672,0,"29445382,78"
02/18/2024,27360,,11823,Terminal SE - Efectivo TPV,"156349,99",0,"29601732,77"
02/18/2024,27363,,11829,Terminal SE - Efectivo TPV,"94618,99",0,"29696351,76"
02/18/2024,27365,,11836,Terminal SE - Efectivo TPV,104000,0,"29800351,76"
02/18/2024,27377,,11894,Terminal SE - Efectivo TPV,"171427,99",0,"29971779,75"
02/18/2024,27368,,11842,Terminal SE - Efectivo TPV,76481,0,"30048260,75"
02/19/2024,27378,,,Terminal SE - Efectivo TPV,2412000,0,"32460260,75"
02/19/2024,27378,,,Terminal SE - Efectivo TPV,0,2412000,"30048260,75"
02/23/2024,28009,,12036,Terminal SE - Efectivo TPV,"237092,99",0,"30265753,25"
02/23/2024,28008,,12015,Terminal SE - Efectivo TPV,90685,0,"30356438,25"
02/23/2024,28007,,12009,Terminal SE - Efectivo TPV,55600,0,"30412038,25"
02/23/2024,28006,,12005,Terminal SE - Efectivo TPV,73859,0,"30485897,25"
02/23/2024,28005,,11996,Terminal SE - Efectivo TPV,"83145,99",0,"30569043,24"
02/23/2024,28004,,11995,Terminal SE - Efectivo TPV,72000,0,"30641043,24"
02/24/2024,28758,,12124,Terminal SE - Efectivo TPV,83583,0,"30674626,24"
02/24/2024,28760,,12131,Terminal SE - Efectivo TPV,"67799,99",0,"30742426,23"
02/24/2024,28761,,12134,Terminal SE - Efectivo TPV,149685,0,"30892111,23"
02/24/2024,28751,,12081,Terminal SE - Efectivo TPV,"105216,99",0,"30997328,22"
02/24/2024,28766,,12171,Terminal SE - Efectivo TPV,67741,0,"31065069,22"
02/24/2024,28762,,12152,Terminal SE - Efectivo TPV,"79299,99",0,"31144369,21"
02/24/2024,28755,,12094,Terminal SE - Efectivo TPV,"82107,01",0,"31226476,22"
02/24/2024,28765,,12168,Terminal SE - Efectivo TPV,64500,0,"31290976,22"
02/24/2024,28753,,12083,Terminal SE - Efectivo TPV,"74299,99",0,"31365276,21"
02/24/2024,28763,,12164,Terminal SE - Efectivo TPV,125648,0,"31490924,21"
02/24/2024,28752,,12082,Terminal SE - Efectivo TPV,137300,0,"31628224,21"
02/24/2024,28764,,12165,Terminal SE - Efectivo TPV,55069,0,"31683293,21"
02/24/2024,28750,,12078,Terminal SE - Efectivo TPV,81398,0,"31764691,21"
02/24/2024,28749,,12075,Terminal SE - Efectivo TPV,"55079,99",0,"31819771,2"
02/24/2024,28748,,12074,Terminal SE - Efectivo TPV,"117890,99",0,"31937662,19"
02/24/2024,28747,,12073,Terminal SE - Efectivo TPV,59000,0,"31996662,19"
02/24/2024,28746,,12067,Terminal SE - Efectivo TPV,93198,0,"32089860,19"
02/24/2024,28010,,,Terminal SE - Efectivo TPV,0,612350,"31477510,19"
02/24/2024,28010,,,Terminal SE - Efectivo TPV,612350,0,"31849260,19"
02/24/2024,28756,,12097,Terminal SE - Efectivo TPV,92324,0,"31757526,83"
02/24/2024,28759,,12126,Terminal SE - Efectivo TPV,"89810,99",0,"31847337,82"
02/24/2024,28754,,12088,Terminal SE - Efectivo TPV,88281,0,"31935618,82"
02/24/2024,28757,,12107,Terminal SE - Efectivo TPV,"94071,99",0,"32029690,81"
02/25/2024,29454,,12249,Terminal SE - Efectivo TPV,"146188,99",0,"32175879,8"
02/25/2024,29436,,12192,Terminal SE - Efectivo TPV,174100,0,"32349979,8"
02/25/2024,29451,,12237,Terminal SE - Efectivo TPV,382080,0,"32732059,8"
02/25/2024,28767,,,Terminal SE - Efectivo TPV,0,1863300,"30868759,8"
02/25/2024,28767,,,Terminal SE - Efectivo TPV,1863300,0,"32732059,8"
02/25/2024,29443,,12215,Terminal SE - Efectivo TPV,230537,0,"32962596,8"
02/25/2024,29453,,12248,Terminal SE - Efectivo TPV,170000,0,"33132596,8"
02/25/2024,29450,,12236,Terminal SE - Efectivo TPV,53500,0,"33186096,8"
02/25/2024,29437,,12196,Terminal SE - Efectivo TPV,256759,0,"33442855,8"
02/25/2024,29446,,12227,Terminal SE - Efectivo TPV,258070,0,"33700925,8"
02/25/2024,29452,,12241,Terminal SE - Efectivo TPV,66430,0,"33767355,8"
02/25/2024,29440,,12205,Terminal SE - Efectivo TPV,108000,0,"33875355,8"
02/25/2024,29447,,12230,Terminal SE - Efectivo TPV,160000,0,"34035355,8"
02/25/2024,29459,,12205,Terminal SE - Efectivo TPV,"33197,99",0,"34068553,79"
02/25/2024,29444,,12218,Terminal SE - Efectivo TPV,72700,0,"34141253,79"
02/25/2024,29449,,12232,Terminal SE - Efectivo TPV,127396,0,"34268649,79"
02/25/2024,29445,,12221,Terminal SE - Efectivo TPV,"87079,99",0,"34355729,78"
02/25/2024,29439,,12199,Terminal SE - Efectivo TPV,31904,0,"34387633,78"
02/25/2024,29455,,12256,Terminal SE - Efectivo TPV,49500,0,"34437133,78"
02/25/2024,29442,,12211,Terminal SE - Efectivo TPV,111444,0,"34548577,78"
02/25/2024,29458,,12269,Terminal SE - Efectivo TPV,85000,0,"34633577,78"
02/25/2024,29441,,12209,Terminal SE - Efectivo TPV,10800,0,"34644377,78"
02/25/2024,29448,,12231,Terminal SE - Efectivo TPV,96694,0,"34741071,78"
02/25/2024,29456,,12260,Terminal SE - Efectivo TPV,"87953,99",0,"34829025,77"
02/25/2024,29438,,12198,Terminal SE - Efectivo TPV,88281,0,"34917306,77"
02/25/2024,29457,,12263,Terminal SE - Efectivo TPV,90500,0,"35007806,77"
02/26/2024,29460,,,Terminal SE - Efectivo TPV,0,2978050,"32029756,77"
02/26/2024,29460,,,Terminal SE - Efectivo TPV,2978050,0,"35007806,77"
02/27/2024,29588,,12300,Terminal LS - Tarjeta TPV,82491,0,"35090297,77"
02/27/2024,29581,,12285,Terminal LS - Tarjeta TPV,51300,0,"35141597,77"
02/27/2024,29578,,12292,Terminal LS - Efectivo TPV,5800,0,"35147397,77"
02/27/2024,29589,,12302,Terminal LS - Tarjeta TPV,"93962,99",0,"35241360,76"
02/27/2024,29592,,12288,Terminal LS - Transferencia TPV,57000,0,"35298360,76"
02/27/2024,29594,,12294,Terminal LS - Transferencia TPV,53300,0,"35351660,76"
02/27/2024,29587,,12298,Terminal LS - Tarjeta TPV,"193934,99",0,"35545595,75"
02/27/2024,29582,,12291,Terminal LS - Tarjeta TPV,"79431,01",0,"35625026,76"
02/27/2024,29584,,12295,Terminal LS - Tarjeta TPV,"74842,99",0,"35699869,75"
02/27/2024,29595,,12299,Terminal LS - Transferencia TPV,"209340,99",0,"35909210,74"
02/27/2024,29596,,12301,Terminal LS - Transferencia TPV,"100399,99",0,"36009610,73"
02/27/2024,29591,,12286,Terminal LS - Transferencia TPV,9200,0,"36018810,73"
02/27/2024,29580,,12281,Terminal LS - Tarjeta TPV,51000,0,"36069810,73"
02/27/2024,29583,,12293,Terminal LS - Tarjeta TPV,"99999,99",0,"36169810,72"
02/27/2024,29585,,12296,Terminal LS - Tarjeta TPV,88063,0,"36257873,72"
02/27/2024,29593,,12289,Terminal LS - Transferencia TPV,63500,0,"36321373,72"
02/27/2024,29586,,12297,Terminal LS - Tarjeta TPV,86096,0,"36407469,72"
02/28/2024,29590,,,Terminal LS - Tarjeta TPV,0,901121,"35506348,72"
02/28/2024,29597,,,Terminal LS - Transferencia TPV,0,492740,"35013608,72"
02/28/2024,29597,,,Terminal LS - Transferencia TPV,492740,0,"35506348,72"
02/28/2024,29579,,,Terminal LS - Efectivo TPV,0,350000,"35124348,72"
02/28/2024,29579,,,Terminal LS - Efectivo TPV,350000,0,"35474348,72"
02/28/2024,29590,,,Terminal LS - Tarjeta TPV,901121,0,"36375469,72"
02/29/2024,29883,,12337,Terminal SE - Efectivo TPV,"138540,99",0,"36514010,71"
02/29/2024,29882,,12329,Terminal SE - Efectivo TPV,126100,0,"36640110,71"
02/29/2024,29884,,12349,Terminal SE - Efectivo TPV,59500,0,"36699610,71"
03/01/2024,30283,,12369,Terminal SE - Efectivo TPV,51858,0,"36751468,71"
03/01/2024,29885,,,Terminal SE - Efectivo TPV,0,265400,"36486068,71"
03/01/2024,29885,,,Terminal SE - Efectivo TPV,265400,0,"36751468,71"
03/01/2024,30293,,12421,Terminal SE - Efectivo TPV,"300626,99",0,"37052095,7"
03/01/2024,30292,,12406,Terminal SE - Efectivo TPV,85222,0,"37137317,7"
03/01/2024,30291,,12405,Terminal SE - Efectivo TPV,149904,0,"37287221,7"
03/01/2024,30290,,12393,Terminal SE - Efectivo TPV,13000,0,"37300221,7"
03/01/2024,30289,,12392,Terminal SE - Efectivo TPV,"71000,01",0,"37371221,71"
03/01/2024,30288,,12383,Terminal SE - Efectivo TPV,114000,0,"37485221,71"
03/01/2024,30287,,12382,Terminal SE - Efectivo TPV,"108603,98",0,"37593825,69"
03/01/2024,30286,,12378,Terminal SE - Efectivo TPV,61000,0,"37654825,69"
03/01/2024,30285,,12375,Terminal SE - Efectivo TPV,"142255,99",0,"37797081,68"
03/01/2024,30284,,12374,Terminal SE - Efectivo TPV,"219600,01",0,"38016681,69"
03/01/2024,30294,,12422,Terminal SE - Efectivo TPV,"97786,99",0,"38114468,68"
03/01/2024,30295,,12436,Terminal SE - Efectivo TPV,20000,0,"38134468,68"
03/01/2024,29886,,,Terminal SE - Efectivo TPV,0,"58740,99","34375727,69"
03/02/2024,30952,,12477,Terminal SE - Efectivo TPV,4000,0,"34114117,69"
03/02/2024,30949,,12471,Terminal SE - Efectivo TPV,10000,0,"34124117,69"
03/02/2024,30296,,,Terminal SE - Efectivo TPV,0,1434900,"32689217,69"
03/02/2024,30946,,12461,Terminal SE - Efectivo TPV,149576,0,"32698306,1"
03/02/2024,30950,,12475,Terminal SE - Efectivo TPV,109478,0,"32807784,1"
03/02/2024,30951,,12476,Terminal SE - Efectivo TPV,135022,0,"32942806,1"
03/02/2024,30296,,,Terminal SE - Efectivo TPV,1434900,0,"34377706,1"
03/02/2024,30945,,12459,Terminal SE - Efectivo TPV,161485,0,"34539191,1"
03/02/2024,30955,,12487,Terminal SE - Efectivo TPV,89374,0,"34628565,1"
03/02/2024,30961,,12535,Terminal SE - Efectivo TPV,"174377,98",0,"34802943,08"
03/02/2024,30954,,12479,Terminal SE - Efectivo TPV,81900,0,"34884843,08"
03/02/2024,30948,,12466,Terminal SE - Efectivo TPV,"79759,01",0,"34964602,09"
03/02/2024,30953,,12478,Terminal SE - Efectivo TPV,"28188,99",0,"34992791,08"
03/02/2024,30960,,12522,Terminal SE - Efectivo TPV,166620,0,"35159411,08"
03/02/2024,30959,,12502,Terminal SE - Efectivo TPV,98880,0,"35258291,08"
03/02/2024,30956,,12490,Terminal SE - Efectivo TPV,"264079,99",0,"35522371,07"
03/02/2024,30957,,12491,Terminal SE - Efectivo TPV,10000,0,"35532371,07"
03/02/2024,30947,,12464,Terminal SE - Efectivo TPV,"101283,01",0,"35633654,08"
03/02/2024,30958,,12492,Terminal SE - Efectivo TPV,"130000,01",0,"35763654,09"
03/03/2024,31505,,12607,Terminal SE - Efectivo TPV,"104599,98",0,"35868254,07"
03/03/2024,31502,,12576,Terminal SE - Efectivo TPV,"194153,98",0,"36021728,05"
03/03/2024,30962,,,Terminal SE - Efectivo TPV,1798100,0,"37819828,05"
03/03/2024,31506,,12611,Terminal SE - Efectivo TPV,66100,0,"37885928,05"
03/03/2024,31511,,12644,Terminal SE - Efectivo TPV,"68099,99",0,"37954028,04"
03/03/2024,31510,,12636,Terminal SE - Efectivo TPV,85700,0,"38039728,04"
03/03/2024,31501,,12575,Terminal SE - Efectivo TPV,"176000,01",0,"38215728,05"
03/03/2024,30962,,,Terminal SE - Efectivo TPV,0,1798100,"36417628,05"
03/03/2024,31504,,12600,Terminal SE - Efectivo TPV,13000,0,"36430628,05"
03/03/2024,31509,,12624,Terminal SE - Efectivo TPV,63000,0,"36493628,05"
03/03/2024,31507,,12617,Terminal SE - Efectivo TPV,66500,0,"36560128,05"
03/03/2024,31508,,12620,Terminal SE - Efectivo TPV,"724696,62",0,"37284824,67"
03/03/2024,31503,,12599,Terminal SE - Efectivo TPV,"94454,99",0,"37379279,66"
03/04/2024,31512,,,Terminal SE - Efectivo TPV,1656300,0,"39035579,66"
03/04/2024,31512,,,Terminal SE - Efectivo TPV,0,1656300,"37379279,66"
03/07/2024,31853,,12684,Terminal SE - Efectivo TPV,96000,0,"37427279,66"
03/07/2024,31855,,12688,Terminal SE - Efectivo TPV,2700,0,"37429979,66"
03/07/2024,31857,,12694,Terminal SE - Efectivo TPV,"63000,01",0,"37492979,67"
03/07/2024,31854,,12685,Terminal SE - Efectivo TPV,78000,0,"37570979,67"
03/07/2024,31856,,12689,Terminal SE - Efectivo TPV,"80498,01",0,"37626487,68"
03/08/2024,31858,,,Terminal SE - Efectivo TPV,0,319200,"37026007,68"
03/08/2024,31858,,,Terminal SE - Efectivo TPV,319200,0,"37345207,68"
03/09/2024,32749,,12808,Terminal SE - Efectivo TPV,171756,0,"37516963,68"
03/09/2024,32748,,12802,Terminal SE - Efectivo TPV,30000,0,"37546963,68"
03/09/2024,32759,,12841,Terminal SE - Efectivo TPV,142200,0,"37628765,37"
03/09/2024,32757,,12833,Terminal SE - Efectivo TPV,12000,0,"37640765,37"
03/09/2024,32754,,12824,Terminal SE - Efectivo TPV,259545,0,"37900310,37"
03/09/2024,32765,,12858,Terminal SE - Efectivo TPV,124009,0,"38024319,37"
03/09/2024,32761,,12851,Terminal SE - Efectivo TPV,"92542,99",0,"38116862,36"
03/09/2024,32758,,12837,Terminal SE - Efectivo TPV,"79868,99",0,"38196731,35"
03/09/2024,32764,,12855,Terminal SE - Efectivo TPV,169461,0,"38366192,35"
03/09/2024,32763,,12854,Terminal SE - Efectivo TPV,"68341,99",0,"38434534,34"
03/09/2024,32753,,12820,Terminal SE - Efectivo TPV,"76000,01",0,"38510534,35"
03/09/2024,32766,,12861,Terminal SE - Efectivo TPV,"164325,99",0,"38674860,34"
03/09/2024,32752,,12818,Terminal SE - Efectivo TPV,79600,0,"38754460,34"
03/09/2024,32755,,12826,Terminal SE - Efectivo TPV,"73312,99",0,"38827773,33"
03/09/2024,32760,,12846,Terminal SE - Efectivo TPV,82491,0,"38910264,33"
03/09/2024,32762,,12852,Terminal SE - Efectivo TPV,281670,0,"39191934,33"
03/09/2024,32756,,12829,Terminal SE - Efectivo TPV,3000,0,"39194934,33"
03/09/2024,32751,,12812,Terminal SE - Efectivo TPV,"56500,01",0,"39251434,34"
03/09/2024,32750,,12810,Terminal SE - Efectivo TPV,81070,0,"39332504,34"
03/10/2024,33207,,12906,Terminal SE - Efectivo TPV,163700,0,"39496204,34"
03/10/2024,32767,,,Terminal SE - Efectivo TPV,2047300,0,"41543504,34"
03/10/2024,32767,,,Terminal SE - Efectivo TPV,0,2047300,"39496204,34"
03/10/2024,33202,,12884,Terminal SE - Efectivo TPV,"349000,01",0,"39845204,35"
03/10/2024,33209,,12921,Terminal SE - Efectivo TPV,210600,0,"40055804,35"
03/10/2024,33210,,12923,Terminal SE - Efectivo TPV,73313,0,"40129117,35"
03/10/2024,33211,,12924,Terminal SE - Efectivo TPV,"22944,01",0,"40152061,36"
03/10/2024,33217,,12953,Terminal SE - Efectivo TPV,"273912,98",0,"40425974,34"
03/10/2024,33220,,12968,Terminal SE - Efectivo TPV,"26000,01",0,"40451974,35"
03/10/2024,33203,,12889,Terminal SE - Efectivo TPV,72100,0,"40524074,35"
03/10/2024,33206,,12905,Terminal SE - Efectivo TPV,85987,0,"40610061,35"
03/10/2024,33216,,12949,Terminal SE - Efectivo TPV,44000,0,"40654061,35"
03/10/2024,33213,,12932,Terminal SE - Efectivo TPV,69000,0,"40723061,35"
03/10/2024,33212,,12929,Terminal SE - Efectivo TPV,"124000,01",0,"40847061,36"
03/10/2024,33204,,12892,Terminal SE - Efectivo TPV,"28516,99",0,"40875578,35"
03/10/2024,33201,,12881,Terminal SE - Efectivo TPV,6000,0,"40881578,35"
03/10/2024,33205,,12902,Terminal SE - Efectivo TPV,92870,0,"40974448,35"
03/10/2024,33219,,12964,Terminal SE - Efectivo TPV,"81288,99",0,"41055737,34"
03/10/2024,33208,,12912,Terminal SE - Efectivo TPV,"175961,99",0,"41231699,33"
03/10/2024,33218,,12958,Terminal SE - Efectivo TPV,9800,0,"41241499,33"
03/11/2024,33221,,,Terminal SE - Efectivo TPV,0,2080800,"39160699,33"
03/11/2024,33221,,,Terminal SE - Efectivo TPV,2080800,0,"41241499,33"
03/14/2024,33621,,13008,Terminal SE - Efectivo TPV,84457,0,"41325956,33"
03/14/2024,33625,,,Terminal SE - Efectivo TPV,369300,0,"41695256,33"
03/14/2024,33624,,13029,Terminal SE - Efectivo TPV,90000,0,"41785256,33"
03/14/2024,33623,,13017,Terminal SE - Efectivo TPV,"87799,99",0,"41873056,32"
03/14/2024,33625,,,Terminal SE - Efectivo TPV,0,369300,"41503756,32"
03/14/2024,33622,,13013,Terminal SE - Efectivo TPV,"107000,01",0,"41610756,33"
03/15/2024,33957,,13073,Terminal SE - Transferencia TPV,57500,0,"41668256,33"
03/15/2024,33963,,13099,Terminal SE - Transferencia TPV,"100518,99",0,"41768775,32"
03/15/2024,33944,,13100,Terminal SE - Efectivo TPV,"85003,99",0,"41772419,31"
03/15/2024,33943,,13097,Terminal SE - Efectivo TPV,74406,0,"41846825,31"
03/15/2024,33941,,13044,Terminal SE - Efectivo TPV,121800,0,"41968625,31"
03/15/2024,33940,,13043,Terminal SE - Efectivo TPV,"19599,99",0,"41988225,3"
03/15/2024,33962,,13098,Terminal SE - Transferencia TPV,79713,0,"42067938,3"
03/15/2024,33958,,13074,Terminal SE - Transferencia TPV,125404,0,"42193342,3"
03/15/2024,33959,,13075,Terminal SE - Transferencia TPV,83856,0,"42277198,3"
03/15/2024,33960,,13077,Terminal SE - Transferencia TPV,57500,0,"42334698,3"
03/15/2024,33961,,13093,Terminal SE - Transferencia TPV,140944,0,"42475642,3"
03/16/2024,34710,,13144,Terminal SE - Efectivo TPV,118546,0,"42594188,3"
03/16/2024,34711,,13149,Terminal SE - Efectivo TPV,"178747,99",0,"42772936,29"
03/16/2024,34706,,13126,Terminal SE - Efectivo TPV,106200,0,"42879136,29"
03/16/2024,34720,,13195,Terminal SE - Efectivo TPV,"24200,01",0,"42903336,3"
03/16/2024,34719,,13193,Terminal SE - Efectivo TPV,"735799,93",0,"43639136,23"
03/16/2024,34713,,13158,Terminal SE - Efectivo TPV,"41399,99",0,"43680536,22"
03/16/2024,33964,,,Terminal SE - Transferencia TPV,1640597,0,"45321133,22"
03/16/2024,33964,,,Terminal SE - Transferencia TPV,0,1640597,"43680536,22"
03/16/2024,34717,,13184,Terminal SE - Efectivo TPV,"349999,99",0,"44030536,21"
03/16/2024,34707,,13134,Terminal SE - Efectivo TPV,6500,0,"44037036,21"
03/16/2024,34722,,13216,Terminal SE - Efectivo TPV,119500,0,"44156536,21"
03/16/2024,33945,,,Terminal SE - Efectivo TPV,0,427309,"43729227,21"
03/16/2024,33945,,,Terminal SE - Efectivo TPV,427309,0,"44156536,21"
03/16/2024,34708,,13136,Terminal SE - Efectivo TPV,20000,0,"44158536,65"
03/16/2024,34705,,13125,Terminal SE - Efectivo TPV,108713,0,"44267249,65"
03/16/2024,34709,,13140,Terminal SE - Efectivo TPV,"40651,99",0,"44307901,64"
03/16/2024,34716,,13175,Terminal SE - Efectivo TPV,2700,0,"44310601,64"
03/16/2024,34712,,13157,Terminal SE - Efectivo TPV,"172999,99",0,"44483601,63"
03/16/2024,34715,,13160,Terminal SE - Efectivo TPV,107074,0,"44590675,63"
03/16/2024,34714,,13159,Terminal SE - Efectivo TPV,109280,0,"44699955,63"
03/16/2024,34721,,13209,Terminal SE - Efectivo TPV,133515,0,"44833470,63"
03/16/2024,34718,,13191,Terminal SE - Efectivo TPV,109500,0,"44942970,63"
03/17/2024,35338,,13281,Terminal SE - Efectivo TPV,72000,0,"45014970,63"
03/17/2024,35341,,13287,Terminal SE - Efectivo TPV,"99999,99",0,"45114970,62"
03/17/2024,35343,,13299,Terminal SE - Efectivo TPV,72000,0,"45186970,62"
03/17/2024,35336,,13268,Terminal SE - Efectivo TPV,"216769,99",0,"45403740,61"
03/17/2024,35342,,13296,Terminal SE - Efectivo TPV,45500,0,"45449240,61"
03/17/2024,35352,,13346,Terminal SE - Efectivo TPV,"177764,98",0,"45627005,59"
03/17/2024,35340,,13286,Terminal SE - Efectivo TPV,"267794,01",0,"45894799,6"
03/17/2024,35351,,13344,Terminal SE - Efectivo TPV,168587,0,"46063386,6"
03/17/2024,35349,,13340,Terminal SE - Efectivo TPV,"178201,99",0,"46241588,59"
03/17/2024,35350,,13341,Terminal SE - Efectivo TPV,83583,0,"46325171,59"
03/17/2024,34724,,,Terminal SE - Efectivo TPV,0,"119027,89","46206143,7"
03/17/2024,35337,,13279,Terminal SE - Efectivo TPV,"168149,99",0,"46374293,69"
03/17/2024,35354,,13350,Terminal SE - Efectivo TPV,"289914,01",0,"46664207,7"
03/17/2024,35335,,13250,Terminal SE - Efectivo TPV,50000,0,"46714207,7"
03/17/2024,34723,,,Terminal SE - Efectivo TPV,0,2366300,"44347907,7"
03/17/2024,34723,,,Terminal SE - Efectivo TPV,2366300,0,"46714207,7"
03/17/2024,35346,,13318,Terminal SE - Efectivo TPV,85987,0,"46800194,7"
03/17/2024,35348,,13329,Terminal SE - Efectivo TPV,"147999,99",0,"46948194,69"
03/17/2024,35344,,13309,Terminal SE - Efectivo TPV,162796,0,"47110990,69"
03/17/2024,35347,,13325,Terminal SE - Efectivo TPV,"68833,01",0,"47179823,7"
03/17/2024,35353,,13347,Terminal SE - Efectivo TPV,"86314,99",0,"47266138,69"
03/17/2024,35345,,13316,Terminal SE - Efectivo TPV,"115999,99",0,"47382138,68"
03/17/2024,35339,,13284,Terminal SE - Efectivo TPV,78448,0,"47460586,68"
03/18/2024,35355,,,Terminal SE - Efectivo TPV,2636700,0,"50097286,68"
03/18/2024,35355,,,Terminal SE - Efectivo TPV,0,2636700,"47460586,68"
03/21/2024,35852,,13434,Terminal LS - Transferencia TPV,10707,0,"35721293,68"
03/21/2024,35792,,13405,Terminal SE - Efectivo TPV,66102,0,"35787395,68"
03/21/2024,35793,,13406,Terminal SE - Efectivo TPV,63300,0,"35850695,68"
03/21/2024,35794,,13407,Terminal SE - Efectivo TPV,56500,0,"35907195,68"
03/21/2024,35795,,13408,Terminal SE - Efectivo TPV,100000,0,"36007195,68"
03/21/2024,35797,,13425,Terminal SE - Efectivo TPV,5800,0,"36012995,68"
03/21/2024,35798,,13426,Terminal SE - Efectivo TPV,"85222,01",0,"36098217,69"
03/21/2024,35799,,13430,Terminal SE - Efectivo TPV,63000,0,"36161217,69"
03/21/2024,35796,,13423,Terminal SE - Efectivo TPV,100000,0,"36261217,69"
03/21/2024,35851,,13433,Terminal LS - Transferencia TPV,82163,0,"36343380,69"
03/21/2024,35849,,13428,Terminal LS - Transferencia TPV,98400,0,"36441780,69"
03/21/2024,35854,,13438,Terminal LS - Transferencia TPV,"75443,99",0,"36517224,68"
03/21/2024,35853,,13435,Terminal LS - Transferencia TPV,75935,0,"36593159,68"
03/21/2024,35850,,13429,Terminal LS - Transferencia TPV,443046,0,"37036205,68"
03/22/2024,36073,,13459,Terminal SE - Efectivo TPV,51680,0,"37087885,68"
03/22/2024,36072,,13458,Terminal SE - Efectivo TPV,72100,0,"37159985,68"
03/22/2024,36071,,13454,Terminal SE - Efectivo TPV,123500,0,"37283485,68"
03/22/2024,36070,,13443,Terminal SE - Efectivo TPV,8000,0,"37291485,68"
03/22/2024,36069,,13442,Terminal SE - Efectivo TPV,"137500,01",0,"37428985,69"
03/22/2024,35800,,,Terminal SE - Efectivo TPV,539900,0,"37968885,69"
03/22/2024,36068,,13441,Terminal SE - Efectivo TPV,10000,0,"37978885,69"
03/22/2024,36067,,13439,Terminal SE - Efectivo TPV,10400,0,"37989285,69"
03/22/2024,35800,,,Terminal SE - Efectivo TPV,0,539900,"37449385,69"
03/22/2024,35855,,,Terminal LS - Transferencia TPV,0,1585538,"35863847,69"
03/22/2024,36075,,13499,Terminal SE - Efectivo TPV,220000,0,"36083847,69"
03/22/2024,36074,,13473,Terminal SE - Efectivo TPV,59000,0,"36142847,69"
03/22/2024,35855,,,Terminal LS - Transferencia TPV,1585538,0,"37728385,69"
03/23/2024,36577,,13559,Terminal SE - Efectivo TPV,8550,0,"37736935,69"
03/23/2024,36570,,13532,Terminal SE - Efectivo TPV,169570,0,"37906505,69"
03/23/2024,36582,,13590,Terminal SE - Efectivo TPV,"115814,99",0,"38022320,68"
03/23/2024,36581,,13575,Terminal SE - Efectivo TPV,"68000,01",0,"38090320,69"
03/23/2024,36578,,13563,Terminal SE - Efectivo TPV,"59500,01",0,"38149820,7"
03/23/2024,36579,,13570,Terminal SE - Efectivo TPV,165648,0,"38315468,7"
03/23/2024,36575,,13551,Terminal SE - Efectivo TPV,8550,0,"38324018,7"
03/23/2024,36574,,13550,Terminal SE - Efectivo TPV,"234000,19",0,"38558018,89"
03/23/2024,36683,,13522,Terminal LS - Tarjeta TPV,95875,0,"38653893,89"
03/23/2024,36681,,13519,Terminal LS - Tarjeta TPV,79541,0,"38733434,89"
03/23/2024,36679,,13593,Terminal LS - Efectivo TPV,45400,0,"38778834,89"
03/23/2024,36687,,13583,Terminal LS - Tarjeta TPV,"590983,01",0,"39369817,9"
03/23/2024,36682,,13521,Terminal LS - Tarjeta TPV,80000,0,"39449817,9"
03/23/2024,36685,,13546,Terminal LS - Tarjeta TPV,117672,0,"39567489,9"
03/23/2024,36688,,13584,Terminal LS - Tarjeta TPV,"244521,99",0,"39812011,89"
03/23/2024,36684,,13544,Terminal LS - Tarjeta TPV,56800,0,"39868811,89"
03/23/2024,36689,,13587,Terminal LS - Tarjeta TPV,148156,0,"40016967,89"
03/23/2024,36690,,13592,Terminal LS - Tarjeta TPV,151870,0,"40168837,89"
03/23/2024,36678,,13591,Terminal LS - Efectivo TPV,78746,0,"40247583,89"
03/23/2024,36076,,,Terminal SE - Efectivo TPV,0,692200,"39555383,89"
03/23/2024,36076,,,Terminal SE - Efectivo TPV,692200,0,"40247583,89"
03/23/2024,36686,,13579,Terminal LS - Tarjeta TPV,85222,0,"40146609,3"
03/23/2024,36673,,13533,Terminal LS - Efectivo TPV,"79868,99",0,"40088478,29"
03/23/2024,36675,,13566,Terminal LS - Efectivo TPV,76600,0,"40165078,29"
03/23/2024,36674,,13534,Terminal LS - Efectivo TPV,"90466,99",0,"40255545,28"
03/23/2024,36677,,13576,Terminal LS - Efectivo TPV,52500,0,"40308045,28"
03/23/2024,36676,,13568,Terminal LS - Efectivo TPV,"125999,99",0,"40434045,27"
03/23/2024,36580,,13574,Terminal SE - Efectivo TPV,"121714,99",0,"40555760,26"
03/23/2024,36571,,13539,Terminal SE - Efectivo TPV,"64681,01",0,"40620441,27"
03/23/2024,36572,,13540,Terminal SE - Efectivo TPV,50500,0,"40670941,27"
03/23/2024,36576,,13557,Terminal SE - Efectivo TPV,91013,0,"40761954,27"
03/23/2024,36573,,13548,Terminal SE - Efectivo TPV,157606,0,"40838200,27"
03/24/2024,37226,,13676,Terminal SE - Efectivo TPV,69000,0,"40907200,27"
03/24/2024,36680,,,Terminal LS - Efectivo TPV,0,549600,"40357600,27"
03/24/2024,36680,,,Terminal LS - Efectivo TPV,549600,0,"40907200,27"
03/24/2024,37214,,13613,Terminal SE - Efectivo TPV,"261675,99",0,"41168876,26"
03/24/2024,37218,,13638,Terminal SE - Efectivo TPV,70964,0,"41239840,26"
03/24/2024,37228,,13690,Terminal SE - Efectivo TPV,"125648,01",0,"41365488,27"
03/24/2024,37222,,13654,Terminal SE - Efectivo TPV,"91231,01",0,"41456719,28"
03/24/2024,37223,,13657,Terminal SE - Efectivo TPV,"81500,01",0,"41538219,29"
03/24/2024,37229,,13699,Terminal SE - Efectivo TPV,63000,0,"41601219,29"
03/24/2024,37225,,13662,Terminal SE - Efectivo TPV,62000,0,"41663219,29"
03/24/2024,37224,,13660,Terminal SE - Efectivo TPV,56000,0,"41719219,29"
03/24/2024,37221,,13653,Terminal SE - Efectivo TPV,72876,0,"41792095,29"
03/24/2024,37230,,13701,Terminal SE - Efectivo TPV,67000,0,"41859095,29"
03/24/2024,37227,,13687,Terminal SE - Efectivo TPV,"514470,01",0,"42373565,3"
03/24/2024,37215,,13618,Terminal SE - Efectivo TPV,"149247,99",0,"42522813,29"
03/24/2024,37213,,13608,Terminal SE - Efectivo TPV,"88609,01",0,"42611422,3"
03/24/2024,37216,,13622,Terminal SE - Efectivo TPV,85222,0,"42696644,3"
03/24/2024,37220,,13651,Terminal SE - Efectivo TPV,56000,0,"42752644,3"
03/24/2024,37219,,13640,Terminal SE - Efectivo TPV,72548,0,"42825192,3"
03/24/2024,37212,,13601,Terminal SE - Efectivo TPV,27000,0,"42852192,3"
03/24/2024,37288,,13689,Terminal SE - Transferencia TPV,"78694,99",0,"42930887,29"
03/24/2024,37287,,13689,Terminal SE - Transferencia TPV,78693,0,"43009580,29"
03/24/2024,37217,,13629,Terminal SE - Efectivo TPV,89000,0,"43098580,29"
03/24/2024,37286,,13688,Terminal SE - Transferencia TPV,123900,0,"43222480,29"
03/24/2024,36583,,,Terminal SE - Efectivo TPV,0,1315000,"41907480,29"
03/24/2024,36583,,,Terminal SE - Efectivo TPV,1315000,0,"43222480,29"
03/25/2024,37231,,,Terminal SE - Efectivo TPV,2103000,0,"45325480,29"
03/25/2024,37721,,13769,Terminal SE - Efectivo TPV,92870,0,"45418350,29"
03/25/2024,37716,,13743,Terminal SE - Efectivo TPV,78339,0,"45496689,29"
03/25/2024,37720,,13766,Terminal SE - Efectivo TPV,"85822,99",0,"45582512,28"
03/25/2024,37715,,13741,Terminal SE - Efectivo TPV,237857,0,"45820369,28"
03/25/2024,37718,,13753,Terminal SE - Efectivo TPV,10000,0,"45830369,28"
03/25/2024,37719,,13759,Terminal SE - Efectivo TPV,63698,0,"45894067,28"
03/25/2024,37717,,13750,Terminal SE - Efectivo TPV,175143,0,"46069210,28"
03/25/2024,37713,,13736,Terminal SE - Efectivo TPV,"104451,99",0,"46173662,27"
03/25/2024,37711,,13729,Terminal SE - Efectivo TPV,100000,0,"46273662,27"
03/25/2024,37714,,13738,Terminal SE - Efectivo TPV,92543,0,"46366205,27"
03/25/2024,37710,,13718,Terminal SE - Efectivo TPV,12305,0,"46378510,27"
03/25/2024,37712,,13730,Terminal SE - Efectivo TPV,74296,0,"46452806,27"
03/25/2024,37231,,,Terminal SE - Efectivo TPV,0,2103000,"44349806,27"
03/26/2024,37722,,,Terminal SE - Efectivo TPV,1127600,0,"45477406,27"
03/26/2024,37722,,,Terminal SE - Efectivo TPV,0,1127600,"44349806,27"
03/27/2024,39608,,13813,Terminal SE - Efectivo TPV,44000,0,"44393806,27"
03/27/2024,39607,,13812,Terminal SE - Efectivo TPV,158000,0,"44551806,27"
03/27/2024,39606,,13809,Terminal SE - Efectivo TPV,62550,0,"44614356,27"
03/27/2024,39605,,13808,Terminal SE - Efectivo TPV,"203440,99",0,"44817797,26"
03/27/2024,39604,,13800,Terminal SE - Efectivo TPV,50000,0,"44867797,26"
03/27/2024,39615,,13856,Terminal SE - Efectivo TPV,11700,0,"44012508,51"
03/27/2024,39614,,13846,Terminal SE - Efectivo TPV,"211416,99",0,"44223925,5"
03/27/2024,39613,,13834,Terminal SE - Efectivo TPV,"144768,99",0,"44368694,49"
03/27/2024,39612,,13832,Terminal SE - Efectivo TPV,74600,0,"44443294,49"
03/27/2024,39610,,13822,Terminal SE - Efectivo TPV,93089,0,"44536383,49"
03/27/2024,39611,,13824,Terminal SE - Efectivo TPV,67085,0,"44603468,49"
03/27/2024,39609,,13819,Terminal SE - Efectivo TPV,"83692,99",0,"44687161,48"
03/28/2024,40178,,13913,Terminal SE - Efectivo TPV,"184647,98",0,"44871809,46"
03/28/2024,40175,,13906,Terminal SE - Efectivo TPV,"144768,99",0,"44710308,45"
03/28/2024,40182,,13950,Terminal SE - Efectivo TPV,"170990,99",0,"44881299,44"
03/28/2024,40167,,13874,Terminal SE - Efectivo TPV,42700,0,"44923999,44"
03/28/2024,40181,,13931,Terminal SE - Efectivo TPV,98150,0,"45022149,44"
03/28/2024,40179,,13926,Terminal SE - Efectivo TPV,111000,0,"45133149,44"
03/28/2024,40174,,13904,Terminal SE - Efectivo TPV,72100,0,"45205249,44"
03/28/2024,40176,,13911,Terminal SE - Efectivo TPV,"84511,99",0,"45289761,43"
03/28/2024,40165,,13865,Terminal SE - Efectivo TPV,48500,0,"45338261,43"
03/28/2024,40183,,13951,Terminal SE - Efectivo TPV,95274,0,"45433535,43"
03/28/2024,40168,,13879,Terminal SE - Efectivo TPV,"330199,98",0,"45763735,41"
03/28/2024,40171,,13891,Terminal SE - Efectivo TPV,5000,0,"45768735,41"
03/28/2024,40173,,13897,Terminal SE - Efectivo TPV,"78120,01",0,"45846855,42"
03/28/2024,40170,,13890,Terminal SE - Efectivo TPV,"92199,99",0,"45939055,41"
03/28/2024,40180,,13930,Terminal SE - Efectivo TPV,"169999,99",0,"46109055,4"
03/28/2024,40172,,13896,Terminal SE - Efectivo TPV,"93962,99",0,"46203018,39"
03/28/2024,40166,,13873,Terminal SE - Efectivo TPV,"77300,01",0,"46280318,4"
03/28/2024,40169,,13889,Terminal SE - Efectivo TPV,8600,0,"46288918,4"
03/28/2024,40177,,13912,Terminal SE - Efectivo TPV,92870,0,"46381788,4"
03/28/2024,39616,,,Terminal SE - Efectivo TPV,1204300,0,"47586088,4"
03/28/2024,39616,,,Terminal SE - Efectivo TPV,0,1204300,"46381788,4"
03/29/2024,40856,,13973,Terminal SE - Efectivo TPV,94837,0,"46476625,4"
03/29/2024,40184,,,Terminal SE - Efectivo TPV,0,2000900,"44475725,4"
03/29/2024,40184,,,Terminal SE - Efectivo TPV,2000900,0,"46476625,4"
03/29/2024,40860,,13987,Terminal SE - Efectivo TPV,196776,0,"46673401,4"
03/29/2024,40855,,13970,Terminal SE - Efectivo TPV,78776,0,"46752177,4"
03/29/2024,40862,,13992,Terminal SE - Efectivo TPV,"196229,98",0,"46948407,38"
03/29/2024,40861,,13989,Terminal SE - Efectivo TPV,4000,0,"46952407,38"
03/29/2024,40875,,14054,Terminal SE - Efectivo TPV,"271728,01",0,"47224135,39"
03/29/2024,40857,,13978,Terminal SE - Efectivo TPV,"76949,99",0,"47266085,38"
03/29/2024,40869,,14016,Terminal SE - Efectivo TPV,112646,0,"47378731,38"
03/29/2024,40874,,14045,Terminal SE - Efectivo TPV,105000,0,"47483731,38"
03/29/2024,40876,,14071,Terminal SE - Efectivo TPV,92870,0,"47576601,38"
03/29/2024,40854,,13969,Terminal SE - Efectivo TPV,"81507,01",0,"47658108,39"
03/29/2024,40870,,14017,Terminal SE - Efectivo TPV,113500,0,"47771608,39"
03/29/2024,40863,,13993,Terminal SE - Efectivo TPV,"28174,99",0,"47799783,38"
03/29/2024,40865,,13999,Terminal SE - Efectivo TPV,"61500,01",0,"47861283,39"
03/29/2024,40859,,13982,Terminal SE - Efectivo TPV,30600,0,"47891883,39"
03/29/2024,40866,,14005,Terminal SE - Efectivo TPV,"79530,01",0,"47971413,4"
03/29/2024,40873,,14024,Terminal SE - Efectivo TPV,107620,0,"48079033,4"
03/29/2024,40879,,14077,Terminal SE - Efectivo TPV,"155967,99",0,"48235001,39"
03/29/2024,40868,,14012,Terminal SE - Efectivo TPV,8100,0,"48243101,39"
03/29/2024,40864,,13995,Terminal SE - Efectivo TPV,166730,0,"48409831,39"
03/29/2024,40872,,14023,Terminal SE - Efectivo TPV,45050,0,"48454881,39"
03/29/2024,40877,,14072,Terminal SE - Efectivo TPV,30000,0,"48484881,39"
03/29/2024,40858,,13980,Terminal SE - Efectivo TPV,"230100,01",0,"48714981,4"
03/29/2024,40871,,14019,Terminal SE - Efectivo TPV,146800,0,"48861781,4"
03/29/2024,40878,,14073,Terminal SE - Efectivo TPV,50000,0,"48911781,4"
03/29/2024,40867,,14008,Terminal SE - Efectivo TPV,"450693,98",0,"49362475,38"
03/30/2024,41566,,14123,Terminal SE - Efectivo TPV,71000,0,"49347488,38"
03/30/2024,41579,,14188,Terminal SE - Efectivo TPV,73586,0,"49421074,38"
03/30/2024,41570,,14141,Terminal SE - Efectivo TPV,"99644,01",0,"49520718,39"
03/30/2024,41573,,14158,Terminal SE - Efectivo TPV,84130,0,"49604848,39"
03/30/2024,41560,,14105,Terminal SE - Efectivo TPV,"56500,01",0,"49208506,74"
03/30/2024,41572,,14148,Terminal SE - Efectivo TPV,"65664,99",0,"49274171,73"
03/30/2024,41568,,14135,Terminal SE - Efectivo TPV,155257,0,"49429428,73"
03/30/2024,41558,,14096,Terminal SE - Efectivo TPV,156350,0,"49585778,73"
03/30/2024,41578,,14185,Terminal SE - Efectivo TPV,"209777,99",0,"49795556,72"
03/30/2024,41555,,14090,Terminal SE - Efectivo TPV,"11700,01",0,"49807256,73"
03/30/2024,41563,,14111,Terminal SE - Efectivo TPV,147281,0,"49954537,73"
03/30/2024,41581,,14201,Terminal SE - Efectivo TPV,125102,0,"50079639,73"
03/30/2024,41564,,14116,Terminal SE - Efectivo TPV,160000,0,"50239639,73"
03/30/2024,41576,,14179,Terminal SE - Efectivo TPV,153000,0,"50392639,73"
03/30/2024,41562,,14110,Terminal SE - Efectivo TPV,102594,0,"50495233,73"
03/30/2024,41577,,14180,Terminal SE - Efectivo TPV,11000,0,"50506233,73"
03/30/2024,41559,,14097,Terminal SE - Efectivo TPV,120185,0,"50576418,73"
03/30/2024,41571,,14147,Terminal SE - Efectivo TPV,32000,0,"50608418,73"
03/30/2024,41569,,14140,Terminal SE - Efectivo TPV,94181,0,"50702599,73"
03/30/2024,40880,,,Terminal SE - Efectivo TPV,0,3015200,"47687399,73"
03/30/2024,40880,,,Terminal SE - Efectivo TPV,3015200,0,"50702599,73"
03/30/2024,41565,,14122,Terminal SE - Efectivo TPV,176891,0,"50879490,73"
03/30/2024,41561,,14109,Terminal SE - Efectivo TPV,247144,0,"51126634,73"
03/30/2024,41567,,14130,Terminal SE - Efectivo TPV,"136245,99",0,"51262880,72"
03/30/2024,41580,,14190,Terminal SE - Efectivo TPV,"157005,99",0,"51419886,71"
03/30/2024,41557,,14093,Terminal SE - Efectivo TPV,"71018,99",0,"51490905,7"
03/30/2024,41556,,14091,Terminal SE - Efectivo TPV,30000,0,"51520905,7"
03/30/2024,41575,,14173,Terminal SE - Efectivo TPV,"144057,99",0,"51664963,69"
03/30/2024,41574,,14163,Terminal SE - Efectivo TPV,10000,0,"51674963,69"
03/30/2024,41582,,14208,Terminal SE - Efectivo TPV,162141,0,"51837104,69"
03/31/2024,41954,,14224,Terminal SE - Efectivo TPV,"99425,99",0,"51922330,68"
03/31/2024,41955,,14225,Terminal SE - Efectivo TPV,64791,0,"51987121,68"
03/31/2024,41959,,14231,Terminal SE - Efectivo TPV,84239,0,"52071360,68"
03/31/2024,41957,,14228,Terminal SE - Efectivo TPV,81398,0,"52152758,68"
03/31/2024,41962,,14238,Terminal SE - Efectivo TPV,"29799,99",0,"52182558,67"
03/31/2024,41958,,14230,Terminal SE - Efectivo TPV,130674,0,"52313232,67"
03/31/2024,41583,,,Terminal SE - Efectivo TPV,0,3063400,"49249832,67"
03/31/2024,41583,,,Terminal SE - Efectivo TPV,3063400,0,"52313232,67"
03/31/2024,41960,,14235,Terminal SE - Efectivo TPV,"124000,01",0,"52437232,68"
03/31/2024,41956,,14227,Terminal SE - Efectivo TPV,45200,0,"52482432,68"
03/31/2024,41963,,14251,Terminal SE - Efectivo TPV,54500,0,"52536932,68"
03/31/2024,41961,,14237,Terminal SE - Efectivo TPV,"199629,99",0,"52736562,67"
03/31/2024,41964,,14254,Terminal SE - Efectivo TPV,131876,0,"52868438,67"
04/01/2024,41965,,,Terminal SE - Efectivo TPV,1045450,0,"53913888,67"
04/01/2024,41965,,,Terminal SE - Efectivo TPV,0,1045450,"51258438,67"
04/04/2024,42205,,14308,Terminal SE - Efectivo TPV,"3600,99",0,"51222039,66"
04/05/2024,42495,,14379,Terminal SE - Efectivo TPV,50000,0,"51115709,66"
04/05/2024,42486,,14330,Terminal SE - Efectivo TPV,"112999,99",0,"51228709,65"
04/05/2024,42487,,14332,Terminal SE - Efectivo TPV,71000,0,"51299709,65"
04/05/2024,42488,,14336,Terminal SE - Efectivo TPV,"71018,99",0,"51370728,64"
04/05/2024,42489,,14338,Terminal SE - Efectivo TPV,"102703,99",0,"51473432,63"
04/05/2024,42490,,14341,Terminal SE - Efectivo TPV,11700,0,"51485132,63"
04/05/2024,42491,,14355,Terminal SE - Efectivo TPV,12000,0,"51497132,63"
04/05/2024,42492,,14365,Terminal SE - Efectivo TPV,"77901,99",0,"51575034,62"
04/05/2024,42493,,14371,Terminal SE - Efectivo TPV,"109999,99",0,"51685034,61"
04/05/2024,42496,,14382,Terminal SE - Efectivo TPV,"113083,02",0,"51798117,63"
04/05/2024,42206,,,Terminal SE - Efectivo TPV,4000,0,"51802117,63"
04/05/2024,42206,,,Terminal SE - Efectivo TPV,0,4000,"51798117,63"
04/05/2024,42494,,14377,Terminal SE - Efectivo TPV,"250026,02",0,"52043563,65"
04/06/2024,43054,,14459,Terminal SE - Efectivo TPV,"161812,99",0,"52205376,64"
04/06/2024,42497,,,Terminal SE - Efectivo TPV,0,981100,"51224276,64"
04/06/2024,43058,,14473,Terminal SE - Efectivo TPV,"150000,01",0,"51374276,65"
04/06/2024,43043,,14415,Terminal SE - Efectivo TPV,10000,0,"51384276,65"
04/06/2024,42497,,,Terminal SE - Efectivo TPV,981100,0,"52240426,65"
04/06/2024,43059,,14481,Terminal SE - Efectivo TPV,165036,0,"52280512,65"
04/06/2024,43052,,14451,Terminal SE - Efectivo TPV,"74296,01",0,"52354808,66"
04/06/2024,43045,,14439,Terminal SE - Efectivo TPV,110500,0,"52465308,66"
04/06/2024,43056,,14470,Terminal SE - Efectivo TPV,"158450,01",0,"52623758,67"
04/06/2024,43044,,14432,Terminal SE - Efectivo TPV,"74733,01",0,"52698491,68"
04/06/2024,43055,,14466,Terminal SE - Efectivo TPV,"56500,01",0,"52754991,69"
04/06/2024,43041,,14409,Terminal SE - Efectivo TPV,62000,0,"52816991,69"
04/06/2024,43049,,14447,Terminal SE - Efectivo TPV,81944,0,"52898935,69"
04/06/2024,43048,,14444,Terminal SE - Efectivo TPV,114722,0,"53013657,69"
04/06/2024,43038,,14399,Terminal SE - Efectivo TPV,165965,0,"53179622,69"
04/06/2024,43039,,14403,Terminal SE - Efectivo TPV,62000,0,"53241622,69"
04/06/2024,43047,,14443,Terminal SE - Efectivo TPV,93744,0,"53335366,69"
04/06/2024,43042,,14414,Terminal SE - Efectivo TPV,116000,0,"53451366,69"
04/06/2024,43046,,14440,Terminal SE - Efectivo TPV,11700,0,"53463066,69"
04/06/2024,43040,,14406,Terminal SE - Efectivo TPV,53000,0,"53516066,69"
04/06/2024,43051,,14450,Terminal SE - Efectivo TPV,"125320,01",0,"53641386,7"
04/06/2024,43060,,14488,Terminal SE - Efectivo TPV,110461,0,"53751847,7"
04/06/2024,43057,,14472,Terminal SE - Efectivo TPV,"222888,99",0,"53974736,69"
04/06/2024,43050,,14448,Terminal SE - Efectivo TPV,"75000,01",0,"54049736,7"
04/06/2024,43053,,14457,Terminal SE - Efectivo TPV,136902,0,"54186638,7"
04/07/2024,43612,,14563,Terminal SE - Efectivo TPV,74296,0,"54260934,7"
04/07/2024,43603,,14512,Terminal SE - Efectivo TPV,"82708,99",0,"54343643,69"
04/07/2024,43617,,14569,Terminal SE - Efectivo TPV,"105250,01",0,"54448893,7"
04/07/2024,43610,,14541,Terminal SE - Efectivo TPV,10400,0,"54459293,7"
04/07/2024,43614,,14566,Terminal SE - Efectivo TPV,"95492,99",0,"54554786,69"
04/07/2024,43619,,14581,Terminal SE - Efectivo TPV,61185,0,"54615971,69"
04/07/2024,43061,,,Terminal SE - Efectivo TPV,0,2392900,"52223071,69"
04/07/2024,43613,,14564,Terminal SE - Efectivo TPV,73760,0,"52296831,69"
04/07/2024,43608,,14528,Terminal SE - Efectivo TPV,"80742,99",0,"52377574,68"
04/07/2024,43605,,14519,Terminal SE - Efectivo TPV,"169569,99",0,"52547144,67"
04/07/2024,43606,,14524,Terminal SE - Efectivo TPV,"391343,99",0,"52938488,66"
04/07/2024,43602,,14510,Terminal SE - Efectivo TPV,86861,0,"53025349,66"
04/07/2024,43607,,14525,Terminal SE - Efectivo TPV,128926,0,"53154275,66"
04/07/2024,43615,,14567,Terminal SE - Efectivo TPV,"115999,99",0,"53270275,65"
04/07/2024,43611,,14552,Terminal SE - Efectivo TPV,58000,0,"53328275,65"
04/07/2024,43618,,14578,Terminal SE - Efectivo TPV,63000,0,"53391275,65"
04/07/2024,43609,,14538,Terminal SE - Efectivo TPV,4320,0,"53395595,65"
04/07/2024,43061,,,Terminal SE - Efectivo TPV,2392900,0,"55788495,65"
04/07/2024,43616,,14568,Terminal SE - Efectivo TPV,61000,0,"55849495,65"
04/07/2024,43604,,14513,Terminal SE - Efectivo TPV,"521876,98",0,"56371372,63"
04/08/2024,43620,,,Terminal SE - Efectivo TPV,0,2138750,"54232622,63"
04/08/2024,43620,,,Terminal SE - Efectivo TPV,2138750,0,"56371372,63"
04/11/2024,43910,,14631,Terminal SE - Efectivo TPV,62550,0,"56433922,63"
04/11/2024,43911,,14636,Terminal SE - Efectivo TPV,111335,0,"56545257,63"
04/11/2024,43912,,14643,Terminal SE - Efectivo TPV,"84238,99",0,"56629496,62"
04/11/2024,43909,,14630,Terminal SE - Efectivo TPV,70472,0,"56699968,62"
04/11/2024,43908,,14622,Terminal SE - Efectivo TPV,70581,0,"56770549,62"
04/11/2024,43907,,14620,Terminal SE - Efectivo TPV,51000,0,"56821549,62"
04/12/2024,44259,,14705,Terminal SE - Efectivo TPV,"400000,01",0,"57221549,63"
04/12/2024,43913,,,Terminal SE - Efectivo TPV,450000,0,"57671549,63"
04/12/2024,43913,,,Terminal SE - Efectivo TPV,0,450000,"57221549,63"
04/12/2024,44258,,14703,Terminal SE - Efectivo TPV,"250476,99",0,"57472026,62"
04/12/2024,44257,,14700,Terminal SE - Efectivo TPV,88281,0,"57560307,62"
04/12/2024,44256,,14677,Terminal SE - Efectivo TPV,7300,0,"57567607,62"
04/12/2024,44255,,14676,Terminal SE - Efectivo TPV,12674,0,"57580281,62"
04/13/2024,44762,,14740,Terminal SE - Efectivo TPV,152307,0,"57732588,62"
04/13/2024,44768,,14796,Terminal SE - Efectivo TPV,"172902,99",0,"57905491,61"
04/13/2024,44763,,14766,Terminal SE - Efectivo TPV,132300,0,"58037791,61"
04/13/2024,44772,,14809,Terminal SE - Efectivo TPV,5000,0,"58042791,61"
04/13/2024,44765,,14784,Terminal SE - Efectivo TPV,125867,0,"58168658,61"
04/13/2024,44766,,14785,Terminal SE - Efectivo TPV,11600,0,"58180258,61"
04/13/2024,44769,,14801,Terminal SE - Efectivo TPV,57000,0,"58237258,61"
04/13/2024,44758,,14726,Terminal SE - Efectivo TPV,196175,0,"58433433,61"
04/13/2024,44771,,14804,Terminal SE - Efectivo TPV,"64999,99",0,"58498433,6"
04/13/2024,44760,,14735,Terminal SE - Efectivo TPV,62500,0,"58560933,6"
04/13/2024,44770,,14803,Terminal SE - Efectivo TPV,6337,0,"58567270,6"
04/13/2024,44767,,14795,Terminal SE - Efectivo TPV,145315,0,"58712585,6"
04/13/2024,44764,,14780,Terminal SE - Efectivo TPV,149904,0,"58862489,6"
04/13/2024,44761,,14739,Terminal SE - Efectivo TPV,"103140,99",0,"58965630,59"
04/13/2024,44260,,,Terminal SE - Efectivo TPV,758900,0,"59724530,59"
04/13/2024,44260,,,Terminal SE - Efectivo TPV,0,758900,"58965630,59"
04/13/2024,44759,,14727,Terminal SE - Efectivo TPV,"72001,99",0,"59037632,58"
04/14/2024,45409,,14874,Terminal SE - Efectivo TPV,962000,0,"59815877,96"
04/14/2024,45392,,14823,Terminal SE - Efectivo TPV,9500,0,"59825377,96"
04/14/2024,45393,,14825,Terminal SE - Efectivo TPV,99098,0,"59924475,96"
04/14/2024,45398,,14841,Terminal SE - Efectivo TPV,190384,0,"60114859,96"
04/14/2024,45403,,14859,Terminal SE - Efectivo TPV,51450,0,"60166309,96"
04/14/2024,44773,,,Terminal SE - Efectivo TPV,1457200,0,"61623509,96"
04/14/2024,44773,,,Terminal SE - Efectivo TPV,0,1457200,"60166309,96"
04/14/2024,45402,,14858,Terminal SE - Efectivo TPV,4000,0,"60129629,96"
04/14/2024,45411,,14879,Terminal SE - Efectivo TPV,98552,0,"60228181,96"
04/14/2024,45391,,14822,Terminal SE - Efectivo TPV,39804,0,"60267985,96"
04/14/2024,45401,,14847,Terminal SE - Efectivo TPV,"751157,01",0,"61019142,97"
04/14/2024,45395,,14832,Terminal SE - Efectivo TPV,119748,0,"61138890,97"
04/14/2024,45412,,14885,Terminal SE - Efectivo TPV,27083,0,"61165973,97"
04/14/2024,45396,,14833,Terminal SE - Efectivo TPV,7600,0,"61173573,97"
04/14/2024,45407,,14866,Terminal SE - Efectivo TPV,135050,0,"61308623,97"
04/14/2024,45397,,14835,Terminal SE - Efectivo TPV,"83692,99",0,"61392316,96"
04/14/2024,45400,,14846,Terminal SE - Efectivo TPV,190439,0,"61582755,96"
04/14/2024,45399,,14845,Terminal SE - Efectivo TPV,"110897,99",0,"61693653,95"
04/14/2024,45405,,14862,Terminal SE - Efectivo TPV,"149800,02",0,"61843453,97"
04/14/2024,45406,,14863,Terminal SE - Efectivo TPV,"112000,01",0,"61955453,98"
04/14/2024,45394,,14830,Terminal SE - Efectivo TPV,"156240,98",0,"62111694,96"
04/14/2024,45410,,14878,Terminal SE - Efectivo TPV,74296,0,"62185990,96"
04/14/2024,45408,,14873,Terminal SE - Efectivo TPV,77530,0,"62263520,96"
04/14/2024,45404,,14859,Terminal SE - Efectivo TPV,62600,0,"62326120,96"
04/15/2024,45413,,,Terminal SE - Efectivo TPV,0,3513000,"58813120,96"
04/15/2024,45413,,,Terminal SE - Efectivo TPV,3513000,0,"62326120,96"
04/17/2024,45651,,14940,Terminal SE - Efectivo TPV,82400,0,"62408520,96"
04/17/2024,45654,,14946,Terminal SE - Efectivo TPV,10000,0,"62418520,96"
04/17/2024,45653,,14945,Terminal SE - Efectivo TPV,"84500,01",0,"62503020,97"
04/17/2024,45650,,14929,Terminal SE - Efectivo TPV,78770,0,"62581790,97"
04/17/2024,45649,,14927,Terminal SE - Efectivo TPV,95056,0,"62676846,97"
04/17/2024,45648,,14925,Terminal SE - Efectivo TPV,"80000,01",0,"62756846,98"
04/17/2024,45652,,14943,Terminal SE - Efectivo TPV,5000,0,"62761846,98"
04/18/2024,45747,,14964,Terminal SE - Efectivo TPV,150300,0,"62912146,98"
04/18/2024,45750,,14973,Terminal SE - Efectivo TPV,"98879,99",0,"63011026,97"
04/18/2024,45655,,,Terminal SE - Efectivo TPV,434750,0,"63445776,97"
04/18/2024,45748,,14967,Terminal SE - Efectivo TPV,"108493,99",0,"63554270,96"
04/18/2024,45655,,,Terminal SE - Efectivo TPV,0,434750,"63119520,96"
04/18/2024,45749,,14971,Terminal SE - Efectivo TPV,186232,0,"63305752,96"
04/19/2024,45992,,14987,Terminal SE - Efectivo TPV,83474,0,"63389226,96"
04/19/2024,45751,,,Terminal SE - Efectivo TPV,543850,0,"63933076,96"
04/19/2024,45994,,15019,Terminal SE - Efectivo TPV,67000,0,"64000076,96"
04/19/2024,45751,,,Terminal SE - Efectivo TPV,0,543850,"63456226,96"
04/19/2024,45993,,15005,Terminal SE - Efectivo TPV,"63250,01",0,"63519476,97"
04/20/2024,46480,,15090,Terminal SE - Efectivo TPV,88500,0,"63568496,97"
04/20/2024,46488,,15106,Terminal SE - Efectivo TPV,5900,0,"63574396,97"
04/20/2024,46473,,15063,Terminal SE - Efectivo TPV,310000,0,"63834397,28"
04/20/2024,46492,,15137,Terminal SE - Efectivo TPV,77574,0,"63911971,28"
04/20/2024,46487,,15105,Terminal SE - Efectivo TPV,149194,0,"64061165,28"
04/20/2024,46482,,15096,Terminal SE - Efectivo TPV,85331,0,"64146496,28"
04/20/2024,46489,,15113,Terminal SE - Efectivo TPV,65000,0,"64211496,28"
04/20/2024,46484,,15100,Terminal SE - Efectivo TPV,99700,0,"64260118,21"
04/20/2024,46475,,15074,Terminal SE - Efectivo TPV,"31999,99",0,"64292118,2"
04/20/2024,46476,,15075,Terminal SE - Efectivo TPV,"95999,99",0,"64388118,19"
04/20/2024,46477,,15076,Terminal SE - Efectivo TPV,19000,0,"64407118,19"
04/20/2024,46485,,15103,Terminal SE - Efectivo TPV,227751,0,"64634869,19"
04/20/2024,46483,,15097,Terminal SE - Efectivo TPV,"76590,99",0,"64711460,18"
04/20/2024,46471,,15050,Terminal SE - Efectivo TPV,5800,0,"64717260,18"
04/20/2024,46479,,15086,Terminal SE - Efectivo TPV,11700,0,"64728960,18"
04/20/2024,46472,,15058,Terminal SE - Efectivo TPV,142050,0,"64871010,18"
04/20/2024,46491,,15120,Terminal SE - Efectivo TPV,85200,0,"64956210,18"
04/20/2024,46478,,15081,Terminal SE - Efectivo TPV,77000,0,"65033210,18"
04/20/2024,46481,,15091,Terminal SE - Efectivo TPV,65000,0,"65098210,18"
04/20/2024,46486,,15104,Terminal SE - Efectivo TPV,68396,0,"65166606,18"
04/20/2024,46490,,15119,Terminal SE - Efectivo TPV,100000,0,"65266606,18"
04/20/2024,45995,,,Terminal SE - Efectivo TPV,0,213700,"65052906,18"
04/20/2024,46474,,15071,Terminal SE - Efectivo TPV,"88827,99",0,"65141734,17"
04/20/2024,45995,,,Terminal SE - Efectivo TPV,213700,0,"65355434,17"
04/21/2024,47025,,15182,Terminal SE - Efectivo TPV,160994,0,"65516428,17"
04/21/2024,46493,,,Terminal SE - Efectivo TPV,1966500,0,"67482928,17"
04/21/2024,46493,,,Terminal SE - Efectivo TPV,0,1966500,"65516428,17"
04/21/2024,46494,,,Terminal SE - Efectivo TPV,0,"10094,95","65506333,22"
04/21/2024,47026,,15184,Terminal SE - Efectivo TPV,"119234,99",0,"65625568,21"
04/21/2024,47027,,15187,Terminal SE - Efectivo TPV,"74973,99",0,"65700542,2"
04/21/2024,47029,,15203,Terminal SE - Efectivo TPV,"62204,01",0,"65762746,21"
04/21/2024,47017,,15146,Terminal SE - Efectivo TPV,91778,0,"65854524,21"
04/21/2024,47018,,15149,Terminal SE - Efectivo TPV,"187106,01",0,"66041630,22"
04/21/2024,47019,,15155,Terminal SE - Efectivo TPV,231700,0,"66273330,22"
04/21/2024,47020,,15156,Terminal SE - Efectivo TPV,151433,0,"66424763,22"
04/21/2024,47021,,15160,Terminal SE - Efectivo TPV,147882,0,"66572645,22"
04/21/2024,47022,,15170,Terminal SE - Efectivo TPV,"111335,01",0,"66683980,23"
04/21/2024,47023,,15172,Terminal SE - Efectivo TPV,120000,0,"66803980,23"
04/21/2024,47024,,15177,Terminal SE - Efectivo TPV,74078,0,"66878058,23"
04/21/2024,47028,,15199,Terminal SE - Efectivo TPV,75170,0,"66953228,23"
04/21/2024,47030,,15212,Terminal SE - Efectivo TPV,57907,0,"67011135,23"
04/22/2024,47031,,,Terminal SE - Efectivo TPV,0,1665900,"65336235,23"
04/22/2024,47031,,,Terminal SE - Efectivo TPV,1665900,0,"67002135,23"
04/24/2024,47276,,15250,Terminal SE - Efectivo TPV,"126740,99",0,"67128876,22"
04/25/2024,47416,,15287,Terminal SE - Efectivo TPV,"119092,99",0,"67026269,21"
04/25/2024,47415,,15284,Terminal SE - Efectivo TPV,70800,0,"67097069,21"
04/25/2024,47413,,15274,Terminal SE - Efectivo TPV,143294,0,"67240363,21"
04/25/2024,47277,,,Terminal SE - Efectivo TPV,626750,0,"67867113,21"
04/25/2024,47412,,15261,Terminal SE - Efectivo TPV,171756,0,"68038869,21"
04/25/2024,47277,,,Terminal SE - Efectivo TPV,0,626750,"67412119,21"
04/25/2024,47414,,15283,Terminal SE - Efectivo TPV,"75921,01",0,"67488040,22"
04/26/2024,47744,,15353,Terminal SE - Efectivo TPV,"254355,99",0,"67722396,21"
04/26/2024,47738,,15327,Terminal SE - Efectivo TPV,135000,0,"67857396,21"
04/26/2024,47739,,15340,Terminal SE - Efectivo TPV,182518,0,"68039914,21"
04/26/2024,47740,,15341,Terminal SE - Efectivo TPV,"68800,01",0,"68108714,22"
04/26/2024,47735,,15306,Terminal SE - Efectivo TPV,"56000,01",0,"68164714,23"
04/26/2024,47741,,15343,Terminal SE - Efectivo TPV,"78599,99",0,"68243314,22"
04/26/2024,47742,,15346,Terminal SE - Efectivo TPV,"90575,99",0,"68333890,21"
04/26/2024,47737,,15323,Terminal SE - Efectivo TPV,4640,0,"68338530,21"
04/26/2024,47736,,15314,Terminal SE - Efectivo TPV,9000,0,"68347530,21"
04/26/2024,47417,,,Terminal SE - Efectivo TPV,580600,0,"68928130,21"
04/26/2024,47417,,,Terminal SE - Efectivo TPV,0,580600,"68347530,21"
04/26/2024,47743,,15348,Terminal SE - Efectivo TPV,"145751,99",0,"68493282,2"
04/27/2024,48245,,15403,Terminal SE - Efectivo TPV,57500,0,"68550782,2"
04/27/2024,47745,,,Terminal SE - Efectivo TPV,0,1025400,"67525382,2"
04/27/2024,47745,,,Terminal SE - Efectivo TPV,1025400,0,"68550782,2"
04/27/2024,48240,,15366,Terminal SE - Efectivo TPV,10000,0,"68560782,2"
04/27/2024,48243,,15388,Terminal SE - Efectivo TPV,60300,0,"68621082,2"
04/27/2024,48242,,15381,Terminal SE - Efectivo TPV,180824,0,"68801906,2"
04/27/2024,48247,,15420,Terminal SE - Efectivo TPV,"145750,01",0,"68700601,9"
04/27/2024,48246,,15419,Terminal SE - Efectivo TPV,10000,0,"68694301,9"
04/27/2024,48239,,15360,Terminal SE - Efectivo TPV,"78250,01",0,"68772551,91"
04/27/2024,48250,,15430,Terminal SE - Efectivo TPV,90139,0,"68862690,91"
04/27/2024,48249,,15429,Terminal SE - Efectivo TPV,"327999,99",0,"69190690,9"
04/27/2024,48251,,15434,Terminal SE - Efectivo TPV,204806,0,"69395496,9"
04/27/2024,48241,,15373,Terminal SE - Efectivo TPV,"79050,01",0,"69474546,91"
04/27/2024,48248,,15425,Terminal SE - Efectivo TPV,"66999,99",0,"69541546,9"
04/27/2024,48252,,15444,Terminal SE - Efectivo TPV,"437117,59",0,"69978664,49"
04/27/2024,48244,,15390,Terminal SE - Efectivo TPV,"76000,01",0,"70054664,5"
04/28/2024,48678,,15473,Terminal SE - Efectivo TPV,"73421,99",0,"70128086,49"
04/28/2024,48677,,15463,Terminal SE - Efectivo TPV,13900,0,"70141986,49"
04/28/2024,48676,,15462,Terminal SE - Efectivo TPV,121933,0,"70263919,49"
04/28/2024,48675,,15457,Terminal SE - Efectivo TPV,82218,0,"70346137,49"
04/28/2024,48687,,15515,Terminal SE - Efectivo TPV,64000,0,"70340137,49"
04/28/2024,48686,,15504,Terminal SE - Efectivo TPV,155148,0,"70495285,49"
04/28/2024,48685,,15499,Terminal SE - Efectivo TPV,59500,0,"70554785,49"
04/28/2024,48684,,15498,Terminal SE - Efectivo TPV,95602,0,"70650387,49"
04/28/2024,48253,,,Terminal SE - Efectivo TPV,1584900,0,"72235287,49"
04/28/2024,48253,,,Terminal SE - Efectivo TPV,0,1584900,"70650387,49"
04/28/2024,48254,,,Terminal SE - Efectivo TPV,0,"239836,61","70410550,88"
04/28/2024,48683,,15483,Terminal SE - Efectivo TPV,50500,0,"70461050,88"
04/28/2024,48682,,15482,Terminal SE - Efectivo TPV,118588,0,"70579638,88"
04/28/2024,48681,,15481,Terminal SE - Efectivo TPV,14600,0,"70594238,88"
04/28/2024,48680,,15479,Terminal SE - Efectivo TPV,235400,0,"70829638,88"
04/28/2024,48679,,15474,Terminal SE - Efectivo TPV,"95055,99",0,"70924694,87"
04/29/2024,48688,,,Terminal SE - Efectivo TPV,0,1179900,"69744794,87"
04/29/2024,48688,,,Terminal SE - Efectivo TPV,1179900,0,"70924694,87"
05/01/2024,49266,,15595,Terminal SE - Efectivo TPV,"48477,98",0,"70973172,85"
05/01/2024,49261,,15577,Terminal SE - Efectivo TPV,114613,0,"71087785,85"
05/01/2024,49259,,15573,Terminal SE - Efectivo TPV,154329,0,"71242114,85"
05/01/2024,49258,,15572,Terminal SE - Efectivo TPV,196448,0,"71438562,85"
05/01/2024,49264,,15590,Terminal SE - Efectivo TPV,90576,0,"71529138,85"
05/01/2024,49260,,15574,Terminal SE - Efectivo TPV,91700,0,"71620838,85"
05/01/2024,49265,,15592,Terminal SE - Efectivo TPV,"102000,01",0,"71722838,86"
05/01/2024,49263,,15586,Terminal SE - Efectivo TPV,"234032,99",0,"71956871,85"
05/01/2024,49257,,15567,Terminal SE - Efectivo TPV,144100,0,"72100971,85"
05/01/2024,49256,,15564,Terminal SE - Efectivo TPV,96148,0,"72197119,85"
05/01/2024,49267,,15606,Terminal SE - Efectivo TPV,66500,0,"72263619,85"
05/01/2024,49262,,15579,Terminal SE - Efectivo TPV,131000,0,"72394619,85"
05/01/2024,49255,,15563,Terminal SE - Efectivo TPV,53500,0,"72448119,85"
05/01/2024,49254,,15558,Terminal SE - Efectivo TPV,"105216,99",0,"72553336,84"
05/01/2024,49253,,15556,Terminal SE - Efectivo TPV,76809,0,"72630145,84"
05/01/2024,49268,,15617,Terminal SE - Efectivo TPV,97569,0,"72727714,84"
05/02/2024,49426,,15638,Terminal SE - Efectivo TPV,5800,0,"72583574,84"
05/02/2024,49269,,,Terminal SE - Efectivo TPV,0,1803200,"70780374,84"
05/02/2024,49269,,,Terminal SE - Efectivo TPV,1803200,0,"72583574,84"
05/02/2024,49427,,15642,Terminal SE - Efectivo TPV,"180000,01",0,"72763574,85"
05/02/2024,49423,,15627,Terminal SE - Efectivo TPV,70000,0,"72666840,85"
05/02/2024,49424,,15629,Terminal SE - Efectivo TPV,"110023,98",0,"72776864,83"
05/02/2024,49425,,15632,Terminal SE - Efectivo TPV,59500,0,"72836364,83"
05/03/2024,49645,,15687,Terminal SE - Efectivo TPV,150000,0,"72966364,83"
05/03/2024,49642,,15659,Terminal SE - Efectivo TPV,"64999,99",0,"73031364,82"
05/03/2024,49641,,15651,Terminal SE - Efectivo TPV,98006,0,"73129370,82"
05/03/2024,49644,,15678,Terminal SE - Efectivo TPV,45000,0,"73174370,82"
05/03/2024,49643,,15661,Terminal SE - Efectivo TPV,89920,0,"73264290,82"
05/03/2024,49428,,,Terminal SE - Efectivo TPV,425300,0,"73665590,82"
05/03/2024,49428,,,Terminal SE - Efectivo TPV,0,425300,"73240290,82"
05/04/2024,50091,,15787,Terminal SE - Efectivo TPV,80000,0,"73320290,82"
05/04/2024,49646,,,Terminal SE - Efectivo TPV,0,448000,"72780537,3"
05/04/2024,49646,,,Terminal SE - Efectivo TPV,448000,0,"73228537,3"
05/04/2024,50079,,15713,Terminal SE - Efectivo TPV,227129,0,"73455666,3"
05/04/2024,50089,,15782,Terminal SE - Efectivo TPV,226822,0,"73682488,3"
05/04/2024,50090,,15784,Terminal SE - Efectivo TPV,"61000,01",0,"73743488,31"
05/04/2024,50088,,15761,Terminal SE - Efectivo TPV,"203530,99",0,"73947019,3"
05/04/2024,50083,,15736,Terminal SE - Efectivo TPV,"175579,98",0,"74122599,28"
05/04/2024,50086,,15756,Terminal SE - Efectivo TPV,105000,0,"74227599,28"
05/04/2024,50085,,15755,Terminal SE - Efectivo TPV,86861,0,"74314460,28"
05/04/2024,50092,,15790,Terminal SE - Efectivo TPV,181152,0,"74495612,28"
05/04/2024,50082,,15730,Terminal SE - Efectivo TPV,65000,0,"74560612,28"
05/04/2024,50081,,15725,Terminal SE - Efectivo TPV,38500,0,"74599112,28"
05/04/2024,50087,,15759,Terminal SE - Efectivo TPV,225456,0,"74824568,28"
05/04/2024,50080,,15716,Terminal SE - Efectivo TPV,81234,0,"74905802,28"
05/04/2024,50084,,15737,Terminal SE - Efectivo TPV,"111990,99",0,"75017793,27"
05/05/2024,50539,,15835,Terminal SE - Efectivo TPV,144222,0,"75162015,27"
05/05/2024,50531,,15810,Terminal SE - Efectivo TPV,81562,0,"75243577,27"
05/05/2024,50540,,15836,Terminal SE - Efectivo TPV,90357,0,"75333934,27"
05/05/2024,50538,,15832,Terminal SE - Efectivo TPV,102922,0,"75436856,27"
05/05/2024,50541,,15841,Terminal SE - Efectivo TPV,"95601,99",0,"75532458,26"
05/05/2024,50529,,15805,Terminal SE - Efectivo TPV,"91777,99",0,"75624236,25"
05/05/2024,50537,,15830,Terminal SE - Efectivo TPV,143130,0,"75767366,25"
05/05/2024,50530,,15808,Terminal SE - Efectivo TPV,155203,0,"75922569,25"
05/05/2024,50545,,15850,Terminal SE - Efectivo TPV,"85000,01",0,"76007569,26"
05/05/2024,50533,,15818,Terminal SE - Efectivo TPV,63000,0,"76070569,26"
05/05/2024,50547,,15863,Terminal SE - Efectivo TPV,44800,0,"76115369,26"
05/05/2024,50544,,15846,Terminal SE - Efectivo TPV,10000,0,"76125369,26"
05/05/2024,50542,,15842,Terminal SE - Efectivo TPV,54000,0,"76179369,26"
05/05/2024,50548,,15866,Terminal SE - Efectivo TPV,44000,0,"76223369,26"
05/05/2024,50550,,15873,Terminal SE - Efectivo TPV,62600,0,"76285969,26"
05/05/2024,50093,,,Terminal SE - Efectivo TPV,1869100,0,"78155069,26"
05/05/2024,50093,,,Terminal SE - Efectivo TPV,0,1869100,"76285969,26"
05/05/2024,50534,,15819,Terminal SE - Efectivo TPV,"58879,99",0,"76344849,25"
05/05/2024,50546,,15856,Terminal SE - Efectivo TPV,60000,0,"76404849,25"
05/05/2024,50549,,15872,Terminal SE - Efectivo TPV,78667,0,"76483516,25"
05/05/2024,50535,,15820,Terminal SE - Efectivo TPV,80032,0,"76563548,25"
05/05/2024,50543,,15845,Terminal SE - Efectivo TPV,88800,0,"76652348,25"
05/05/2024,50536,,15822,Terminal SE - Efectivo TPV,"95199,99",0,"76747548,24"
05/05/2024,50532,,15817,Terminal SE - Efectivo TPV,"168700,01",0,"76916248,25"
05/06/2024,50551,,,Terminal SE - Efectivo TPV,0,1898550,"75017698,25"
05/06/2024,50551,,,Terminal SE - Efectivo TPV,1898550,0,"76916248,25"
05/08/2024,50796,,15899,Terminal SE - Efectivo TPV,160720,0,"77076968,25"
05/08/2024,50797,,15912,Terminal SE - Efectivo TPV,4000,0,"77075968,25"
05/09/2024,50798,,,Terminal SE - Efectivo TPV,0,164700,"76911268,25"
05/09/2024,50981,,15952,Terminal SE - Efectivo TPV,"199999,99",0,"77111268,24"
05/09/2024,50980,,15944,Terminal SE - Efectivo TPV,63000,0,"77174268,24"
05/09/2024,50798,,,Terminal SE - Efectivo TPV,164700,0,"77338968,24"
05/09/2024,50982,,15958,Terminal SE - Efectivo TPV,56000,0,"77394968,24"
05/10/2024,50983,,,Terminal SE - Efectivo TPV,319200,0,"77714168,24"
05/10/2024,51236,,15993,Terminal SE - Efectivo TPV,"128707,01",0,"77842875,25"
05/10/2024,51237,,15994,Terminal SE - Efectivo TPV,95200,0,"77938075,25"
05/10/2024,50983,,,Terminal SE - Efectivo TPV,0,319200,"77618875,25"
05/10/2024,51239,,16004,Terminal SE - Efectivo TPV,"109805,99",0,"77728681,24"
05/10/2024,51238,,15995,Terminal SE - Efectivo TPV,108003,0,"77836684,24"
05/11/2024,51775,,16085,Terminal SE - Efectivo TPV,107900,0,"77944584,24"
05/11/2024,51773,,16074,Terminal SE - Efectivo TPV,"179300,01",0,"78123884,25"
05/11/2024,51772,,16056,Terminal SE - Efectivo TPV,86424,0,"78210308,25"
05/11/2024,51769,,16050,Terminal SE - Efectivo TPV,104670,0,"78314978,25"
05/11/2024,51763,,16023,Terminal SE - Efectivo TPV,"82599,99",0,"78397578,24"
05/11/2024,51240,,,Terminal SE - Efectivo TPV,0,441700,"77955878,24"
05/11/2024,51767,,16041,Terminal SE - Efectivo TPV,124119,0,"78079997,24"
05/11/2024,51764,,16026,Terminal SE - Efectivo TPV,"131657,01",0,"78211654,25"
05/11/2024,51766,,16040,Terminal SE - Efectivo TPV,70000,0,"78281654,25"
05/11/2024,51776,,16098,Terminal SE - Efectivo TPV,89811,0,"78371465,25"
05/11/2024,51774,,16075,Terminal SE - Efectivo TPV,205517,0,"78576982,25"
05/11/2024,51770,,16051,Terminal SE - Efectivo TPV,79431,0,"78656413,25"
05/11/2024,51777,,16100,Terminal SE - Efectivo TPV,4000,0,"78660413,25"
05/11/2024,51771,,16053,Terminal SE - Efectivo TPV,59850,0,"78720263,25"
05/11/2024,51762,,16020,Terminal SE - Efectivo TPV,81180,0,"78801443,25"
05/11/2024,51765,,16028,Terminal SE - Efectivo TPV,51985,0,"78853428,25"
05/11/2024,51768,,16047,Terminal SE - Efectivo TPV,330000,0,"79183428,25"
05/11/2024,51240,,,Terminal SE - Efectivo TPV,441700,0,"79625128,25"
05/12/2024,52258,,16139,Terminal SE - Efectivo TPV,"177272,99",0,"79802401,24"
05/12/2024,51778,,,Terminal SE - Efectivo TPV,0,1788450,"78013951,24"
05/12/2024,51778,,,Terminal SE - Efectivo TPV,1788450,0,"79802401,24"
05/12/2024,52268,,16183,Terminal SE - Efectivo TPV,10300,0,"79812701,24"
05/12/2024,52265,,16167,Terminal SE - Efectivo TPV,"311989,98",0,"80124691,22"
05/12/2024,52266,,16179,Terminal SE - Efectivo TPV,111007,0,"80235698,22"
05/12/2024,52256,,16131,Terminal SE - Efectivo TPV,"148756,01",0,"80384454,23"
05/12/2024,52267,,16180,Terminal SE - Efectivo TPV,87735,0,"80472189,23"
05/12/2024,52260,,16145,Terminal SE - Efectivo TPV,60500,0,"80532689,23"
05/12/2024,52262,,16148,Terminal SE - Efectivo TPV,10200,0,"80542889,23"
05/12/2024,52263,,16154,Terminal SE - Efectivo TPV,"85599,99",0,"80628489,22"
05/12/2024,52264,,16159,Terminal SE - Efectivo TPV,91231,0,"80719720,22"
05/12/2024,52259,,16140,Terminal SE - Efectivo TPV,242282,0,"80962002,22"
05/12/2024,52257,,16136,Terminal SE - Efectivo TPV,102300,0,"80981342,22"
05/12/2024,52255,,16125,Terminal SE - Efectivo TPV,"186723,99",0,"81168066,21"
05/12/2024,52261,,16146,Terminal SE - Efectivo TPV,"177545,99",0,"81345612,2"
05/12/2024,52254,,16122,Terminal SE - Efectivo TPV,164763,0,"81510375,2"
05/13/2024,52824,,16213,Terminal SE - Efectivo TPV,103031,0,"81613406,2"
05/13/2024,52834,,16245,Terminal SE - Efectivo TPV,79213,0,"81692619,2"
05/13/2024,52826,,16222,Terminal SE - Efectivo TPV,93198,0,"81785817,2"
05/13/2024,52835,,16251,Terminal SE - Efectivo TPV,"161899,99",0,"81947717,19"
05/13/2024,52828,,16229,Terminal SE - Efectivo TPV,75717,0,"82023434,19"
05/13/2024,52833,,16243,Terminal SE - Efectivo TPV,84075,0,"82107509,19"
05/13/2024,52837,,16262,Terminal SE - Efectivo TPV,97241,0,"82204750,19"
05/13/2024,52832,,16238,Terminal SE - Efectivo TPV,106145,0,"82310895,19"
05/13/2024,52825,,16214,Terminal SE - Efectivo TPV,111850,0,"82422745,19"
05/13/2024,52822,,16199,Terminal SE - Efectivo TPV,99098,0,"82521843,19"
05/13/2024,52831,,16237,Terminal SE - Efectivo TPV,4000,0,"82525843,19"
05/13/2024,52269,,,Terminal SE - Efectivo TPV,1968250,0,"84494093,19"
05/13/2024,52269,,,Terminal SE - Efectivo TPV,0,1968250,"82525843,19"
05/13/2024,52829,,16230,Terminal SE - Efectivo TPV,"177919,01",0,"82703762,2"
05/13/2024,52823,,16200,Terminal SE - Efectivo TPV,"11000,01",0,"82714762,21"
05/13/2024,52838,,16283,Terminal SE - Efectivo TPV,"110788,99",0,"82825551,2"
05/13/2024,52839,,16286,Terminal SE - Efectivo TPV,10000,0,"82835551,2"
05/13/2024,52830,,16234,Terminal SE - Efectivo TPV,57000,0,"82892551,2"
05/13/2024,52827,,16224,Terminal SE - Efectivo TPV,76700,0,"82969251,2"
05/13/2024,52836,,16257,Terminal SE - Efectivo TPV,"205516,99",0,"83174768,19"
05/13/2024,52821,,16193,Terminal SE - Efectivo TPV,103000,0,"83277768,19"
05/14/2024,52840,,,Terminal SE - Efectivo TPV,0,1769200,"81508568,19"
05/14/2024,52840,,,Terminal SE - Efectivo TPV,1769200,0,"83277768,19"
05/15/2024,53142,,16310,Terminal SE - Efectivo TPV,127560,0,"83405328,19"
05/15/2024,53144,,16315,Terminal SE - Efectivo TPV,"54999,99",0,"83460328,18"
05/15/2024,53143,,16313,Terminal SE - Efectivo TPV,5800,0,"83466128,18"
05/16/2024,53145,,,Terminal SE - Efectivo TPV,0,188300,"83277828,18"
05/16/2024,53145,,,Terminal SE - Efectivo TPV,188300,0,"83466128,18"
05/16/2024,53297,,16363,Terminal SE - Efectivo TPV,5000,0,"83471128,18"
05/16/2024,53298,,16369,Terminal SE - Efectivo TPV,"10023,99",0,"83481152,17"
05/16/2024,53293,,16352,Terminal SE - Efectivo TPV,"121059,01",0,"83602211,18"
05/16/2024,53294,,16354,Terminal SE - Efectivo TPV,18000,0,"83620211,18"
05/16/2024,53295,,16355,Terminal SE - Efectivo TPV,"90684,99",0,"83710896,17"
05/16/2024,53296,,16362,Terminal SE - Efectivo TPV,"136399,99",0,"83847296,16"
05/16/2024,53299,,16373,Terminal SE - Efectivo TPV,82400,0,"83929696,16"
05/17/2024,53675,,16387,Terminal SE - Efectivo TPV,"79704,99",0,"84009401,15"
05/17/2024,53680,,16425,Terminal SE - Efectivo TPV,86315,0,"84095716,15"
05/17/2024,53681,,16426,Terminal SE - Efectivo TPV,56250,0,"84151966,15"
05/17/2024,53674,,16385,Terminal SE - Efectivo TPV,96148,0,"84248114,15"
05/17/2024,53673,,16383,Terminal SE - Efectivo TPV,"85877,99",0,"84333992,14"
05/17/2024,53300,,,Terminal SE - Efectivo TPV,0,463500,"83870492,14"
05/17/2024,53300,,,Terminal SE - Efectivo TPV,463500,0,"84333992,14"
05/17/2024,53682,,16429,Terminal SE - Efectivo TPV,"80305,99",0,"84414298,13"
05/17/2024,53676,,16392,Terminal SE - Efectivo TPV,9100,0,"84423398,13"
05/17/2024,53677,,16394,Terminal SE - Efectivo TPV,"88827,99",0,"84512226,12"
05/17/2024,53678,,16402,Terminal SE - Efectivo TPV,"99999,99",0,"84612226,11"
05/17/2024,53679,,16408,Terminal SE - Efectivo TPV,61500,0,"84673726,11"
05/18/2024,54160,,16498,Terminal SE - Efectivo TPV,52500,0,"84726226,11"
05/18/2024,53683,,,Terminal SE - Efectivo TPV,0,744100,"83982126,11"
05/18/2024,53683,,,Terminal SE - Efectivo TPV,744100,0,"84726226,11"
05/18/2024,54164,,16514,Terminal SE - Efectivo TPV,74100,0,"84800326,11"
05/18/2024,54161,,16502,Terminal SE - Efectivo TPV,"107197,99",0,"84907524,1"
05/18/2024,54156,,16469,Terminal SE - Efectivo TPV,"225838,99",0,"85133363,09"
05/18/2024,54159,,16497,Terminal SE - Efectivo TPV,85987,0,"85219350,09"
05/18/2024,54166,,16524,Terminal SE - Efectivo TPV,208958,0,"85428308,09"
05/18/2024,54155,,16458,Terminal SE - Efectivo TPV,154900,0,"85583208,09"
05/18/2024,54163,,16507,Terminal SE - Efectivo TPV,"177869,01",0,"85761077,1"
05/18/2024,54165,,16516,Terminal SE - Efectivo TPV,"120949,99",0,"85882027,09"
05/18/2024,54167,,16532,Terminal SE - Efectivo TPV,116763,0,"85998790,09"
05/18/2024,54158,,16484,Terminal SE - Efectivo TPV,"26388,99",0,"86025179,08"
05/18/2024,54162,,16505,Terminal SE - Efectivo TPV,129600,0,"86154779,08"
05/18/2024,54157,,16479,Terminal SE - Efectivo TPV,83900,0,"86238679,08"
05/19/2024,54168,,,Terminal SE - Efectivo TPV,0,1565000,"84673679,08"
05/19/2024,54657,,16615,Terminal SE - Efectivo TPV,173600,0,"84847279,08"
05/19/2024,54658,,16622,Terminal SE - Efectivo TPV,"9222,99",0,"84856502,07"
05/19/2024,54656,,16610,Terminal SE - Efectivo TPV,40000,0,"84896502,07"
05/19/2024,54653,,16593,Terminal SE - Efectivo TPV,6700,0,"84903202,07"
05/19/2024,54168,,,Terminal SE - Efectivo TPV,1565000,0,"86468202,07"
05/19/2024,54648,,16552,Terminal SE - Efectivo TPV,78066,0,"86546268,07"
05/19/2024,54651,,16565,Terminal SE - Efectivo TPV,72220,0,"86618488,07"
05/19/2024,54654,,16598,Terminal SE - Efectivo TPV,233159,0,"86851647,07"
05/19/2024,54649,,16558,Terminal SE - Efectivo TPV,63800,0,"86915447,07"
05/19/2024,54655,,16608,Terminal SE - Efectivo TPV,63000,0,"86978447,07"
05/19/2024,54652,,16578,Terminal SE - Efectivo TPV,"373999,96",0,"87352447,03"
05/19/2024,54650,,16559,Terminal SE - Efectivo TPV,68000,0,"87420447,03"
05/20/2024,54659,,,Terminal SE - Efectivo TPV,1181300,0,"88601747,03"
05/20/2024,54659,,,Terminal SE - Efectivo TPV,0,1181300,"87420447,03"
05/22/2024,55037,,16660,Terminal SE - Efectivo TPV,97459,0,"87517906,03"
05/22/2024,55036,,16651,Terminal SE - Efectivo TPV,91231,0,"87609137,03"
05/23/2024,55208,,16696,Terminal SE - Efectivo TPV,"138759,01",0,"87747896,04"
05/23/2024,55038,,,Terminal SE - Efectivo TPV,0,186800,"87561096,04"
05/23/2024,55038,,,Terminal SE - Efectivo TPV,186800,0,"87747896,04"
05/23/2024,55209,,16708,Terminal SE - Efectivo TPV,190000,0,"87937896,04"
05/24/2024,55210,,,Terminal SE - Efectivo TPV,0,328800,"87609096,04"
05/24/2024,55210,,,Terminal SE - Efectivo TPV,328800,0,"87937896,04"
05/24/2024,55490,,16783,Terminal SE - Efectivo TPV,78284,0,"88016180,04"
05/24/2024,55491,,16788,Terminal SE - Efectivo TPV,56500,0,"88072680,04"
05/24/2024,55489,,16771,Terminal SE - Efectivo TPV,51850,0,"88124530,04"
05/24/2024,55488,,16751,Terminal SE - Efectivo TPV,"80742,99",0,"88205273,03"
05/24/2024,55487,,16749,Terminal SE - Efectivo TPV,67000,0,"88272273,03"
05/25/2024,55989,,16864,Terminal SE - Efectivo TPV,192897,0,"88465170,03"
05/25/2024,55492,,,Terminal SE - Efectivo TPV,334400,0,"88799570,03"
05/25/2024,55492,,,Terminal SE - Efectivo TPV,0,334400,"88465170,03"
05/25/2024,55990,,16867,Terminal SE - Efectivo TPV,"102703,99",0,"88567874,02"
05/25/2024,55991,,16868,Terminal SE - Efectivo TPV,"114176,01",0,"88682050,03"
05/25/2024,55992,,16870,Terminal SE - Efectivo TPV,"129600,01",0,"88811650,04"
05/25/2024,55986,,16854,Terminal SE - Efectivo TPV,"62500,01",0,"88874150,05"
05/25/2024,55980,,16836,Terminal SE - Efectivo TPV,7200,0,"88881350,05"
05/25/2024,55978,,16833,Terminal SE - Efectivo TPV,"66500,01",0,"88947850,06"
05/25/2024,55987,,16857,Terminal SE - Efectivo TPV,"264000,01",0,"89211850,07"
05/25/2024,55985,,16850,Terminal SE - Efectivo TPV,88700,0,"89300550,07"
05/25/2024,55988,,16858,Terminal SE - Efectivo TPV,16000,0,"89316550,07"
05/25/2024,55981,,16837,Terminal SE - Efectivo TPV,"110000,01",0,"89426550,08"
05/25/2024,55979,,16835,Terminal SE - Efectivo TPV,69800,0,"89496350,08"
05/25/2024,55984,,16848,Terminal SE - Efectivo TPV,95555,0,"89591905,08"
05/25/2024,55975,,16821,Terminal SE - Efectivo TPV,"111999,99",0,"89703905,07"
05/25/2024,55977,,16827,Terminal SE - Efectivo TPV,"109805,99",0,"89813711,06"
05/25/2024,55982,,16843,Terminal SE - Efectivo TPV,70636,0,"89884347,06"
05/25/2024,55993,,16877,Terminal SE - Efectivo TPV,80852,0,"89965199,06"
05/25/2024,55983,,16844,Terminal SE - Efectivo TPV,204861,0,"90170060,06"
05/25/2024,55976,,16823,Terminal SE - Efectivo TPV,82873,0,"90252933,06"
05/26/2024,56490,,16904,Terminal SE - Efectivo TPV,"93635,01",0,"90346568,07"
05/26/2024,56493,,16918,Terminal SE - Efectivo TPV,84348,0,"90430916,07"
05/26/2024,56489,,16901,Terminal SE - Efectivo TPV,57000,0,"90487916,07"
05/26/2024,56504,,16957,Terminal SE - Efectivo TPV,174924,0,"90662840,07"
05/26/2024,56502,,16944,Terminal SE - Efectivo TPV,166129,0,"90828969,07"
05/26/2024,56499,,16938,Terminal SE - Efectivo TPV,"167166,99",0,"90996136,06"
05/26/2024,56495,,16929,Terminal SE - Efectivo TPV,"85598,99",0,"91081735,05"
05/26/2024,56494,,16928,Terminal SE - Efectivo TPV,"63000,01",0,"91144735,06"
05/26/2024,56491,,16907,Terminal SE - Efectivo TPV,198950,0,"91343685,06"
05/26/2024,56503,,16952,Terminal SE - Efectivo TPV,81562,0,"91425247,06"
05/26/2024,56501,,16942,Terminal SE - Efectivo TPV,"88171,99",0,"91513419,05"
05/26/2024,55994,,,Terminal SE - Efectivo TPV,1980750,0,"93494169,05"
05/26/2024,55994,,,Terminal SE - Efectivo TPV,0,1980750,"91513419,05"
05/26/2024,56498,,16937,Terminal SE - Efectivo TPV,156241,0,"91669660,05"
05/26/2024,56505,,16961,Terminal SE - Efectivo TPV,156678,0,"91826338,05"
05/26/2024,56497,,16932,Terminal SE - Efectivo TPV,86151,0,"91912489,05"
05/26/2024,56500,,16939,Terminal SE - Efectivo TPV,"80523,99",0,"91993013,04"
05/26/2024,56496,,16931,Terminal SE - Efectivo TPV,"177000,01",0,"92170013,05"
05/26/2024,56492,,16912,Terminal SE - Efectivo TPV,170226,0,"92340239,05"
05/26/2024,56506,,16966,Terminal SE - Efectivo TPV,"79868,99",0,"92420108,04"
05/27/2024,56507,,,Terminal SE - Efectivo TPV,2167200,0,"94587308,04"
05/27/2024,56507,,,Terminal SE - Efectivo TPV,0,2167200,"92420108,04"
05/29/2024,56654,,16987,Terminal SE - Efectivo TPV,60311,0,"92480419,04"
05/29/2024,56657,,16995,Terminal SE - Efectivo TPV,70800,0,"92551219,04"
05/29/2024,56658,,17001,Terminal SE - Efectivo TPV,"164489,99",0,"92715709,03"
05/29/2024,56656,,16990,Terminal SE - Efectivo TPV,"56500,01",0,"92772209,04"
05/29/2024,56655,,16988,Terminal SE - Efectivo TPV,"143129,99",0,"92915339,03"
05/30/2024,56659,,,Terminal SE - Efectivo TPV,0,495250,"92420089,03"
05/30/2024,56659,,,Terminal SE - Efectivo TPV,495250,0,"92915339,03"
05/30/2024,56858,,17046,Terminal SE - Efectivo TPV,10000,0,"92925339,03"
05/30/2024,56851,,17010,Terminal SE - Efectivo TPV,63000,0,"92988339,03"
05/30/2024,56852,,17012,Terminal SE - Efectivo TPV,"475116,01",0,"93463455,04"
05/30/2024,56853,,17017,Terminal SE - Efectivo TPV,107293,0,"93570748,04"
05/30/2024,56854,,17020,Terminal SE - Efectivo TPV,"228296,99",0,"93799045,03"
05/30/2024,56855,,17029,Terminal SE - Efectivo TPV,"202020,01",0,"94001065,04"
05/30/2024,56856,,17034,Terminal SE - Efectivo TPV,"70000,01",0,"94071065,05"
05/30/2024,56857,,17044,Terminal SE - Efectivo TPV,170000,0,"94241065,05"
05/31/2024,57364,,17072,Terminal SE - Efectivo TPV,52554,0,"94293619,05"
05/31/2024,57363,,17070,Terminal SE - Efectivo TPV,111000,0,"94404619,05"
05/31/2024,56859,,,Terminal SE - Efectivo TPV,0,1325750,"93078869,05"
05/31/2024,56859,,,Terminal SE - Efectivo TPV,1325750,0,"94404619,05"
05/31/2024,57365,,17074,Terminal SE - Efectivo TPV,"290000,01",0,"94694619,06"
05/31/2024,57366,,17075,Terminal SE - Efectivo TPV,55500,0,"94750119,06"
05/31/2024,57367,,17076,Terminal SE - Efectivo TPV,63000,0,"94813119,06"
05/31/2024,57368,,17081,Terminal SE - Efectivo TPV,66211,0,"94879330,06"
05/31/2024,57369,,17091,Terminal SE - Efectivo TPV,"89701,99",0,"94969032,05"
05/31/2024,57370,,17093,Terminal SE - Efectivo TPV,47040,0,"95016072,05"
05/31/2024,57371,,17152,Terminal SE - Efectivo TPV,"295125,99",0,"95311198,04"
