FECHA,N° DOC,TERCERO,DESCRIPCIÓN,ORIGEN,DEBITO,CREDITO,SALDO
01/02/2024,11751,,9163,Terminal LS - Transferencia TPV,"142799,99",0,"-5042365,05"
01/02/2024,11750,,9161,Terminal LS - Transferencia TPV,"86350,01",0,"-4956015,04"
01/02/2024,11749,,9151,Terminal LS - Transferencia TPV,"77000,01",0,"-4879015,03"
01/02/2024,11748,,9147,Terminal LS - Transferencia TPV,54000,0,"-4825015,03"
01/02/2024,11747,,9141,Terminal LS - Transferencia TPV,52800,0,"-4772215,03"
01/02/2024,11745,,9167,Terminal LS - Tarjeta TPV,71500,0,"-4700715,03"
01/02/2024,11744,,9166,Terminal LS - Tarjeta TPV,84700,0,"-4616015,03"
01/02/2024,11743,,9162,Terminal LS - Tarjeta TPV,59400,0,"-4556615,03"
01/02/2024,11742,,9159,Terminal LS - Tarjeta TPV,68200,0,"-4488415,03"
01/02/2024,11741,,9158,Terminal LS - Tarjeta TPV,133760,0,"-4354655,03"
01/02/2024,11740,,9157,Terminal LS - Tarjeta TPV,197692,0,"-4156963,03"
01/02/2024,11739,,9155,Terminal LS - Tarjeta TPV,"138930,01",0,"-4018033,02"
01/02/2024,11738,,9153,Terminal LS - Tarjeta TPV,140250,0,"-4989419,58"
01/02/2024,11737,,9146,Terminal LS - Tarjeta TPV,"56100,01",0,"-4933319,57"
01/02/2024,11736,,9143,Terminal LS - Tarjeta TPV,63800,0,"-4869519,57"
01/02/2024,11735,,9142,Terminal LS - Tarjeta TPV,60346,0,"-4809173,57"
01/02/2024,11753,,9165,Terminal LS - Transferencia TPV,"70950,01",0,"-4738223,56"
01/02/2024,11752,,9164,Terminal LS - Transferencia TPV,118250,0,"-6680740,66"
01/03/2024,11754,,,Terminal LS - Transferencia TPV,0,602200,"-7282940,66"
01/03/2024,11746,,,Terminal LS - Tarjeta TPV,0,1074678,"-8357618,66"
01/03/2024,11857,,9174,Terminal LS - Tarjeta TPV,"74800,01",0,"-8282818,65"
01/03/2024,11859,,9184,Terminal LS - Tarjeta TPV,"62699,99",0,"-8220118,66"
01/03/2024,11860,,9185,Terminal LS - Tarjeta TPV,"81400,01",0,"-8138718,65"
01/03/2024,11861,,9186,Terminal LS - Tarjeta TPV,75900,0,"-8062818,65"
01/03/2024,11862,,9188,Terminal LS - Tarjeta TPV,119900,0,"-7942918,65"
01/03/2024,11863,,9190,Terminal LS - Tarjeta TPV,63000,0,"-7879918,65"
01/03/2024,11864,,9191,Terminal LS - Tarjeta TPV,"70180,01",0,"-7809738,64"
01/03/2024,11865,,9195,Terminal LS - Tarjeta TPV,"156310,01",0,"-7653428,63"
01/03/2024,11874,,9181,Terminal LS - Transferencia TPV,62000,0,"-7886828,57"
01/03/2024,11875,,9182,Terminal LS - Transferencia TPV,51000,0,"-7835828,57"
01/03/2024,11876,,9187,Terminal LS - Transferencia TPV,131450,0,"-7704378,57"
01/03/2024,11877,,9189,Terminal LS - Transferencia TPV,208450,0,"-7495928,57"
01/03/2024,11873,,9179,Terminal LS - Transferencia TPV,"53500,01",0,"-7442428,56"
01/03/2024,11872,,9178,Terminal LS - Transferencia TPV,58300,0,"-7449906,96"
01/03/2024,11871,,9177,Terminal LS - Transferencia TPV,"75680,01",0,"-7374226,95"
01/03/2024,11870,,9176,Terminal LS - Transferencia TPV,59000,0,"-7315226,95"
01/03/2024,11869,,9173,Terminal LS - Transferencia TPV,"34800,01",0,"-7280426,94"
01/03/2024,11868,,9172,Terminal LS - Transferencia TPV,155000,0,"-7125426,94"
01/03/2024,11867,,9170,Terminal LS - Transferencia TPV,194000,0,"-6931426,94"
01/03/2024,11858,,9180,Terminal LS - Tarjeta TPV,168300,0,"-6763126,94"
01/04/2024,12310,,9263,Terminal LS - Transferencia TPV,"62500,02",0,"-6700626,92"
01/04/2024,12311,,9263,Terminal LS - Transferencia TPV,6250,0,"-6694376,92"
01/04/2024,12298,,9229,Terminal LS - Transferencia TPV,"148500,01",0,"-6545876,91"
01/04/2024,12297,,9227,Terminal LS - Transferencia TPV,101000,0,"-6444876,91"
01/04/2024,12305,,9255,Terminal LS - Transferencia TPV,72600,0,"-6372276,91"
01/04/2024,12307,,9258,Terminal LS - Transferencia TPV,163900,0,"-6619406,83"
01/04/2024,12293,,9196,Terminal LS - Transferencia TPV,341145,0,"-6278261,83"
01/04/2024,12295,,9215,Terminal LS - Transferencia TPV,"192499,99",0,"-7143003,39"
01/04/2024,12294,,9214,Terminal LS - Transferencia TPV,59000,0,"-7084003,39"
01/04/2024,12291,,9252,Terminal LS - Tarjeta TPV,"61600,01",0,"-7022403,38"
01/04/2024,12286,,9232,Terminal LS - Tarjeta TPV,"111429,99",0,"-7367232,67"
01/04/2024,11878,,,Terminal LS - Transferencia TPV,0,1083180,"-8450412,67"
01/04/2024,12282,,9207,Terminal LS - Tarjeta TPV,"62150,01",0,"-8388262,66"
01/04/2024,12283,,9209,Terminal LS - Tarjeta TPV,"110000,01",0,"-8278262,65"
01/04/2024,12284,,9216,Terminal LS - Tarjeta TPV,17000,0,"-8261262,65"
01/04/2024,12285,,9224,Terminal LS - Tarjeta TPV,"72050,01",0,"-8189212,64"
01/04/2024,12300,,9235,Terminal LS - Transferencia TPV,60500,0,"-8128712,64"
01/04/2024,12301,,9242,Terminal LS - Transferencia TPV,67430,0,"-8061282,64"
01/04/2024,12302,,9243,Terminal LS - Transferencia TPV,128238,0,"-7933044,64"
01/04/2024,12303,,9245,Terminal LS - Transferencia TPV,"135850,01",0,"-7797194,63"
01/04/2024,12304,,9249,Terminal LS - Transferencia TPV,"82500,02",0,"-7714694,61"
01/04/2024,12287,,9236,Terminal LS - Tarjeta TPV,120780,0,"-7593914,61"
01/04/2024,12308,,9259,Terminal LS - Transferencia TPV,"65450,01",0,"-7528464,6"
01/04/2024,11866,,,Terminal LS - Tarjeta TPV,0,872489,"-8400953,6"
01/04/2024,12296,,9220,Terminal LS - Transferencia TPV,52000,0,"-8348953,6"
01/04/2024,12306,,9257,Terminal LS - Transferencia TPV,"289714,01",0,"-8059239,59"
01/04/2024,12309,,9262,Terminal LS - Transferencia TPV,"151250,02",0,"-7907989,57"
01/04/2024,12288,,9237,Terminal LS - Tarjeta TPV,"263890,01",0,"-7644099,56"
01/04/2024,12289,,9240,Terminal LS - Tarjeta TPV,75500,0,"-7568599,56"
01/04/2024,12299,,9233,Terminal LS - Transferencia TPV,"127050,02",0,"-7441549,54"
01/04/2024,12290,,9241,Terminal LS - Tarjeta TPV,74250,0,"-7367299,54"
01/05/2024,12822,,9323,Terminal LS - Transferencia TPV,133650,0,"-7377569,33"
01/05/2024,12823,,9324,Terminal LS - Transferencia TPV,"63029,99",0,"-7314539,34"
01/05/2024,12821,,9321,Terminal LS - Transferencia TPV,109900,0,"-7204639,34"
01/05/2024,12292,,,Terminal LS - Tarjeta TPV,0,968649,"-8173288,34"
01/05/2024,12312,,,Terminal LS - Transferencia TPV,0,2307477,"-10480765,34"
01/05/2024,12830,,9347,Terminal LS - Transferencia TPV,"94600,01",0,"-10759965,33"
01/05/2024,12818,,9311,Terminal LS - Transferencia TPV,159610,0,"-10600355,33"
01/05/2024,12831,,9348,Terminal LS - Transferencia TPV,"128700,02",0,"-10471655,31"
01/05/2024,12834,,9355,Terminal LS - Transferencia TPV,"71499,99",0,"-10400155,32"
01/05/2024,12824,,9325,Terminal LS - Transferencia TPV,61000,0,"-10339155,32"
01/05/2024,12827,,9338,Terminal LS - Transferencia TPV,"76000,01",0,"-10263155,31"
01/05/2024,12816,,9298,Terminal LS - Transferencia TPV,6000,0,"-10257155,31"
01/05/2024,12833,,9352,Terminal LS - Transferencia TPV,"269999,99",0,"-9987155,32"
01/05/2024,12819,,9318,Terminal LS - Transferencia TPV,57000,0,"-9930155,32"
01/05/2024,12825,,9330,Terminal LS - Transferencia TPV,77770,0,"-9852385,32"
01/05/2024,12828,,9343,Terminal LS - Transferencia TPV,95700,0,"-9756685,32"
01/05/2024,12832,,9351,Terminal LS - Transferencia TPV,222310,0,"-9534375,32"
01/05/2024,12826,,9332,Terminal LS - Transferencia TPV,"94449,99",0,"-9439925,33"
01/05/2024,12829,,9344,Terminal LS - Transferencia TPV,153000,0,"-10081613,73"
01/05/2024,12814,,9295,Terminal LS - Transferencia TPV,"141000,01",0,"-9940613,72"
01/05/2024,12815,,9296,Terminal LS - Transferencia TPV,"55500,01",0,"-9885113,71"
01/05/2024,12817,,9302,Terminal LS - Transferencia TPV,"71720,01",0,"-9813393,7"
01/05/2024,12835,,9360,Terminal LS - Transferencia TPV,"103950,01",0,"-9709443,69"
01/05/2024,12820,,9320,Terminal LS - Transferencia TPV,"64500,01",0,"-9644943,68"
01/05/2024,12836,,9361,Terminal LS - Transferencia TPV,124300,0,"-9819643,41"
01/06/2024,13560,,9390,Terminal LS - Transferencia TPV,"103950,01",0,"-9715693,4"
01/06/2024,13570,,9433,Terminal LS - Transferencia TPV,54000,0,"-9661693,4"
01/06/2024,12837,,,Terminal LS - Transferencia TPV,0,2699538,"-12361231,4"
01/06/2024,13561,,9398,Terminal LS - Transferencia TPV,55500,0,"-12305731,4"
01/06/2024,13539,,9413,Terminal LS - Tarjeta TPV,"83050,01",0,"-12222681,39"
01/06/2024,13541,,9432,Terminal LS - Tarjeta TPV,"124024,99",0,"-12098656,4"
01/06/2024,13581,,9492,Terminal LS - Transferencia TPV,"95999,99",0,"-12002656,41"
01/06/2024,13543,,9438,Terminal LS - Tarjeta TPV,"70950,02",0,"-11931706,39"
01/06/2024,13551,,9483,Terminal LS - Tarjeta TPV,"153450,01",0,"-11778256,38"
01/06/2024,13580,,9491,Terminal LS - Transferencia TPV,61050,0,"-11717206,38"
01/06/2024,13571,,9436,Terminal LS - Transferencia TPV,54000,0,"-11663206,38"
01/06/2024,13554,,9494,Terminal LS - Tarjeta TPV,"137170,01",0,"-11526036,37"
01/06/2024,13574,,9453,Terminal LS - Transferencia TPV,90090,0,"-11435946,37"
01/06/2024,13549,,9476,Terminal LS - Tarjeta TPV,105600,0,"-11330346,37"
01/06/2024,13576,,9459,Terminal LS - Transferencia TPV,"180000,01",0,"-11150346,36"
01/06/2024,13569,,9431,Terminal LS - Transferencia TPV,74800,0,"-11075546,36"
01/06/2024,13563,,9406,Terminal LS - Transferencia TPV,113850,0,"-10961696,36"
01/06/2024,13582,,9493,Terminal LS - Transferencia TPV,"78100,01",0,"-10883596,35"
01/06/2024,13567,,9415,Terminal LS - Transferencia TPV,133000,0,"-10750596,35"
01/06/2024,13579,,9484,Terminal LS - Transferencia TPV,69850,0,"-10680746,35"
01/06/2024,13564,,9408,Terminal LS - Transferencia TPV,44250,0,"-10636496,35"
01/06/2024,13566,,9414,Terminal LS - Transferencia TPV,188000,0,"-10448496,35"
01/06/2024,13544,,9446,Terminal LS - Tarjeta TPV,61600,0,"-10386896,35"
01/06/2024,13583,,9495,Terminal LS - Transferencia TPV,"189475,01",0,"-10197421,34"
01/06/2024,13555,,9496,Terminal LS - Tarjeta TPV,40800,0,"-13884899,3"
01/06/2024,13556,,9496,Terminal LS - Tarjeta TPV,163250,0,"-13721649,3"
01/06/2024,13575,,9456,Terminal LS - Transferencia TPV,99000,0,"-13622649,3"
01/06/2024,13548,,9471,Terminal LS - Tarjeta TPV,"69300,01",0,"-13553349,29"
01/06/2024,13550,,9480,Terminal LS - Tarjeta TPV,135300,0,"-13418049,29"
01/06/2024,13559,,9371,Terminal LS - Transferencia TPV,54450,0,"-13363599,29"
01/06/2024,13572,,9440,Terminal LS - Transferencia TPV,69300,0,"-13592836,97"
01/06/2024,13577,,9461,Terminal LS - Transferencia TPV,229900,0,"-13362936,97"
01/06/2024,13542,,9437,Terminal LS - Tarjeta TPV,68750,0,"-13294186,97"
01/06/2024,13568,,9425,Terminal LS - Transferencia TPV,"149999,99",0,"-13144186,98"
01/06/2024,13562,,9400,Terminal LS - Transferencia TPV,"55500,01",0,"-13088686,97"
01/06/2024,13573,,9450,Terminal LS - Transferencia TPV,"77550,01",0,"-13011136,96"
01/06/2024,13538,,9363,Terminal LS - Tarjeta TPV,"142600,01",0,"-12868536,95"
01/06/2024,13540,,9422,Terminal LS - Tarjeta TPV,"84700,01",0,"-12783836,94"
01/06/2024,13547,,9470,Terminal LS - Tarjeta TPV,45000,0,"-12738836,94"
01/06/2024,13546,,9463,Terminal LS - Tarjeta TPV,140580,0,"-12598256,94"
01/06/2024,13584,,9497,Terminal LS - Transferencia TPV,"97950,01",0,"-12500306,93"
01/06/2024,13558,,9369,Terminal LS - Transferencia TPV,68500,0,"-12431806,93"
01/06/2024,13578,,9482,Terminal LS - Transferencia TPV,75350,0,"-12356456,93"
01/06/2024,13553,,9487,Terminal LS - Tarjeta TPV,46000,0,"-12310456,93"
01/06/2024,13545,,9454,Terminal LS - Tarjeta TPV,118800,0,"-12191656,93"
01/06/2024,13552,,9485,Terminal LS - Tarjeta TPV,"78650,01",0,"-12113006,92"
01/06/2024,13565,,9411,Terminal LS - Transferencia TPV,"58000,01",0,"-12055006,91"
01/07/2024,14408,,9561,Terminal LS - Tarjeta TPV,"18750,01",0,"-12036256,9"
01/07/2024,14418,,9629,Terminal LS - Tarjeta TPV,"133650,01",0,"-11902606,89"
01/07/2024,14430,,9589,Terminal LS - Transferencia TPV,"67650,01",0,"-11834956,88"
01/07/2024,14415,,9602,Terminal LS - Tarjeta TPV,45000,0,"-11789956,88"
01/07/2024,14417,,9612,Terminal LS - Tarjeta TPV,"89100,01",0,"-11700856,87"
01/07/2024,14427,,9579,Terminal LS - Transferencia TPV,"65500,01",0,"-11635356,86"
01/07/2024,14422,,9511,Terminal LS - Transferencia TPV,"92950,01",0,"-11542406,85"
01/07/2024,14406,,9551,Terminal LS - Tarjeta TPV,41000,0,"-11501406,85"
01/07/2024,14428,,9580,Terminal LS - Transferencia TPV,106500,0,"-11394906,85"
01/07/2024,14405,,9546,Terminal LS - Tarjeta TPV,"75900,01",0,"-11319006,84"
01/07/2024,14424,,9554,Terminal LS - Transferencia TPV,"67430,01",0,"-11251576,83"
01/07/2024,14413,,9595,Terminal LS - Tarjeta TPV,294400,0,"-10957176,83"
01/07/2024,14409,,9570,Terminal LS - Tarjeta TPV,"65450,01",0,"-10891726,82"
01/07/2024,14407,,9555,Terminal LS - Tarjeta TPV,178200,0,"-10713526,82"
01/07/2024,14403,,9513,Terminal LS - Tarjeta TPV,130350,0,"-10583176,82"
01/07/2024,14429,,9587,Terminal LS - Transferencia TPV,53000,0,"-10530176,82"
01/07/2024,14431,,9624,Terminal LS - Transferencia TPV,101200,0,"-10428976,82"
01/07/2024,14412,,9593,Terminal LS - Tarjeta TPV,"86680,02",0,"-10342296,8"
01/07/2024,14416,,9605,Terminal LS - Tarjeta TPV,"119020,01",0,"-10223276,79"
01/07/2024,14414,,9601,Terminal LS - Tarjeta TPV,46000,0,"-10177276,79"
01/07/2024,13557,,,Terminal LS - Tarjeta TPV,0,1869574,"-12046850,79"
01/07/2024,14410,,9574,Terminal LS - Tarjeta TPV,15000,0,"-12031850,79"
01/07/2024,13585,,,Terminal LS - Transferencia TPV,0,2621364,"-14881614,79"
01/07/2024,14420,,9500,Terminal LS - Transferencia TPV,176770,0,"-14804844,79"
01/07/2024,14426,,9575,Terminal LS - Transferencia TPV,120890,0,"-14683954,79"
01/07/2024,14423,,9520,Terminal LS - Transferencia TPV,4860,0,"-14679094,79"
01/07/2024,14432,,9627,Terminal LS - Transferencia TPV,"110000,01",0,"-14569094,78"
01/07/2024,14425,,9558,Terminal LS - Transferencia TPV,98000,0,"-14471094,78"
01/07/2024,14421,,9504,Terminal LS - Transferencia TPV,"65999,99",0,"-14405094,79"
01/07/2024,14411,,9591,Terminal LS - Tarjeta TPV,62975,0,"-14342119,79"
01/07/2024,14404,,9534,Terminal LS - Tarjeta TPV,132000,0,"-14210119,79"
01/08/2024,14908,,9658,Terminal LS - Tarjeta TPV,92400,0,"-14117719,79"
01/08/2024,14924,,9666,Terminal LS - Transferencia TPV,78100,0,"-14039619,79"
01/08/2024,14914,,9707,Terminal LS - Tarjeta TPV,"68420,01",0,"-13971199,78"
01/08/2024,14915,,9708,Terminal LS - Tarjeta TPV,69300,0,"-13901899,78"
01/08/2024,14433,,,Terminal LS - Transferencia TPV,0,1130849,"-15032748,78"
01/08/2024,14419,,,Terminal LS - Tarjeta TPV,0,1533475,"-16566223,78"
01/08/2024,14918,,9717,Terminal LS - Tarjeta TPV,"65450,01",0,"-16500773,77"
01/08/2024,14921,,9726,Terminal LS - Tarjeta TPV,74250,0,"-16426523,77"
01/08/2024,14911,,9684,Terminal LS - Tarjeta TPV,"105600,01",0,"-16320923,76"
01/08/2024,14932,,9700,Terminal LS - Transferencia TPV,"115999,99",0,"-16204923,77"
01/08/2024,14931,,9699,Terminal LS - Transferencia TPV,66550,0,"-16138373,77"
01/08/2024,14926,,9686,Terminal LS - Transferencia TPV,18200,0,"-16120173,77"
01/08/2024,14939,,9729,Terminal LS - Transferencia TPV,202400,0,"-16619965,76"
01/08/2024,14919,,9724,Terminal LS - Tarjeta TPV,75130,0,"-16544835,76"
01/08/2024,14912,,9704,Terminal LS - Tarjeta TPV,"523654,98",0,"-16021180,78"
01/08/2024,14910,,9664,Terminal LS - Tarjeta TPV,119680,0,"-15901500,78"
01/08/2024,14936,,9721,Terminal LS - Transferencia TPV,64350,0,"-15837150,78"
01/08/2024,14916,,9711,Terminal LS - Tarjeta TPV,"157146,01",0,"-15680004,77"
01/08/2024,14933,,9701,Terminal LS - Transferencia TPV,56000,0,"-15624004,77"
01/08/2024,14913,,9706,Terminal LS - Tarjeta TPV,80630,0,"-15543374,77"
01/08/2024,14938,,9728,Terminal LS - Transferencia TPV,140250,0,"-15403124,77"
01/08/2024,14928,,9694,Terminal LS - Transferencia TPV,"63800,01",0,"-15339324,76"
01/08/2024,14929,,9695,Terminal LS - Transferencia TPV,"84700,01",0,"-15254624,75"
01/08/2024,14925,,9679,Terminal LS - Transferencia TPV,"100999,99",0,"-15153624,76"
01/08/2024,14930,,9698,Terminal LS - Transferencia TPV,141460,0,"-15012164,76"
01/08/2024,14934,,9702,Terminal LS - Transferencia TPV,54000,0,"-14958164,76"
01/08/2024,14927,,9691,Terminal LS - Transferencia TPV,"54000,01",0,"-14904164,75"
01/08/2024,14909,,9662,Terminal LS - Tarjeta TPV,82896,0,"-14821268,75"
01/08/2024,14898,,9686,Terminal LS - Efectivo TPV,"50000,01",0,"-14771268,74"
01/08/2024,14935,,9703,Terminal LS - Transferencia TPV,"93720,01",0,"-14677548,73"
01/08/2024,14937,,9727,Terminal LS - Transferencia TPV,155300,0,"-14522248,73"
01/08/2024,14920,,9725,Terminal LS - Tarjeta TPV,"160050,01",0,"-14362198,72"
01/08/2024,14917,,9713,Terminal LS - Tarjeta TPV,61050,0,"-14301148,72"
01/08/2024,14923,,9659,Terminal LS - Transferencia TPV,75350,0,"-14225798,72"
01/09/2024,15128,,9744,Terminal LS - Transferencia TPV,80960,0,"-15949931,36"
01/09/2024,15127,,9742,Terminal LS - Transferencia TPV,64350,0,"-15885581,36"
01/09/2024,15126,,9739,Terminal LS - Transferencia TPV,55000,0,"-15830581,36"
01/09/2024,15125,,9738,Terminal LS - Transferencia TPV,"59999,99",0,"-15770581,37"
01/09/2024,14922,,,Terminal LS - Tarjeta TPV,0,1735656,"-17506237,37"
01/09/2024,15134,,9758,Terminal LS - Transferencia TPV,110000,0,"-18009297,28"
01/09/2024,15133,,9754,Terminal LS - Transferencia TPV,80850,0,"-18494947,29"
01/09/2024,15123,,9765,Terminal LS - Tarjeta TPV,"136619,99",0,"-18358327,3"
01/09/2024,15136,,9760,Terminal LS - Transferencia TPV,55000,0,"-18303327,3"
01/09/2024,15135,,9759,Terminal LS - Transferencia TPV,33530,0,"-18269797,3"
01/09/2024,14940,,,Terminal LS - Transferencia TPV,0,1565180,"-19834977,3"
01/09/2024,15132,,9751,Terminal LS - Transferencia TPV,71170,0,"-24825463,33"
01/09/2024,15131,,9750,Terminal LS - Transferencia TPV,"129799,99",0,"-24695663,34"
01/09/2024,15130,,9749,Terminal LS - Transferencia TPV,48750,0,"-24646913,34"
01/09/2024,15129,,9746,Terminal LS - Transferencia TPV,146000,0,"-24500913,34"
01/10/2024,15318,,9768,Terminal LS - Transferencia TPV,"100000,01",0,"-24400913,33"
01/10/2024,15321,,9782,Terminal LS - Transferencia TPV,13600,0,"-24387313,33"
01/10/2024,15313,,9787,Terminal LS - Tarjeta TPV,113300,0,"-24274013,33"
01/10/2024,15319,,9772,Terminal LS - Transferencia TPV,"98000,01",0,"-24176013,32"
01/10/2024,15315,,9794,Terminal LS - Tarjeta TPV,"138050,02",0,"-25647963,3"
01/10/2024,15137,,,Terminal LS - Transferencia TPV,0,935380,"-27196842,96"
01/10/2024,15124,,,Terminal LS - Tarjeta TPV,0,1567315,"-28764157,96"
01/10/2024,15316,,9796,Terminal LS - Tarjeta TPV,"175449,99",0,"-28588707,97"
01/10/2024,15310,,9775,Terminal LS - Tarjeta TPV,51700,0,"-28537007,97"
01/10/2024,15311,,9783,Terminal LS - Tarjeta TPV,112001,0,"-28425006,97"
01/10/2024,15322,,9786,Terminal LS - Transferencia TPV,"128700,01",0,"-28296306,96"
01/10/2024,15312,,9784,Terminal LS - Tarjeta TPV,"111650,01",0,"-28184656,95"
01/10/2024,15325,,9791,Terminal LS - Transferencia TPV,"617760,04",0,"-27566896,91"
01/10/2024,15324,,9789,Terminal LS - Transferencia TPV,51000,0,"-27515896,91"
01/10/2024,15308,,9771,Terminal LS - Tarjeta TPV,43500,0,"-27595063,55"
01/10/2024,15309,,9773,Terminal LS - Tarjeta TPV,"77000,01",0,"-27518063,54"
01/10/2024,15320,,9777,Terminal LS - Transferencia TPV,58500,0,"-27459563,54"
01/10/2024,15314,,9793,Terminal LS - Tarjeta TPV,163900,0,"-27295663,54"
01/10/2024,15323,,9788,Terminal LS - Transferencia TPV,66042,0,"-27229621,54"
01/11/2024,15326,,,Terminal LS - Transferencia TPV,0,1133602,"-28363223,54"
01/11/2024,15317,,,Terminal LS - Tarjeta TPV,0,1060801,"-29471024,54"
01/11/2024,15602,,9841,Terminal LS - Transferencia TPV,148500,0,"-29358524,54"
01/11/2024,15585,,9838,Terminal LS - Tarjeta TPV,44778,0,"-29463746,54"
01/11/2024,15586,,9839,Terminal LS - Tarjeta TPV,202450,0,"-29261296,54"
01/11/2024,15587,,9840,Terminal LS - Tarjeta TPV,"70180,01",0,"-29191116,53"
01/11/2024,15591,,9847,Terminal LS - Tarjeta TPV,105930,0,"-29085186,53"
01/11/2024,15597,,9832,Terminal LS - Transferencia TPV,"99200,99",0,"-28985985,54"
01/11/2024,15592,,9848,Terminal LS - Tarjeta TPV,88000,0,"-28897985,54"
01/11/2024,15588,,9842,Terminal LS - Tarjeta TPV,110000,0,"-28787985,54"
01/11/2024,15594,,9808,Terminal LS - Transferencia TPV,"70000,01",0,"-28717985,53"
01/11/2024,15595,,9828,Terminal LS - Transferencia TPV,"166000,01",0,"-28551985,52"
01/11/2024,15596,,9830,Terminal LS - Transferencia TPV,274120,0,"-28277865,52"
01/11/2024,15589,,9843,Terminal LS - Tarjeta TPV,"74800,01",0,"-28203065,51"
01/11/2024,15603,,9835,Terminal LS - Transferencia TPV,"41510,01",0,"-28161555,5"
01/11/2024,15600,,9835,Terminal LS - Transferencia TPV,150000,0,"-28011555,5"
01/11/2024,15584,,9826,Terminal LS - Tarjeta TPV,"101969,99",0,"-27909585,51"
01/11/2024,15583,,9822,Terminal LS - Tarjeta TPV,"167999,99",0,"-27741585,52"
01/11/2024,15582,,9814,Terminal LS - Tarjeta TPV,79420,0,"-27662165,52"
01/11/2024,15581,,9813,Terminal LS - Tarjeta TPV,89430,0,"-27572735,52"
01/11/2024,15580,,9811,Terminal LS - Tarjeta TPV,"80849,99",0,"-27491885,53"
01/11/2024,15590,,9845,Terminal LS - Tarjeta TPV,"74030,01",0,"-27417855,52"
01/11/2024,15598,,9833,Terminal LS - Transferencia TPV,"54999,99",0,"-27362855,53"
01/11/2024,15599,,9834,Terminal LS - Transferencia TPV,"89319,99",0,"-27273535,54"
01/11/2024,15601,,9837,Terminal LS - Transferencia TPV,"171160,01",0,"-27283330,53"
01/12/2024,16015,,9893,Terminal LS - Tarjeta TPV,72072,0,"-27472982,37"
01/12/2024,16051,,9922,Terminal LS - Transferencia TPV,78430,0,"-27394552,37"
01/12/2024,16040,,9888,Terminal LS - Transferencia TPV,86900,0,"-27307652,37"
01/12/2024,16026,,9851,Terminal LS - Transferencia TPV,540019,0,"-26767633,37"
01/12/2024,16038,,9882,Terminal LS - Transferencia TPV,59000,0,"-26708633,37"
01/12/2024,16013,,9880,Terminal LS - Tarjeta TPV,"83379,99",0,"-26625253,38"
01/12/2024,16050,,9921,Terminal LS - Transferencia TPV,"178529,98",0,"-26446723,4"
01/12/2024,16029,,9860,Terminal LS - Transferencia TPV,100000,0,"-26346723,4"
01/12/2024,16057,,9930,Terminal LS - Transferencia TPV,"117149,99",0,"-26229573,41"
01/12/2024,16048,,9918,Terminal LS - Transferencia TPV,"153119,99",0,"-26076453,42"
01/12/2024,16027,,9854,Terminal LS - Transferencia TPV,123948,0,"-25952505,42"
01/12/2024,16016,,9895,Terminal LS - Tarjeta TPV,253330,0,"-25699175,42"
01/12/2024,16011,,9869,Terminal LS - Tarjeta TPV,"115719,99",0,"-25583455,43"
01/12/2024,16039,,9884,Terminal LS - Transferencia TPV,57500,0,"-25525955,43"
01/12/2024,16044,,9904,Terminal LS - Transferencia TPV,98120,0,"-25427835,43"
01/12/2024,16033,,9868,Terminal LS - Transferencia TPV,64500,0,"-25363335,43"
01/12/2024,16035,,9877,Terminal LS - Transferencia TPV,62068,0,"-25301267,43"
01/12/2024,16014,,9889,Terminal LS - Tarjeta TPV,"157299,99",0,"-25143967,44"
01/12/2024,16045,,9909,Terminal LS - Transferencia TPV,169070,0,"-24974897,44"
01/12/2024,16032,,9865,Terminal LS - Transferencia TPV,133000,0,"-24841897,44"
01/12/2024,16036,,9879,Terminal LS - Transferencia TPV,120000,0,"-24721897,44"
01/12/2024,16017,,9898,Terminal LS - Tarjeta TPV,126700,0,"-24595197,44"
01/12/2024,16037,,9881,Terminal LS - Transferencia TPV,"90199,99",0,"-24504997,45"
01/12/2024,16055,,9928,Terminal LS - Transferencia TPV,10200,0,"-24494797,45"
01/12/2024,16022,,9917,Terminal LS - Tarjeta TPV,"237049,99",0,"-24257747,46"
01/12/2024,16023,,9923,Terminal LS - Tarjeta TPV,90310,0,"-24167437,46"
01/12/2024,16019,,9906,Terminal LS - Tarjeta TPV,93830,0,"-24073607,46"
01/12/2024,16034,,9873,Terminal LS - Transferencia TPV,92070,0,"-23981537,46"
01/12/2024,16030,,9861,Terminal LS - Transferencia TPV,335000,0,"-23646537,46"
01/12/2024,16031,,9864,Terminal LS - Transferencia TPV,112000,0,"-23606537,46"
01/12/2024,15593,,,Terminal LS - Tarjeta TPV,0,1289837,"-24896374,46"
01/12/2024,16046,,9912,Terminal LS - Transferencia TPV,"404689,98",0,"-24491684,48"
01/12/2024,16049,,9920,Terminal LS - Transferencia TPV,"217469,99",0,"-24274214,49"
01/12/2024,15604,,,Terminal LS - Transferencia TPV,0,1114809,"-25389023,49"
01/12/2024,16053,,9926,Terminal LS - Transferencia TPV,147840,0,"-25241183,49"
01/12/2024,16054,,9927,Terminal LS - Transferencia TPV,"229899,99",0,"-25011283,5"
01/12/2024,16024,,9924,Terminal LS - Tarjeta TPV,64900,0,"-24946383,5"
01/12/2024,16058,,9931,Terminal LS - Transferencia TPV,139500,0,"-24806883,5"
01/12/2024,16028,,9856,Terminal LS - Transferencia TPV,"71000,01",0,"-24735883,49"
01/12/2024,16041,,9894,Terminal LS - Transferencia TPV,87450,0,"-24648433,49"
01/12/2024,16043,,9903,Terminal LS - Transferencia TPV,90750,0,"-24557683,49"
01/12/2024,16052,,9925,Terminal LS - Transferencia TPV,79860,0,"-24477823,49"
01/12/2024,16042,,9902,Terminal LS - Transferencia TPV,275550,0,"-24202273,49"
01/12/2024,16021,,9913,Terminal LS - Tarjeta TPV,"13799,99",0,"-24188473,5"
01/12/2024,16047,,9916,Terminal LS - Transferencia TPV,"116709,99",0,"-24071763,51"
01/12/2024,16056,,9929,Terminal LS - Transferencia TPV,74910,0,"-23996853,51"
01/12/2024,16018,,9905,Terminal LS - Tarjeta TPV,"123090,02",0,"-23873763,49"
01/12/2024,16010,,9863,Terminal LS - Tarjeta TPV,72500,0,"-23801263,49"
01/12/2024,16012,,9872,Terminal LS - Tarjeta TPV,25062,0,"-23776201,49"
01/12/2024,16020,,9910,Terminal LS - Tarjeta TPV,88660,0,"-23687541,49"
01/13/2024,16747,,9961,Terminal LS - Transferencia TPV,"80499,99",0,"-23607041,5"
01/13/2024,16760,,10051,Terminal LS - Transferencia TPV,88300,0,"-23518741,5"
01/13/2024,16746,,9956,Terminal LS - Transferencia TPV,51750,0,"-23466991,5"
01/13/2024,16734,,10035,Terminal LS - Tarjeta TPV,76230,0,"-23390761,5"
01/13/2024,16722,,9958,Terminal LS - Tarjeta TPV,85800,0,"-23304961,5"
01/13/2024,16743,,9940,Terminal LS - Transferencia TPV,117150,0,"-23676939,5"
01/13/2024,16758,,10039,Terminal LS - Transferencia TPV,108680,0,"-23635759,5"
01/13/2024,16723,,9977,Terminal LS - Tarjeta TPV,180070,0,"-23455689,5"
01/13/2024,16059,,,Terminal LS - Transferencia TPV,0,4716451,"-28172140,5"
01/13/2024,16025,,,Terminal LS - Tarjeta TPV,0,1617700,"-29789840,5"
01/13/2024,16721,,9953,Terminal LS - Tarjeta TPV,"239778,01",0,"-29550062,49"
01/13/2024,16729,,10004,Terminal LS - Tarjeta TPV,"83929,99",0,"-29466132,5"
01/13/2024,16736,,10044,Terminal LS - Tarjeta TPV,"216809,99",0,"-29249322,51"
01/13/2024,16731,,10010,Terminal LS - Tarjeta TPV,62500,0,"-29186822,51"
01/13/2024,16748,,9962,Terminal LS - Transferencia TPV,159555,0,"-29027267,51"
01/13/2024,16750,,9992,Terminal LS - Transferencia TPV,72000,0,"-28955267,51"
01/13/2024,16740,,10052,Terminal LS - Tarjeta TPV,98120,0,"-28857147,51"
01/13/2024,16739,,10050,Terminal LS - Tarjeta TPV,"110110,01",0,"-28747037,5"
01/13/2024,16720,,9948,Terminal LS - Tarjeta TPV,"93500,01",0,"-28653537,49"
01/13/2024,16749,,9986,Terminal LS - Transferencia TPV,78100,0,"-28575437,49"
01/13/2024,16753,,10007,Terminal LS - Transferencia TPV,"88199,99",0,"-28487237,5"
01/13/2024,16754,,10019,Terminal LS - Transferencia TPV,64350,0,"-28422887,5"
01/13/2024,16725,,9980,Terminal LS - Tarjeta TPV,2000,0,"-28420887,5"
01/13/2024,16751,,9993,Terminal LS - Transferencia TPV,185500,0,"-28737088,25"
01/13/2024,16730,,10008,Terminal LS - Tarjeta TPV,"84699,99",0,"-28652388,26"
01/13/2024,16755,,10021,Terminal LS - Transferencia TPV,296670,0,"-28355718,26"
01/13/2024,16735,,10036,Terminal LS - Tarjeta TPV,"131559,99",0,"-28224158,27"
01/13/2024,16728,,10003,Terminal LS - Tarjeta TPV,85800,0,"-28138358,27"
01/13/2024,16732,,10012,Terminal LS - Tarjeta TPV,157190,0,"-27981168,27"
01/13/2024,16724,,9979,Terminal LS - Tarjeta TPV,78100,0,"-27903068,27"
01/13/2024,16733,,10024,Terminal LS - Tarjeta TPV,94050,0,"-27809018,27"
01/13/2024,16759,,10043,Terminal LS - Transferencia TPV,201740,0,"-27607278,27"
01/13/2024,16737,,10048,Terminal LS - Tarjeta TPV,160270,0,"-27447008,27"
01/13/2024,16752,,10001,Terminal LS - Transferencia TPV,"174239,99",0,"-27272768,28"
01/13/2024,16726,,9984,Terminal LS - Tarjeta TPV,58800,0,"-27213968,28"
01/13/2024,16757,,10029,Terminal LS - Transferencia TPV,66660,0,"-27147308,28"
01/13/2024,16738,,10049,Terminal LS - Tarjeta TPV,"130679,99",0,"-27016628,29"
01/13/2024,16727,,9994,Terminal LS - Tarjeta TPV,64130,0,"-26952498,29"
01/13/2024,16742,,9937,Terminal LS - Transferencia TPV,"107800,01",0,"-26844698,28"
01/13/2024,16744,,9941,Terminal LS - Transferencia TPV,62500,0,"-26782198,28"
01/13/2024,16745,,9954,Terminal LS - Transferencia TPV,67000,0,"-26715198,28"
01/13/2024,16756,,10028,Terminal LS - Transferencia TPV,"81729,99",0,"-26633468,29"
01/14/2024,17330,,10137,Terminal LS - Transferencia TPV,163900,0,"-26469568,29"
01/14/2024,17332,,10145,Terminal LS - Transferencia TPV,78210,0,"-26391358,29"
01/14/2024,17333,,10146,Terminal LS - Transferencia TPV,"236485,99",0,"-26154872,3"
01/14/2024,17356,,10133,Terminal LS - Tarjeta TPV,"221869,98",0,"-25933002,32"
01/14/2024,17325,,10110,Terminal LS - Transferencia TPV,133980,0,"-25799022,32"
01/14/2024,17324,,10107,Terminal LS - Transferencia TPV,127160,0,"-25671862,32"
01/14/2024,17323,,10102,Terminal LS - Transferencia TPV,166500,0,"-25505362,32"
01/14/2024,16761,,,Terminal LS - Transferencia TPV,0,2152469,"-27657831,32"
01/14/2024,17331,,10141,Terminal LS - Transferencia TPV,"175199,98",0,"-27482631,34"
01/14/2024,17319,,10058,Terminal LS - Transferencia TPV,81400,0,"-27401231,34"
01/14/2024,17320,,10081,Terminal LS - Transferencia TPV,281600,0,"-27119631,34"
01/14/2024,17352,,10079,Terminal LS - Tarjeta TPV,"232000,01",0,"-26887631,33"
01/14/2024,17357,,10136,Terminal LS - Tarjeta TPV,83600,0,"-26804031,33"
01/14/2024,17350,,10055,Terminal LS - Tarjeta TPV,85250,0,"-26718781,33"
01/14/2024,17327,,10125,Terminal LS - Transferencia TPV,78980,0,"-26639801,33"
01/14/2024,17326,,10124,Terminal LS - Transferencia TPV,85800,0,"-26554001,33"
01/14/2024,17329,,10134,Terminal LS - Transferencia TPV,"262129,99",0,"-26291871,34"
01/14/2024,17328,,10126,Terminal LS - Transferencia TPV,"158949,99",0,"-26132921,35"
01/14/2024,17322,,10089,Terminal LS - Transferencia TPV,61000,0,"-26071921,35"
01/14/2024,17321,,10086,Terminal LS - Transferencia TPV,93000,0,"-25978921,35"
01/14/2024,17334,,10151,Terminal LS - Transferencia TPV,189300,0,"-25789621,35"
01/14/2024,17335,,10151,Terminal LS - Transferencia TPV,18930,0,"-25770691,35"
01/14/2024,17355,,10132,Terminal LS - Tarjeta TPV,"80409,99",0,"-25690281,36"
01/14/2024,17351,,10071,Terminal LS - Tarjeta TPV,"149159,99",0,"-25541121,37"
01/14/2024,17354,,10128,Terminal LS - Tarjeta TPV,64130,0,"-25476991,37"
01/14/2024,17353,,10116,Terminal LS - Tarjeta TPV,86350,0,"-25390641,37"
01/14/2024,16741,,,Terminal LS - Tarjeta TPV,0,2294126,"-27684767,37"
01/14/2024,17360,,10148,Terminal LS - Tarjeta TPV,157850,0,"-27526917,37"
01/14/2024,17359,,10144,Terminal LS - Tarjeta TPV,89560,0,"-27437357,37"
01/14/2024,17358,,10142,Terminal LS - Tarjeta TPV,242770,0,"-27194587,37"
01/15/2024,17361,,,Terminal LS - Tarjeta TPV,0,1492947,"-28968953,6"
01/15/2024,17336,,,Terminal LS - Transferencia TPV,0,2392574,"-31661527,6"
01/16/2024,17476,,10166,Terminal LS - Transferencia TPV,"101309,99",0,"-31560217,61"
01/16/2024,17477,,10169,Terminal LS - Transferencia TPV,"172259,99",0,"-31387957,62"
01/16/2024,17478,,10170,Terminal LS - Transferencia TPV,110000,0,"-32268732,62"
01/16/2024,17470,,10155,Terminal LS - Transferencia TPV,163000,0,"-43849931,74"
01/16/2024,17475,,10165,Terminal LS - Transferencia TPV,73370,0,"-47867247,74"
01/16/2024,17463,,10154,Terminal LS - Tarjeta TPV,117200,0,"-47750047,74"
01/16/2024,17471,,10157,Terminal LS - Transferencia TPV,"109999,99",0,"-47640047,75"
01/16/2024,17464,,10156,Terminal LS - Tarjeta TPV,"141899,99",0,"-47498147,76"
01/16/2024,17465,,10158,Terminal LS - Tarjeta TPV,277750,0,"-47220397,76"
01/16/2024,17466,,10161,Terminal LS - Tarjeta TPV,"92949,99",0,"-47127447,77"
01/16/2024,17467,,10162,Terminal LS - Tarjeta TPV,"223409,99",0,"-46904037,78"
01/16/2024,17468,,10168,Terminal LS - Tarjeta TPV,"123469,99",0,"-46780567,79"
01/16/2024,17472,,10159,Terminal LS - Transferencia TPV,145860,0,"-46634707,79"
01/16/2024,17473,,10160,Terminal LS - Transferencia TPV,"119459,99",0,"-46515247,8"
01/16/2024,17474,,10164,Terminal LS - Transferencia TPV,172260,0,"-46342987,8"
01/17/2024,17570,,10171,Terminal LS - Tarjeta TPV,73810,0,"-46956640,8"
01/17/2024,17469,,,Terminal LS - Tarjeta TPV,0,976676,"-48131516,9"
01/17/2024,17479,,,Terminal LS - Transferencia TPV,0,1167734,"-49299250,9"
01/17/2024,17571,,10174,Terminal LS - Tarjeta TPV,143715,0,"-50403528,15"
01/17/2024,17572,,10179,Terminal LS - Tarjeta TPV,112420,0,"-50291108,15"
01/17/2024,17573,,10181,Terminal LS - Tarjeta TPV,80850,0,"-50210258,15"
01/17/2024,17574,,10183,Terminal LS - Tarjeta TPV,158070,0,"-50052188,15"
01/17/2024,17575,,10190,Terminal LS - Tarjeta TPV,167860,0,"-49884328,15"
01/17/2024,17577,,10172,Terminal LS - Transferencia TPV,"122099,99",0,"-49762228,16"
01/17/2024,17578,,10173,Terminal LS - Transferencia TPV,66880,0,"-49695348,16"
01/17/2024,17579,,10177,Terminal LS - Transferencia TPV,"90199,99",0,"-49605148,17"
01/17/2024,17580,,10178,Terminal LS - Transferencia TPV,"81069,99",0,"-49524078,18"
01/17/2024,17581,,10184,Terminal LS - Transferencia TPV,92510,0,"-49431568,18"
01/17/2024,17582,,10185,Terminal LS - Transferencia TPV,"96799,99",0,"-49334768,19"
01/17/2024,17583,,10186,Terminal LS - Transferencia TPV,"168739,99",0,"-49166028,2"
01/17/2024,17584,,10187,Terminal LS - Transferencia TPV,"82060,01",0,"-49083968,19"
01/17/2024,17585,,10191,Terminal LS - Transferencia TPV,210210,0,"-48873758,19"
01/18/2024,17859,,10239,Terminal LS - Transferencia TPV,"110989,99",0,"-48762768,2"
01/18/2024,17857,,10237,Terminal LS - Transferencia TPV,184250,0,"-48578518,2"
01/18/2024,17856,,10231,Terminal LS - Transferencia TPV,"89650,01",0,"-48488868,19"
01/18/2024,17855,,10230,Terminal LS - Transferencia TPV,110770,0,"-48378098,19"
01/18/2024,17858,,10238,Terminal LS - Transferencia TPV,61800,0,"-48316298,19"
01/18/2024,17853,,10224,Terminal LS - Transferencia TPV,"132761,99",0,"-48453736,67"
01/18/2024,17852,,10222,Terminal LS - Transferencia TPV,389500,0,"-48064236,67"
01/18/2024,17851,,10220,Terminal LS - Transferencia TPV,109450,0,"-47954786,67"
01/18/2024,17850,,10219,Terminal LS - Transferencia TPV,"73000,01",0,"-47881786,66"
01/18/2024,17838,,10223,Terminal LS - Tarjeta TPV,"99599,98",0,"-47782186,68"
01/18/2024,17837,,10217,Terminal LS - Tarjeta TPV,92950,0,"-47689236,68"
01/18/2024,17836,,10206,Terminal LS - Tarjeta TPV,114800,0,"-47574436,68"
01/18/2024,17835,,10201,Terminal LS - Tarjeta TPV,69080,0,"-47505356,68"
01/18/2024,17834,,10199,Terminal LS - Tarjeta TPV,"83379,99",0,"-47421976,69"
01/18/2024,17854,,10229,Terminal LS - Transferencia TPV,34600,0,"-47422776,77"
01/18/2024,17839,,10229,Terminal LS - Tarjeta TPV,34540,0,"-47388236,77"
01/18/2024,17586,,,Terminal LS - Transferencia TPV,0,1010606,"-48398842,77"
01/18/2024,17576,,,Terminal LS - Tarjeta TPV,0,736725,"-49135567,77"
01/18/2024,17860,,10241,Terminal LS - Transferencia TPV,85250,0,"-49050317,77"
01/19/2024,18350,,10265,Terminal LS - Transferencia TPV,"92399,99",0,"-48957917,78"
01/19/2024,18364,,10308,Terminal LS - Transferencia TPV,"158209,99",0,"-48799707,79"
01/19/2024,18356,,10279,Terminal LS - Transferencia TPV,82000,0,"-48717707,79"
01/19/2024,18365,,10310,Terminal LS - Transferencia TPV,"93799,99",0,"-48623907,8"
01/19/2024,18357,,10285,Terminal LS - Transferencia TPV,63800,0,"-48560107,8"
01/19/2024,18371,,10324,Terminal LS - Transferencia TPV,125900,0,"-48434207,8"
01/19/2024,18383,,10297,Terminal LS - Tarjeta TPV,72300,0,"-48361907,8"
01/19/2024,18353,,10274,Terminal LS - Transferencia TPV,155870,0,"-48206037,8"
01/19/2024,18363,,10307,Terminal LS - Transferencia TPV,"206909,99",0,"-47999127,81"
01/19/2024,18381,,10292,Terminal LS - Tarjeta TPV,108790,0,"-47890337,81"
01/19/2024,18380,,10287,Terminal LS - Tarjeta TPV,77880,0,"-47812457,81"
01/19/2024,18372,,10325,Terminal LS - Transferencia TPV,"134419,99",0,"-47678037,82"
01/19/2024,18379,,10273,Terminal LS - Tarjeta TPV,97350,0,"-47580687,82"
01/19/2024,18366,,10312,Terminal LS - Transferencia TPV,"73699,99",0,"-47506987,83"
01/19/2024,18352,,10271,Terminal LS - Transferencia TPV,70400,0,"-47436587,83"
01/19/2024,18376,,10252,Terminal LS - Tarjeta TPV,"149325,02",0,"-47311262,81"
01/19/2024,18378,,10272,Terminal LS - Tarjeta TPV,"187109,98",0,"-47124152,83"
01/19/2024,18390,,10327,Terminal LS - Tarjeta TPV,"162579,99",0,"-46961572,84"
01/19/2024,18358,,10289,Terminal LS - Transferencia TPV,"234079,98",0,"-46727492,86"
01/19/2024,18382,,10296,Terminal LS - Tarjeta TPV,"166500,01",0,"-46560992,85"
01/19/2024,18367,,10314,Terminal LS - Transferencia TPV,"87500,01",0,"-46473492,84"
01/19/2024,18346,,10250,Terminal LS - Transferencia TPV,67000,0,"-46406492,84"
01/19/2024,18354,,10276,Terminal LS - Transferencia TPV,67000,0,"-46339492,84"
01/19/2024,18349,,10264,Terminal LS - Transferencia TPV,208725,0,"-46130767,84"
01/19/2024,17861,,,Terminal LS - Transferencia TPV,0,1578771,"-47841538,84"
01/19/2024,18355,,10278,Terminal LS - Transferencia TPV,118500,0,"-47723038,84"
01/19/2024,18369,,10322,Terminal LS - Transferencia TPV,89650,0,"-47633388,84"
01/19/2024,18343,,10246,Terminal LS - Transferencia TPV,"64499,99",0,"-47568888,85"
01/19/2024,18368,,10317,Terminal LS - Transferencia TPV,71500,0,"-47497388,85"
01/19/2024,18377,,10256,Terminal LS - Tarjeta TPV,"134529,99",0,"-47362858,86"
01/19/2024,18375,,10243,Terminal LS - Tarjeta TPV,"106039,99",0,"-47256818,87"
01/19/2024,18351,,10268,Terminal LS - Transferencia TPV,94710,0,"-47162108,87"
01/19/2024,18384,,10311,Terminal LS - Tarjeta TPV,114390,0,"-47047718,87"
01/19/2024,18347,,10253,Terminal LS - Transferencia TPV,"78949,99",0,"-46968768,88"
01/19/2024,18348,,10259,Terminal LS - Transferencia TPV,"197999,98",0,"-46770768,9"
01/19/2024,18370,,10323,Terminal LS - Transferencia TPV,"147509,99",0,"-46896259,19"
01/19/2024,18360,,10298,Terminal LS - Transferencia TPV,87450,0,"-46808809,19"
01/19/2024,18361,,10301,Terminal LS - Transferencia TPV,"110599,99",0,"-46698209,2"
01/19/2024,18345,,10248,Terminal LS - Transferencia TPV,61000,0,"-46637209,2"
01/19/2024,18362,,10302,Terminal LS - Transferencia TPV,"183149,98",0,"-46454059,22"
01/19/2024,18344,,10247,Terminal LS - Transferencia TPV,"133000,01",0,"-46321059,21"
01/19/2024,18373,,10328,Terminal LS - Transferencia TPV,"215049,99",0,"-46142009,22"
01/19/2024,18359,,10290,Terminal LS - Transferencia TPV,115720,0,"-46026289,22"
01/20/2024,19194,,10457,Terminal LS - Transferencia TPV,334730,0,"-45765559,74"
01/20/2024,18374,,,Terminal LS - Transferencia TPV,0,3691051,"-49456610,74"
01/20/2024,19163,,10449,Terminal LS - Tarjeta TPV,"82279,99",0,"-49374330,75"
01/20/2024,19198,,10471,Terminal LS - Transferencia TPV,"188540,01",0,"-49185790,74"
01/20/2024,19161,,10417,Terminal LS - Tarjeta TPV,"230560,01",0,"-48955230,73"
01/20/2024,19149,,10332,Terminal LS - Tarjeta TPV,"88769,99",0,"-48866460,74"
01/20/2024,19151,,10342,Terminal LS - Tarjeta TPV,"228139,99",0,"-48638320,75"
01/20/2024,19167,,10330,Terminal LS - Transferencia TPV,157850,0,"-48480470,75"
01/20/2024,19187,,10425,Terminal LS - Transferencia TPV,"89099,99",0,"-48391370,76"
01/20/2024,19168,,10338,Terminal LS - Transferencia TPV,84920,0,"-48306450,76"
01/20/2024,19201,,10474,Terminal LS - Transferencia TPV,"65299,99",0,"-48241150,77"
01/20/2024,19169,,10345,Terminal LS - Transferencia TPV,78000,0,"-48163150,77"
01/20/2024,19150,,10341,Terminal LS - Tarjeta TPV,78210,0,"-48084940,77"
01/20/2024,19157,,10410,Terminal LS - Tarjeta TPV,81700,0,"-48003240,77"
01/20/2024,19173,,10378,Terminal LS - Transferencia TPV,60000,0,"-47943240,77"
01/20/2024,19177,,10392,Terminal LS - Transferencia TPV,156200,0,"-47787040,77"
01/20/2024,19179,,10395,Terminal LS - Transferencia TPV,"86349,99",0,"-47700690,78"
01/20/2024,19154,,10375,Terminal LS - Tarjeta TPV,"82268,99",0,"-47618421,79"
01/20/2024,19181,,10398,Terminal LS - Transferencia TPV,"75999,99",0,"-47542421,8"
01/20/2024,19182,,10400,Terminal LS - Transferencia TPV,"195029,99",0,"-47347391,81"
01/20/2024,19176,,10389,Terminal LS - Transferencia TPV,85800,0,"-47261591,81"
01/20/2024,19180,,10397,Terminal LS - Transferencia TPV,56500,0,"-47205091,81"
01/20/2024,19155,,10382,Terminal LS - Tarjeta TPV,121000,0,"-47084091,81"
01/20/2024,19197,,10470,Terminal LS - Transferencia TPV,"158400,01",0,"-46925691,8"
01/20/2024,19184,,10408,Terminal LS - Transferencia TPV,"76229,99",0,"-46849461,81"
01/20/2024,19159,,10412,Terminal LS - Tarjeta TPV,"89429,99",0,"-46760031,82"
01/20/2024,19164,,10456,Terminal LS - Tarjeta TPV,"95149,99",0,"-46664881,83"
01/20/2024,19171,,10362,Terminal LS - Transferencia TPV,132550,0,"-46532331,83"
01/20/2024,19199,,10472,Terminal LS - Transferencia TPV,"83269,99",0,"-46449061,84"
01/20/2024,19183,,10405,Terminal LS - Transferencia TPV,82000,0,"-46367061,84"
01/20/2024,19195,,10459,Terminal LS - Transferencia TPV,"190999,99",0,"-46176061,85"
01/20/2024,19196,,10469,Terminal LS - Transferencia TPV,74910,0,"-46101151,85"
01/20/2024,19170,,10346,Terminal LS - Transferencia TPV,80410,0,"-46020741,85"
01/20/2024,19160,,10413,Terminal LS - Tarjeta TPV,99770,0,"-45920971,85"
01/20/2024,19190,,10443,Terminal LS - Transferencia TPV,580800,0,"-45340171,85"
01/20/2024,19185,,10415,Terminal LS - Transferencia TPV,86130,0,"-45254041,85"
01/20/2024,19200,,10473,Terminal LS - Transferencia TPV,"89429,99",0,"-45164611,86"
01/20/2024,19174,,10379,Terminal LS - Transferencia TPV,54000,0,"-45110611,86"
01/20/2024,19191,,10444,Terminal LS - Transferencia TPV,139150,0,"-44971461,86"
01/20/2024,19158,,10411,Terminal LS - Tarjeta TPV,73300,0,"-44898161,86"
01/20/2024,19175,,10384,Terminal LS - Transferencia TPV,78650,0,"-44819511,86"
01/20/2024,19186,,10424,Terminal LS - Transferencia TPV,"95999,99",0,"-44723511,87"
01/20/2024,19156,,10386,Terminal LS - Tarjeta TPV,"129359,99",0,"-44594151,88"
01/20/2024,19192,,10445,Terminal LS - Transferencia TPV,93170,0,"-44500981,88"
01/20/2024,19188,,10426,Terminal LS - Transferencia TPV,148500,0,"-44352481,88"
01/20/2024,19153,,10351,Terminal LS - Tarjeta TPV,91300,0,"-44261181,88"
01/20/2024,19172,,10368,Terminal LS - Transferencia TPV,119000,0,"-44142181,88"
01/20/2024,19152,,10348,Terminal LS - Tarjeta TPV,"82609,99",0,"-44059571,89"
01/20/2024,19165,,10465,Terminal LS - Tarjeta TPV,7600,0,"-44051971,89"
01/20/2024,19178,,10393,Terminal LS - Transferencia TPV,"99549,98",0,"-43952421,91"
01/20/2024,19162,,10422,Terminal LS - Tarjeta TPV,31150,0,"-43921271,91"
01/20/2024,19193,,10447,Terminal LS - Transferencia TPV,73600,0,"-43847671,91"
01/20/2024,19189,,10428,Terminal LS - Transferencia TPV,80300,0,"-43767371,91"
01/21/2024,19755,,10548,Terminal LS - Tarjeta TPV,"103949,99",0,"-43663421,92"
01/21/2024,19760,,10567,Terminal LS - Tarjeta TPV,41920,0,"-43621501,92"
01/21/2024,19766,,10475,Terminal LS - Transferencia TPV,65450,0,"-43556051,92"
01/21/2024,19768,,10518,Terminal LS - Transferencia TPV,52000,0,"-43504051,92"
01/21/2024,19753,,10535,Terminal LS - Tarjeta TPV,"77440,01",0,"-43426611,91"
01/21/2024,19776,,10557,Terminal LS - Transferencia TPV,109450,0,"-43317161,91"
01/21/2024,19752,,10506,Terminal LS - Tarjeta TPV,144430,0,"-43172731,91"
01/21/2024,19781,,10572,Terminal LS - Transferencia TPV,95700,0,"-43077031,91"
01/21/2024,19770,,10522,Terminal LS - Transferencia TPV,"83049,99",0,"-42993981,92"
01/21/2024,19775,,10556,Terminal LS - Transferencia TPV,"117260,01",0,"-42876721,91"
01/21/2024,19782,,10573,Terminal LS - Transferencia TPV,202510,0,"-42674211,91"
01/21/2024,19761,,10568,Terminal LS - Tarjeta TPV,168960,0,"-42505251,91"
01/21/2024,19762,,10569,Terminal LS - Tarjeta TPV,"65229,99",0,"-42440021,92"
01/21/2024,19774,,10544,Terminal LS - Transferencia TPV,63000,0,"-42377021,92"
01/21/2024,19779,,10563,Terminal LS - Transferencia TPV,"116599,99",0,"-42260421,93"
01/21/2024,19769,,10520,Terminal LS - Transferencia TPV,77330,0,"-42183091,93"
01/21/2024,19764,,10576,Terminal LS - Tarjeta TPV,"116600,01",0,"-42066491,92"
01/21/2024,19772,,10536,Terminal LS - Transferencia TPV,67000,0,"-41999491,92"
01/21/2024,19202,,,Terminal LS - Transferencia TPV,0,4331846,"-46331337,92"
01/21/2024,19166,,,Terminal LS - Tarjeta TPV,0,1692591,"-48023928,92"
01/21/2024,19780,,10567,Terminal LS - Transferencia TPV,120000,0,"-47903928,92"
01/21/2024,19748,,10480,Terminal LS - Tarjeta TPV,"41999,99",0,"-47861928,93"
01/21/2024,19759,,10566,Terminal LS - Tarjeta TPV,54000,0,"-47807928,93"
01/21/2024,19771,,10531,Terminal LS - Transferencia TPV,154500,0,"-47653428,93"
01/21/2024,19747,,10479,Terminal LS - Tarjeta TPV,93060,0,"-47560368,93"
01/21/2024,19758,,10565,Terminal LS - Tarjeta TPV,81500,0,"-47478868,93"
01/21/2024,19778,,10561,Terminal LS - Transferencia TPV,66000,0,"-47412868,93"
01/21/2024,19754,,10543,Terminal LS - Tarjeta TPV,"166539,99",0,"-47246328,94"
01/21/2024,19751,,10502,Terminal LS - Tarjeta TPV,"125399,99",0,"-47120928,95"
01/21/2024,19763,,10575,Terminal LS - Tarjeta TPV,84150,0,"-47036778,95"
01/21/2024,19767,,10476,Terminal LS - Transferencia TPV,"78650,01",0,"-46958128,94"
01/21/2024,19757,,10564,Terminal LS - Tarjeta TPV,"87669,99",0,"-46870458,95"
01/21/2024,19773,,10537,Terminal LS - Transferencia TPV,65000,0,"-46805458,95"
01/21/2024,19749,,10485,Terminal LS - Tarjeta TPV,83710,0,"-46721748,95"
01/21/2024,19750,,10488,Terminal LS - Tarjeta TPV,67430,0,"-46654318,95"
01/21/2024,19777,,10560,Terminal LS - Transferencia TPV,"194000,01",0,"-46460318,94"
01/21/2024,19756,,10562,Terminal LS - Tarjeta TPV,80000,0,"-46380318,94"
01/22/2024,19765,,,Terminal LS - Tarjeta TPV,0,1683984,"-48164302,94"
01/22/2024,19783,,,Terminal LS - Transferencia TPV,0,1727500,"-53609995,63"
01/23/2024,19954,,10590,Terminal LS - Transferencia TPV,"70799,99",0,"-56588935,4"
01/23/2024,19957,,10594,Terminal LS - Transferencia TPV,91960,0,"-56950393,43"
01/23/2024,19956,,10593,Terminal LS - Transferencia TPV,76000,0,"-56874393,43"
01/23/2024,19955,,10591,Terminal LS - Transferencia TPV,"62100,01",0,"-56812293,42"
01/23/2024,19960,,10597,Terminal LS - Transferencia TPV,82390,0,"-56729903,42"
01/23/2024,19959,,10596,Terminal LS - Transferencia TPV,89210,0,"-57267393,42"
01/23/2024,19953,,10589,Terminal LS - Transferencia TPV,"61500,01",0,"-57205893,41"
01/23/2024,19952,,10584,Terminal LS - Transferencia TPV,52000,0,"-57153893,41"
01/23/2024,19949,,10599,Terminal LS - Tarjeta TPV,"205149,99",0,"-57167227,67"
01/23/2024,19961,,10600,Terminal LS - Transferencia TPV,104720,0,"-57937914,3"
01/23/2024,19958,,10595,Terminal LS - Transferencia TPV,82390,0,"-57855524,3"
01/23/2024,19948,,10598,Terminal LS - Tarjeta TPV,"225609,99",0,"-57629914,31"
01/23/2024,19947,,10588,Terminal LS - Tarjeta TPV,"95149,99",0,"-57534764,32"
01/23/2024,19946,,10587,Terminal LS - Tarjeta TPV,59500,0,"-57475264,32"
01/23/2024,19945,,10586,Terminal LS - Tarjeta TPV,100980,0,"-57374284,32"
01/23/2024,19944,,10583,Terminal LS - Tarjeta TPV,"98669,99",0,"-57275614,33"
01/23/2024,19943,,10582,Terminal LS - Tarjeta TPV,"72379,99",0,"-57203234,34"
01/23/2024,19942,,10579,Terminal LS - Tarjeta TPV,72160,0,"-57131074,34"
01/24/2024,19950,,,Terminal LS - Tarjeta TPV,0,946595,"-61421501,45"
01/24/2024,19951,,,Terminal LS - Tarjeta TPV,"16995,05",0,"-61404506,4"
01/24/2024,19962,,,Terminal LS - Transferencia TPV,0,773120,"-62177626,4"
01/24/2024,20151,,10612,Terminal LS - Tarjeta TPV,72710,0,"-62104916,4"
01/25/2024,20461,,10675,Terminal LS - Transferencia TPV,97569,0,"-62352173,23"
01/25/2024,20449,,10640,Terminal LS - Transferencia TPV,"132000,01",0,"-62220173,22"
01/25/2024,20458,,10670,Terminal LS - Transferencia TPV,81726,0,"-62138447,22"
01/25/2024,20448,,10637,Terminal LS - Transferencia TPV,"61500,01",0,"-62076947,21"
01/25/2024,20460,,10674,Terminal LS - Transferencia TPV,80000,0,"-62128776,93"
01/25/2024,20465,,10681,Terminal LS - Transferencia TPV,95700,0,"-62033076,93"
01/25/2024,20459,,10673,Terminal LS - Transferencia TPV,"90138,99",0,"-61942937,94"
01/25/2024,20468,,10634,Terminal LS - Tarjeta TPV,"78499,99",0,"-61864437,95"
01/25/2024,20462,,10676,Terminal LS - Transferencia TPV,47800,0,"-61816637,95"
01/25/2024,20476,,10666,Terminal LS - Tarjeta TPV,"342855,99",0,"-61473781,96"
01/25/2024,20447,,10631,Terminal LS - Transferencia TPV,116000,0,"-61357781,96"
01/25/2024,20473,,10659,Terminal LS - Tarjeta TPV,"247842,99",0,"-61109938,97"
01/25/2024,20474,,10663,Terminal LS - Tarjeta TPV,110000,0,"-60999938,97"
01/25/2024,20456,,10660,Terminal LS - Transferencia TPV,"139415,01",0,"-60860523,96"
01/25/2024,20452,,10652,Terminal LS - Transferencia TPV,90685,0,"-60843838,96"
01/25/2024,20478,,10678,Terminal LS - Tarjeta TPV,"93088,99",0,"-60750749,97"
01/25/2024,20453,,10653,Terminal LS - Transferencia TPV,"193389,01",0,"-60557360,96"
01/25/2024,20455,,10658,Terminal LS - Transferencia TPV,78557,0,"-60478803,96"
01/25/2024,20469,,10647,Terminal LS - Tarjeta TPV,"84784,99",0,"-60394018,97"
01/25/2024,20450,,10642,Terminal LS - Transferencia TPV,84785,0,"-60309233,97"
01/25/2024,20457,,10667,Terminal LS - Transferencia TPV,61500,0,"-60247733,97"
01/25/2024,20464,,10680,Terminal LS - Transferencia TPV,106500,0,"-60141233,97"
01/25/2024,20466,,10683,Terminal LS - Transferencia TPV,259700,0,"-59881533,97"
01/25/2024,20463,,10677,Terminal LS - Transferencia TPV,9800,0,"-59871733,97"
01/25/2024,20471,,10649,Terminal LS - Tarjeta TPV,77574,0,"-59794159,97"
01/25/2024,20477,,10668,Terminal LS - Tarjeta TPV,"144768,99",0,"-59649390,98"
01/25/2024,20475,,10665,Terminal LS - Tarjeta TPV,66648,0,"-59582742,98"
01/25/2024,20470,,10648,Terminal LS - Tarjeta TPV,59546,0,"-59523196,98"
01/25/2024,20454,,10656,Terminal LS - Transferencia TPV,74624,0,"-59448572,98"
01/25/2024,20451,,10645,Terminal LS - Transferencia TPV,"317999,99",0,"-59130572,99"
01/25/2024,20472,,10657,Terminal LS - Tarjeta TPV,89374,0,"-59041198,99"
01/26/2024,20875,,10702,Terminal LS - Transferencia TPV,72220,0,"-60294878,88"
01/26/2024,20467,,,Terminal LS - Transferencia TPV,0,2219519,"-63226497,4"
01/26/2024,20479,,,Terminal LS - Tarjeta TPV,0,1394978,"-64621475,4"
01/27/2024,21570,,10828,Terminal LS - Transferencia TPV,57298,0,"-64564177,4"
01/27/2024,21580,,10890,Terminal LS - Transferencia TPV,94400,0,"-64469777,4"
01/27/2024,21539,,10765,Terminal LS - Tarjeta TPV,"97240,99",0,"-64372536,41"
01/27/2024,21550,,10864,Terminal LS - Tarjeta TPV,85769,0,"-64286767,41"
01/27/2024,21549,,10861,Terminal LS - Tarjeta TPV,"117453,99",0,"-64169313,42"
01/27/2024,21560,,10786,Terminal LS - Transferencia TPV,81726,0,"-64087587,42"
01/27/2024,21548,,10856,Terminal LS - Tarjeta TPV,156787,0,"-63930800,42"
01/27/2024,21561,,10787,Terminal LS - Transferencia TPV,90000,0,"-63840800,42"
01/27/2024,21565,,10804,Terminal LS - Transferencia TPV,"97240,99",0,"-63743559,43"
01/27/2024,21542,,10828,Terminal LS - Tarjeta TPV,30000,0,"-63713559,43"
01/27/2024,21574,,10850,Terminal LS - Transferencia TPV,82381,0,"-63631178,43"
01/27/2024,21547,,10848,Terminal LS - Tarjeta TPV,72657,0,"-63558521,43"
01/27/2024,21572,,10841,Terminal LS - Transferencia TPV,"93999,99",0,"-63464521,44"
01/27/2024,21551,,10878,Terminal LS - Tarjeta TPV,"52907,99",0,"-63411613,45"
01/27/2024,21557,,10892,Terminal LS - Tarjeta TPV,"292268,98",0,"-63119344,47"
01/27/2024,21575,,10862,Terminal LS - Transferencia TPV,"182518,99",0,"-62936825,48"
01/27/2024,21554,,10881,Terminal LS - Tarjeta TPV,"76153,99",0,"-62860671,49"
01/27/2024,21546,,10840,Terminal LS - Tarjeta TPV,"142255,99",0,"-62718415,5"
01/27/2024,21541,,10812,Terminal LS - Tarjeta TPV,137011,0,"-62581404,5"
01/27/2024,21569,,10819,Terminal LS - Transferencia TPV,164981,0,"-62416423,5"
01/27/2024,21564,,10798,Terminal LS - Transferencia TPV,"70799,99",0,"-62345623,51"
01/27/2024,21553,,10880,Terminal LS - Tarjeta TPV,"170553,99",0,"-62289668,32"
01/27/2024,21573,,10844,Terminal LS - Transferencia TPV,91231,0,"-62198437,32"
01/27/2024,21552,,10879,Terminal LS - Tarjeta TPV,172739,0,"-62025698,32"
01/27/2024,21543,,10829,Terminal LS - Tarjeta TPV,73859,0,"-61951839,32"
01/27/2024,21544,,10835,Terminal LS - Tarjeta TPV,84130,0,"-61867709,32"
01/27/2024,21576,,10863,Terminal LS - Transferencia TPV,86424,0,"-61781285,32"
01/27/2024,21567,,10813,Terminal LS - Transferencia TPV,63500,0,"-61717785,32"
01/27/2024,21579,,10887,Terminal LS - Transferencia TPV,"183555,99",0,"-61534229,33"
01/27/2024,21545,,10837,Terminal LS - Tarjeta TPV,62100,0,"-61472129,33"
01/27/2024,21577,,10877,Terminal LS - Transferencia TPV,105435,0,"-61366694,33"
01/27/2024,21563,,10797,Terminal LS - Transferencia TPV,62000,0,"-61304694,33"
01/27/2024,21555,,10888,Terminal LS - Tarjeta TPV,72111,0,"-61232583,33"
01/27/2024,21556,,10891,Terminal LS - Tarjeta TPV,73750,0,"-61158833,33"
01/27/2024,21559,,10780,Terminal LS - Transferencia TPV,63000,0,"-61095833,33"
01/27/2024,21578,,10885,Terminal LS - Transferencia TPV,143676,0,"-60952157,33"
01/27/2024,21566,,10809,Terminal LS - Transferencia TPV,"214584,99",0,"-60737572,34"
01/27/2024,21540,,10777,Terminal LS - Tarjeta TPV,63698,0,"-60673874,34"
01/27/2024,21562,,10789,Terminal LS - Transferencia TPV,"90138,99",0,"-60817275,36"
01/27/2024,21571,,10832,Terminal LS - Transferencia TPV,95400,0,"-60721875,36"
01/27/2024,21568,,10818,Terminal LS - Transferencia TPV,64297,0,"-60957578,36"
01/28/2024,22005,,10903,Terminal LS - Transferencia TPV,67000,0,"-60890578,36"
01/28/2024,22015,,10974,Terminal LS - Transferencia TPV,"253984,58",0,"-60636593,78"
01/28/2024,22013,,10966,Terminal LS - Transferencia TPV,"53000,01",0,"-60583593,77"
01/28/2024,22012,,10965,Terminal LS - Transferencia TPV,71000,0,"-60512593,77"
01/28/2024,22011,,10957,Terminal LS - Transferencia TPV,"107999,99",0,"-60404593,78"
01/28/2024,21558,,,Terminal LS - Tarjeta TPV,0,2033440,"-62438033,78"
01/28/2024,22010,,10948,Terminal LS - Transferencia TPV,"81397,99",0,"-62356635,79"
01/28/2024,22009,,10946,Terminal LS - Transferencia TPV,66500,0,"-62290135,79"
01/28/2024,22008,,10933,Terminal LS - Transferencia TPV,81507,0,"-62208628,79"
01/28/2024,22007,,10927,Terminal LS - Transferencia TPV,83911,0,"-62124717,79"
01/28/2024,22006,,10920,Terminal LS - Transferencia TPV,91231,0,"-62033486,79"
01/28/2024,21581,,,Terminal LS - Transferencia TPV,0,2278611,"-64312097,79"
01/28/2024,22003,,10975,Terminal LS - Tarjeta TPV,"142036,99",0,"-64170060,8"
01/28/2024,22002,,10960,Terminal LS - Tarjeta TPV,105000,0,"-64065060,8"
01/28/2024,22001,,10958,Terminal LS - Tarjeta TPV,82491,0,"-63982569,8"
01/28/2024,22000,,10955,Terminal LS - Tarjeta TPV,152963,0,"-63829606,8"
01/28/2024,21999,,10951,Terminal LS - Tarjeta TPV,156350,0,"-63673256,8"
01/28/2024,21998,,10934,Terminal LS - Tarjeta TPV,61512,0,"-63611744,8"
01/28/2024,21997,,10930,Terminal LS - Tarjeta TPV,64400,0,"-63547344,8"
01/28/2024,21996,,10902,Terminal LS - Tarjeta TPV,"228000,02",0,"-63319344,78"
01/28/2024,21995,,10893,Terminal LS - Tarjeta TPV,75826,0,"-63243518,78"
01/28/2024,22014,,10971,Terminal LS - Transferencia TPV,70000,0,"-63173518,78"
01/29/2024,22016,,,Terminal LS - Transferencia TPV,0,1027622,"-64255140,78"
01/29/2024,22004,,,Terminal LS - Tarjeta TPV,0,1068578,"-65323718,78"
01/30/2024,22193,,10989,Terminal LS - Tarjeta TPV,231193,0,"-67332525,78"
01/30/2024,22192,,10986,Terminal LS - Tarjeta TPV,105763,0,"-67226762,78"
01/30/2024,22202,,10990,Terminal LS - Transferencia TPV,86861,0,"-67139901,78"
01/30/2024,22191,,10981,Terminal LS - Tarjeta TPV,"98442,99",0,"-67041458,79"
01/30/2024,22207,,10999,Terminal LS - Transferencia TPV,46222,0,"-66995236,79"
01/30/2024,22206,,10999,Terminal LS - Transferencia TPV,92500,0,"-66902736,79"
01/30/2024,22205,,10999,Terminal LS - Transferencia TPV,46222,0,"-66856514,79"
01/30/2024,22194,,10991,Terminal LS - Tarjeta TPV,115269,0,"-66741245,79"
01/30/2024,22201,,10985,Terminal LS - Transferencia TPV,88500,0,"-66765225,39"
01/30/2024,22200,,10984,Terminal LS - Transferencia TPV,80633,0,"-66992092,85"
01/30/2024,22199,,10983,Terminal LS - Transferencia TPV,60000,0,"-66932092,85"
01/30/2024,22197,,10996,Terminal LS - Tarjeta TPV,75389,0,"-67303654,95"
01/30/2024,22196,,10995,Terminal LS - Tarjeta TPV,90685,0,"-67212969,95"
01/30/2024,22195,,10993,Terminal LS - Tarjeta TPV,"78775,99",0,"-67144193,96"
01/30/2024,22209,,11001,Terminal LS - Transferencia TPV,"129800,01",0,"-68082779,76"
01/30/2024,22208,,11000,Terminal LS - Transferencia TPV,"213382,99",0,"-74589385,54"
01/30/2024,22204,,10998,Terminal LS - Transferencia TPV,76000,0,"-74513385,54"
01/30/2024,22203,,10994,Terminal LS - Transferencia TPV,88500,0,"-74424885,54"
01/31/2024,22369,,11004,Terminal LS - Tarjeta TPV,70787,0,"-74354098,54"
01/31/2024,22385,,11024,Terminal LS - Transferencia TPV,88800,0,"-74930697,54"
01/31/2024,22384,,11018,Terminal LS - Transferencia TPV,"1193547,98",0,"-73737149,56"
01/31/2024,22383,,11017,Terminal LS - Transferencia TPV,"87079,99",0,"-73650069,57"
01/31/2024,22382,,11016,Terminal LS - Transferencia TPV,"90029,99",0,"-73560039,58"
01/31/2024,22381,,11014,Terminal LS - Transferencia TPV,"374431,03",0,"-73185608,55"
01/31/2024,22380,,11009,Terminal LS - Transferencia TPV,78011,0,"-73107597,55"
01/31/2024,22379,,11008,Terminal LS - Transferencia TPV,"155475,99",0,"-72952121,56"
01/31/2024,22378,,11007,Terminal LS - Transferencia TPV,167713,0,"-72784408,56"
01/31/2024,22377,,11006,Terminal LS - Transferencia TPV,"94509,01",0,"-72689899,55"
01/31/2024,22376,,11003,Terminal LS - Transferencia TPV,54000,0,"-72635899,55"
01/31/2024,22374,,11023,Terminal LS - Tarjeta TPV,133150,0,"-72502749,55"
01/31/2024,22373,,11021,Terminal LS - Tarjeta TPV,90685,0,"-72412064,55"
01/31/2024,22372,,11020,Terminal LS - Tarjeta TPV,"270416,97",0,"-72141647,58"
01/31/2024,22371,,11013,Terminal LS - Tarjeta TPV,57500,0,"-72084147,58"
01/31/2024,22370,,11005,Terminal LS - Tarjeta TPV,72657,0,"-72011490,58"
01/31/2024,22368,,11002,Terminal LS - Tarjeta TPV,"115268,99",0,"-73073965,59"
01/31/2024,22210,,,Terminal LS - Transferencia TPV,0,1008638,"-74082603,59"
01/31/2024,22198,,,Terminal LS - Tarjeta TPV,0,795516,"-74878119,59"
02/01/2024,22586,,11049,Terminal LS - Tarjeta TPV,"494720,98",0,"-78432469,03"
02/01/2024,22585,,11033,Terminal LS - Tarjeta TPV,52000,0,"-78380469,03"
02/01/2024,22375,,,Terminal LS - Tarjeta TPV,0,810464,"-79190933,03"
02/01/2024,22386,,,Terminal LS - Transferencia TPV,0,2383664,"-81574597,03"
02/01/2024,22598,,11048,Terminal LS - Transferencia TPV,60000,0,"-81514597,03"
02/01/2024,22597,,11047,Terminal LS - Transferencia TPV,"53000,01",0,"-81461597,02"
02/01/2024,22595,,11045,Terminal LS - Transferencia TPV,95967,0,"-83617730,02"
02/01/2024,22596,,11046,Terminal LS - Transferencia TPV,117000,0,"-83500730,02"
02/01/2024,22594,,11038,Terminal LS - Transferencia TPV,87407,0,"-83413323,02"
02/01/2024,22593,,11036,Terminal LS - Transferencia TPV,174500,0,"-83385823,02"
02/01/2024,22592,,11031,Terminal LS - Transferencia TPV,7600,0,"-88254113,02"
02/01/2024,22591,,11030,Terminal LS - Transferencia TPV,4640,0,"-89729398,22"
02/01/2024,22590,,11028,Terminal LS - Transferencia TPV,72000,0,"-89657398,22"
02/01/2024,22589,,11027,Terminal LS - Transferencia TPV,"157223,99",0,"-89500174,23"
02/01/2024,22587,,11056,Terminal LS - Tarjeta TPV,"264407,01",0,"-89235767,22"
02/01/2024,22599,,11050,Terminal LS - Transferencia TPV,"70362,99",0,"-90035546,23"
02/01/2024,22609,,11068,Terminal LS - Transferencia TPV,5769,0,"-90029777,23"
02/01/2024,22608,,11066,Terminal LS - Transferencia TPV,"83583,01",0,"-89946194,22"
02/01/2024,22607,,11065,Terminal LS - Transferencia TPV,"78666,99",0,"-89867527,23"
02/01/2024,22606,,11064,Terminal LS - Transferencia TPV,"62299,99",0,"-89805227,24"
02/01/2024,22605,,11063,Terminal LS - Transferencia TPV,"75716,99",0,"-89729510,25"
02/01/2024,22604,,11062,Terminal LS - Transferencia TPV,84676,0,"-89644834,25"
02/01/2024,22603,,11061,Terminal LS - Transferencia TPV,"97568,99",0,"-89547265,26"
02/01/2024,22602,,11060,Terminal LS - Transferencia TPV,85222,0,"-89462043,26"
02/01/2024,22601,,11059,Terminal LS - Transferencia TPV,105435,0,"-89356608,26"
02/01/2024,22600,,11058,Terminal LS - Transferencia TPV,148593,0,"-89208015,26"
02/02/2024,23020,,11124,Terminal LS - Tarjeta TPV,"112318,98",0,"-89199796,28"
02/02/2024,23027,,11088,Terminal LS - Transferencia TPV,"62500,01",0,"-89874921,27"
02/02/2024,23017,,11113,Terminal LS - Tarjeta TPV,134935,0,"-89739986,27"
02/02/2024,23023,,11142,Terminal LS - Tarjeta TPV,79541,0,"-89660445,27"
02/02/2024,23029,,11093,Terminal LS - Transferencia TPV,75389,0,"-89585056,27"
02/02/2024,23044,,11138,Terminal LS - Transferencia TPV,63418,0,"-89521638,27"
02/02/2024,23026,,11083,Terminal LS - Transferencia TPV,"78775,99",0,"-89546864,56"
02/02/2024,23018,,11114,Terminal LS - Tarjeta TPV,152307,0,"-89394557,56"
02/02/2024,23030,,11095,Terminal LS - Transferencia TPV,157989,0,"-89236568,56"
02/02/2024,23043,,11137,Terminal LS - Transferencia TPV,"95055,99",0,"-89141512,57"
02/02/2024,23015,,11109,Terminal LS - Tarjeta TPV,216661,0,"-88924851,57"
02/02/2024,23012,,11084,Terminal LS - Tarjeta TPV,170881,0,"-88753970,57"
02/02/2024,23036,,11103,Terminal LS - Transferencia TPV,68500,0,"-88685470,57"
02/02/2024,23045,,11139,Terminal LS - Transferencia TPV,87080,0,"-88598390,57"
02/02/2024,23034,,11100,Terminal LS - Transferencia TPV,"160938,99",0,"-88437451,58"
02/02/2024,23039,,11119,Terminal LS - Transferencia TPV,"163342,99",0,"-88274108,59"
02/02/2024,23040,,11122,Terminal LS - Transferencia TPV,"119092,99",0,"-88155015,6"
02/02/2024,23028,,11089,Terminal LS - Transferencia TPV,75000,0,"-88080015,6"
02/02/2024,23010,,11074,Terminal LS - Tarjeta TPV,"168040,99",0,"-87911974,61"
02/02/2024,23014,,11094,Terminal LS - Tarjeta TPV,112000,0,"-87799974,61"
02/02/2024,23011,,11075,Terminal LS - Tarjeta TPV,80633,0,"-87719341,61"
02/02/2024,23022,,11140,Terminal LS - Tarjeta TPV,"472983,01",0,"-87246358,6"
02/02/2024,22610,,,Terminal LS - Transferencia TPV,0,1727260,"-88973618,6"
02/02/2024,22588,,,Terminal LS - Tarjeta TPV,0,811127,"-89784745,6"
02/02/2024,23047,,11144,Terminal LS - Transferencia TPV,92870,0,"-89691875,6"
02/02/2024,23041,,11123,Terminal LS - Transferencia TPV,"174268,98",0,"-89517606,62"
02/02/2024,23019,,11116,Terminal LS - Tarjeta TPV,80926,0,"-89436680,62"
02/02/2024,23031,,11097,Terminal LS - Transferencia TPV,137230,0,"-89299450,62"
02/02/2024,23038,,11118,Terminal LS - Transferencia TPV,"311716,99",0,"-88987733,63"
02/02/2024,23035,,11102,Terminal LS - Transferencia TPV,68000,0,"-88919733,63"
02/02/2024,23021,,11129,Terminal LS - Tarjeta TPV,"69379,99",0,"-88850353,64"
02/02/2024,23033,,11099,Terminal LS - Transferencia TPV,"86399,99",0,"-88763953,65"
02/02/2024,23046,,11141,Terminal LS - Transferencia TPV,"77100,99",0,"-88686852,66"
02/02/2024,23013,,11092,Terminal LS - Tarjeta TPV,74296,0,"-88612556,66"
02/02/2024,23037,,11106,Terminal LS - Transferencia TPV,76044,0,"-88536512,66"
02/02/2024,23025,,11078,Terminal LS - Transferencia TPV,7000,0,"-88529512,66"
02/02/2024,23016,,11110,Terminal LS - Tarjeta TPV,"517153,91",0,"-88012358,75"
02/02/2024,23048,,11146,Terminal LS - Transferencia TPV,"80523,99",0,"-87931834,76"
02/02/2024,23032,,11098,Terminal LS - Transferencia TPV,92652,0,"-87839182,76"
02/02/2024,23042,,11132,Terminal LS - Transferencia TPV,127000,0,"-87712182,76"
02/03/2024,23750,,11197,Terminal LS - Tarjeta TPV,"81616,99",0,"-87704565,77"
02/03/2024,23777,,11224,Terminal LS - Transferencia TPV,"97568,99",0,"-87606996,78"
02/03/2024,23781,,11257,Terminal LS - Transferencia TPV,"80086,99",0,"-87526909,79"
02/03/2024,23753,,11216,Terminal LS - Tarjeta TPV,73750,0,"-87453159,79"
02/03/2024,23770,,11176,Terminal LS - Transferencia TPV,"225999,99",0,"-87227159,8"
02/03/2024,23772,,11198,Terminal LS - Transferencia TPV,"150231,01",0,"-87076928,79"
02/03/2024,23751,,11199,Terminal LS - Tarjeta TPV,"83364,99",0,"-86993563,8"
02/03/2024,23778,,11233,Terminal LS - Transferencia TPV,78000,0,"-86915563,8"
02/03/2024,23747,,11182,Terminal LS - Tarjeta TPV,"113999,99",0,"-86801563,81"
02/03/2024,23766,,11157,Terminal LS - Transferencia TPV,81944,0,"-86719619,81"
02/03/2024,23756,,11232,Terminal LS - Tarjeta TPV,"91777,99",0,"-86627841,82"
02/03/2024,23745,,11178,Terminal LS - Tarjeta TPV,205407,0,"-86422434,82"
02/03/2024,23767,,11158,Terminal LS - Transferencia TPV,"88499,99",0,"-86333934,83"
02/03/2024,23784,,11266,Terminal LS - Transferencia TPV,"156896,01",0,"-86177038,82"
02/03/2024,23024,,,Terminal LS - Tarjeta TPV,0,2442053,"-88619091,82"
02/03/2024,23049,,,Terminal LS - Transferencia TPV,0,2537884,"-91156975,82"
02/03/2024,23761,,11264,Terminal LS - Tarjeta TPV,"85221,99",0,"-91071753,83"
02/03/2024,23762,,11267,Terminal LS - Tarjeta TPV,197759,0,"-90873994,83"
02/03/2024,23749,,11192,Terminal LS - Tarjeta TPV,87407,0,"-90786587,83"
02/03/2024,23773,,11201,Terminal LS - Transferencia TPV,92324,0,"-90694263,83"
02/03/2024,23759,,11260,Terminal LS - Tarjeta TPV,141819,0,"-90552444,83"
02/03/2024,23782,,11259,Terminal LS - Transferencia TPV,"86314,99",0,"-90466129,84"
02/03/2024,23780,,11256,Terminal LS - Transferencia TPV,"164434,99",0,"-90301694,85"
02/03/2024,23774,,11208,Terminal LS - Transferencia TPV,697300,0,"-89604394,85"
02/03/2024,23760,,11263,Terminal LS - Tarjeta TPV,"89994,99",0,"-89514399,86"
02/03/2024,23776,,11212,Terminal LS - Transferencia TPV,"84238,99",0,"-89430160,87"
02/03/2024,23768,,11159,Terminal LS - Transferencia TPV,80000,0,"-89350160,87"
02/03/2024,23783,,11265,Terminal LS - Transferencia TPV,"111444,01",0,"-89238716,86"
02/03/2024,23771,,11188,Terminal LS - Transferencia TPV,67800,0,"-89170916,86"
02/03/2024,23746,,11181,Terminal LS - Tarjeta TPV,"249767,01",0,"-88921149,85"
02/03/2024,23755,,11231,Terminal LS - Tarjeta TPV,"79649,99",0,"-88841499,86"
02/03/2024,23758,,11258,Terminal LS - Tarjeta TPV,96476,0,"-88745023,86"
02/03/2024,23748,,11184,Terminal LS - Tarjeta TPV,115223,0,"-88629800,86"
02/03/2024,23754,,11227,Terminal LS - Tarjeta TPV,"260399,98",0,"-88369400,88"
02/03/2024,23779,,11253,Terminal LS - Transferencia TPV,"148045,99",0,"-88221354,89"
02/03/2024,23752,,11207,Terminal LS - Tarjeta TPV,"164499,99",0,"-88117054,9"
02/03/2024,23775,,11210,Terminal LS - Transferencia TPV,85222,0,"-88031832,9"
02/03/2024,23769,,11174,Terminal LS - Transferencia TPV,"78775,99",0,"-87953056,91"
02/03/2024,23765,,11156,Terminal LS - Transferencia TPV,69300,0,"-87883756,91"
02/03/2024,23764,,11150,Terminal LS - Transferencia TPV,71100,0,"-87812656,91"
02/03/2024,23757,,11243,Terminal LS - Tarjeta TPV,107074,0,"-87705582,91"
02/04/2024,23763,,,Terminal LS - Tarjeta TPV,0,2325207,"-90216767,91"
02/04/2024,24320,,11350,Terminal LS - Tarjeta TPV,"97350,01",0,"-90119417,9"
02/04/2024,24312,,11292,Terminal LS - Tarjeta TPV,"119900,01",0,"-89999517,89"
02/04/2024,24318,,11345,Terminal LS - Tarjeta TPV,69489,0,"-89930028,89"
02/04/2024,24301,,11323,Terminal LS - Transferencia TPV,114251,0,"-89815777,89"
02/04/2024,24291,,11282,Terminal LS - Transferencia TPV,122500,0,"-89693277,89"
02/04/2024,24309,,11357,Terminal LS - Transferencia TPV,101611,0,"-89591666,89"
02/04/2024,24308,,11356,Terminal LS - Transferencia TPV,"74623,99",0,"-89517042,9"
02/04/2024,24304,,11326,Terminal LS - Transferencia TPV,"61500,01",0,"-89455542,89"
02/04/2024,24317,,11344,Terminal LS - Tarjeta TPV,"82490,99",0,"-89373051,9"
02/04/2024,24300,,11322,Terminal LS - Transferencia TPV,133187,0,"-89239864,9"
02/04/2024,24313,,11310,Terminal LS - Tarjeta TPV,102704,0,"-89137160,9"
02/04/2024,24288,,11272,Terminal LS - Transferencia TPV,188035,0,"-88949125,9"
02/04/2024,24292,,11287,Terminal LS - Transferencia TPV,"165200,01",0,"-88783925,89"
02/04/2024,24293,,11290,Terminal LS - Transferencia TPV,"245833,01",0,"-88538092,88"
02/04/2024,23785,,,Terminal LS - Transferencia TPV,0,2795534,"-91333626,88"
02/04/2024,24249,,11280,Terminal SE - Transferencia TPV,290000,0,"-91043626,88"
02/04/2024,24294,,11291,Terminal LS - Transferencia TPV,124009,0,"-90919617,88"
02/04/2024,24296,,11296,Terminal LS - Transferencia TPV,"87407,01",0,"-90832210,87"
02/04/2024,24321,,11352,Terminal LS - Tarjeta TPV,"103686,99",0,"-90728523,88"
02/04/2024,24290,,11277,Terminal LS - Transferencia TPV,97896,0,"-90630627,88"
02/04/2024,24302,,11324,Terminal LS - Transferencia TPV,86970,0,"-90543657,88"
02/04/2024,24315,,11329,Terminal LS - Tarjeta TPV,140507,0,"-90403150,88"
02/04/2024,24295,,11295,Terminal LS - Transferencia TPV,"73968,99",0,"-90329181,89"
02/04/2024,24298,,11313,Terminal LS - Transferencia TPV,114500,0,"-90214681,89"
02/04/2024,24303,,11325,Terminal LS - Transferencia TPV,"69999,99",0,"-90144681,9"
02/04/2024,24305,,11343,Terminal LS - Transferencia TPV,"145751,99",0,"-89998929,91"
02/04/2024,24289,,11274,Terminal LS - Transferencia TPV,"85000,99",0,"-89913928,92"
02/04/2024,24314,,11321,Terminal LS - Tarjeta TPV,"410158,98",0,"-89503769,94"
02/04/2024,24265,,11334,Terminal SE - Transferencia TPV,"134000,01",0,"-89539769,93"
02/04/2024,24307,,11353,Terminal LS - Transferencia TPV,"80960,99",0,"-89458808,94"
02/04/2024,24319,,11347,Terminal LS - Tarjeta TPV,84457,0,"-89374351,94"
02/04/2024,24306,,11351,Terminal LS - Transferencia TPV,"89701,99",0,"-89284649,95"
02/04/2024,24297,,11312,Terminal LS - Transferencia TPV,"110570,01",0,"-89174079,94"
02/04/2024,24311,,11289,Terminal LS - Tarjeta TPV,"151870,01",0,"-89022209,93"
02/04/2024,24299,,11317,Terminal LS - Transferencia TPV,294000,0,"-88728209,93"
02/04/2024,24316,,11341,Terminal LS - Tarjeta TPV,"82162,99",0,"-88646046,94"
02/05/2024,24322,,,Terminal LS - Tarjeta TPV,0,1444773,"-93712604,98"
02/05/2024,24310,,,Terminal LS - Transferencia TPV,0,2667473,"-96380077,98"
02/13/2024,25327,,11513,Terminal LS - Transferencia TPV,"120622,01",0,"-104943939,87"
02/13/2024,25326,,11509,Terminal LS - Transferencia TPV,79104,0,"-104864835,87"
02/13/2024,25332,,11519,Terminal LS - Transferencia TPV,117400,0,"-105000861,87"
02/13/2024,25333,,11520,Terminal LS - Transferencia TPV,590109,0,"-104410752,87"
02/13/2024,25334,,11521,Terminal LS - Transferencia TPV,103000,0,"-104732939,87"
02/13/2024,25331,,11518,Terminal LS - Transferencia TPV,"104342,98",0,"-105714934,93"
02/13/2024,25328,,11515,Terminal LS - Transferencia TPV,127900,0,"-105774234,93"
02/13/2024,25329,,11516,Terminal LS - Transferencia TPV,"180199,99",0,"-106049936,88"
02/13/2024,25330,,11517,Terminal LS - Transferencia TPV,87080,0,"-106877088,07"
02/13/2024,25335,,11522,Terminal LS - Transferencia TPV,"386999,98",0,"-106763088,37"
02/14/2024,25484,,11534,Terminal LS - Tarjeta TPV,73531,0,"-107289623,73"
02/14/2024,25483,,11532,Terminal LS - Tarjeta TPV,"83364,99",0,"-107206258,74"
02/14/2024,25482,,11527,Terminal LS - Tarjeta TPV,79978,0,"-107126280,74"
02/14/2024,25481,,11526,Terminal LS - Tarjeta TPV,20400,0,"-107105880,74"
02/14/2024,25480,,11523,Terminal LS - Tarjeta TPV,79759,0,"-107026121,74"
02/14/2024,25485,,11538,Terminal LS - Tarjeta TPV,"110897,99",0,"-106915223,75"
02/14/2024,25486,,11540,Terminal LS - Tarjeta TPV,"81321,29",0,"-106833902,46"
02/14/2024,25487,,11541,Terminal LS - Tarjeta TPV,87844,0,"-106746058,46"
02/14/2024,25488,,11542,Terminal LS - Tarjeta TPV,67741,0,"-106678317,46"
02/14/2024,25336,,,Terminal LS - Transferencia TPV,0,1896753,"-108575070,46"
02/14/2024,25489,,11547,Terminal LS - Tarjeta TPV,128052,0,"-108841668,58"
02/14/2024,25490,,11552,Terminal LS - Tarjeta TPV,56500,0,"-108785168,58"
02/14/2024,25492,,11528,Terminal LS - Transferencia TPV,5800,0,"-108779368,58"
02/14/2024,25493,,11533,Terminal LS - Transferencia TPV,"153727,99",0,"-108625640,59"
02/14/2024,25494,,11535,Terminal LS - Transferencia TPV,69489,0,"-108556151,59"
02/14/2024,25495,,11536,Terminal LS - Transferencia TPV,97787,0,"-108458364,59"
02/14/2024,25496,,11537,Terminal LS - Transferencia TPV,83911,0,"-108374453,59"
02/14/2024,25497,,11539,Terminal LS - Transferencia TPV,103250,0,"-108271203,59"
02/14/2024,25498,,11543,Terminal LS - Transferencia TPV,"102266,99",0,"-108168936,6"
02/14/2024,25499,,11545,Terminal LS - Transferencia TPV,"31999,99",0,"-108136936,61"
02/14/2024,25500,,11548,Terminal LS - Transferencia TPV,104552,0,"-108032384,61"
02/14/2024,25501,,11549,Terminal LS - Transferencia TPV,149904,0,"-107882480,61"
02/15/2024,25671,,11565,Terminal LS - Tarjeta TPV,"89919,99",0,"-109806170,49"
02/15/2024,25673,,11573,Terminal LS - Tarjeta TPV,204970,0,"-109601200,49"
02/15/2024,25674,,11574,Terminal LS - Tarjeta TPV,85222,0,"-109515978,49"
02/15/2024,25675,,11577,Terminal LS - Tarjeta TPV,139087,0,"-109376891,49"
02/15/2024,25676,,11579,Terminal LS - Tarjeta TPV,214148,0,"-109162743,49"
02/15/2024,25677,,11583,Terminal LS - Tarjeta TPV,95700,0,"-109067043,49"
02/15/2024,25678,,11587,Terminal LS - Tarjeta TPV,80524,0,"-108986519,49"
02/15/2024,25680,,11553,Terminal LS - Transferencia TPV,"90999,99",0,"-108895519,5"
02/15/2024,25681,,11567,Terminal LS - Transferencia TPV,48400,0,"-108847119,5"
02/15/2024,25684,,11581,Terminal LS - Transferencia TPV,"275223,99",0,"-108571895,51"
02/15/2024,25683,,11580,Terminal LS - Transferencia TPV,73313,0,"-108498582,51"
02/15/2024,25682,,11575,Terminal LS - Transferencia TPV,98115,0,"-108400467,51"
02/15/2024,25686,,11588,Terminal LS - Transferencia TPV,87734,0,"-109403590,21"
02/15/2024,25670,,11555,Terminal LS - Tarjeta TPV,"77355,99",0,"-109326234,22"
02/15/2024,25669,,11554,Terminal LS - Tarjeta TPV,"101064,99",0,"-109225169,23"
02/15/2024,25672,,11569,Terminal LS - Tarjeta TPV,81944,0,"-109187225,23"
02/15/2024,25503,,,Terminal LS - Transferencia TPV,"104551,03",0,"-109082674,2"
02/15/2024,25502,,,Terminal LS - Transferencia TPV,0,1007239,"-110089913,2"
02/15/2024,25491,,,Terminal LS - Tarjeta TPV,0,869487,"-110959400,2"
02/15/2024,25685,,11586,Terminal LS - Transferencia TPV,"325001,99",0,"-110634398,21"
02/16/2024,26112,,11631,Terminal LS - Transferencia TPV,49713,0,"-110584685,21"
02/16/2024,26113,,11643,Terminal LS - Transferencia TPV,"109149,99",0,"-111476550,22"
02/16/2024,26100,,11674,Terminal LS - Tarjeta TPV,"106527,99",0,"-111370022,23"
02/16/2024,26091,,11619,Terminal LS - Tarjeta TPV,"210869,99",0,"-111159152,24"
02/16/2024,26116,,11658,Terminal LS - Transferencia TPV,99754,0,"-111059398,24"
02/16/2024,26098,,11669,Terminal LS - Tarjeta TPV,11000,0,"-111048398,24"
02/16/2024,26089,,11612,Terminal LS - Tarjeta TPV,127000,0,"-110921398,24"
02/16/2024,26097,,11665,Terminal LS - Tarjeta TPV,74624,0,"-110846774,24"
02/16/2024,26103,,11595,Terminal LS - Transferencia TPV,221000,0,"-110625774,24"
02/16/2024,26101,,11675,Terminal LS - Tarjeta TPV,125000,0,"-110500774,24"
02/16/2024,26095,,11659,Terminal LS - Tarjeta TPV,81500,0,"-110419274,24"
02/16/2024,26094,,11653,Terminal LS - Tarjeta TPV,"56700,01",0,"-110362574,23"
02/16/2024,26120,,11671,Terminal LS - Transferencia TPV,195574,0,"-110167000,23"
02/16/2024,26119,,11670,Terminal LS - Transferencia TPV,78000,0,"-110089000,23"
02/16/2024,26092,,11626,Terminal LS - Tarjeta TPV,105326,0,"-109983674,23"
02/16/2024,26104,,11597,Terminal LS - Transferencia TPV,157000,0,"-109826674,23"
02/16/2024,26115,,11657,Terminal LS - Transferencia TPV,187161,0,"-109639513,23"
02/16/2024,26088,,11610,Terminal LS - Tarjeta TPV,"84457,01",0,"-109555056,22"
02/16/2024,26111,,11628,Terminal LS - Transferencia TPV,100846,0,"-109454210,22"
02/16/2024,26110,,11623,Terminal LS - Transferencia TPV,72800,0,"-110771547,87"
02/16/2024,26093,,11630,Terminal LS - Tarjeta TPV,"451130,96",0,"-110320416,91"
02/16/2024,26117,,11662,Terminal LS - Transferencia TPV,"140398,01",0,"-110180018,9"
02/16/2024,26099,,11672,Terminal LS - Tarjeta TPV,"94181,01",0,"-110085837,89"
02/16/2024,26109,,11622,Terminal LS - Transferencia TPV,110898,0,"-109974939,89"
02/16/2024,26105,,11599,Terminal LS - Transferencia TPV,"95700,01",0,"-109879239,88"
02/16/2024,26096,,11663,Terminal LS - Tarjeta TPV,"95601,99",0,"-109783637,89"
02/16/2024,25687,,,Terminal LS - Transferencia TPV,0,998786,"-110782423,89"
02/16/2024,25679,,,Terminal LS - Tarjeta TPV,0,1169933,"-111952356,89"
02/16/2024,26114,,11647,Terminal LS - Transferencia TPV,28300,0,"-111924056,89"
02/16/2024,26118,,11664,Terminal LS - Transferencia TPV,90357,0,"-111833699,89"
02/16/2024,26107,,11601,Terminal LS - Transferencia TPV,72000,0,"-111761699,89"
02/16/2024,26106,,11600,Terminal LS - Transferencia TPV,68000,0,"-111693699,89"
02/16/2024,26108,,11611,Terminal LS - Transferencia TPV,191000,0,"-111502699,89"
02/16/2024,26090,,11618,Terminal LS - Tarjeta TPV,153291,0,"-111349408,89"
02/16/2024,26087,,11598,Terminal LS - Tarjeta TPV,"178201,99",0,"-111171206,9"
02/17/2024,26843,,11707,Terminal LS - Tarjeta TPV,19600,0,"-111263919,9"
02/17/2024,26878,,11742,Terminal LS - Transferencia TPV,"132000,01",0,"-111131919,89"
02/17/2024,26877,,11741,Terminal LS - Transferencia TPV,"95055,99",0,"-111036863,9"
02/17/2024,26885,,11782,Terminal LS - Transferencia TPV,82600,0,"-110954263,9"
02/17/2024,26102,,,Terminal LS - Tarjeta TPV,0,1955409,"-112909672,9"
02/17/2024,26879,,11755,Terminal LS - Transferencia TPV,"193060,99",0,"-112716611,91"
02/17/2024,26891,,11803,Terminal LS - Transferencia TPV,52000,0,"-112664611,91"
02/17/2024,26862,,11805,Terminal LS - Tarjeta TPV,216720,0,"-112447891,91"
02/17/2024,26861,,11802,Terminal LS - Tarjeta TPV,"373099,98",0,"-112074791,93"
02/17/2024,26863,,11806,Terminal LS - Tarjeta TPV,106200,0,"-111968591,93"
02/17/2024,26866,,11687,Terminal LS - Transferencia TPV,92324,0,"-111876267,93"
02/17/2024,26888,,11789,Terminal LS - Transferencia TPV,"97240,99",0,"-111779026,94"
02/17/2024,26867,,11688,Terminal LS - Transferencia TPV,104233,0,"-111674793,94"
02/17/2024,26853,,11784,Terminal LS - Tarjeta TPV,114600,0,"-111560193,94"
02/17/2024,26880,,11757,Terminal LS - Transferencia TPV,"221800,01",0,"-111338393,93"
02/17/2024,26860,,11800,Terminal LS - Tarjeta TPV,"88205,4",0,"-111250188,53"
02/17/2024,26854,,11786,Terminal LS - Tarjeta TPV,63152,0,"-111187036,53"
02/17/2024,26883,,11772,Terminal LS - Transferencia TPV,190000,0,"-110997036,53"
02/17/2024,26856,,11796,Terminal LS - Tarjeta TPV,56000,0,"-110941036,53"
02/17/2024,26890,,11801,Terminal LS - Transferencia TPV,70035,0,"-110871001,53"
02/17/2024,26887,,11788,Terminal LS - Transferencia TPV,"212945,98",0,"-110658055,55"
02/17/2024,26846,,11724,Terminal LS - Tarjeta TPV,"75497,99",0,"-110582557,56"
02/17/2024,26844,,11714,Terminal LS - Tarjeta TPV,"76153,99",0,"-110506403,57"
02/17/2024,26870,,11713,Terminal LS - Transferencia TPV,"28771,99",0,"-110477631,58"
02/17/2024,26884,,11781,Terminal LS - Transferencia TPV,92543,0,"-110385088,58"
02/17/2024,26882,,11764,Terminal LS - Transferencia TPV,109806,0,"-110275282,58"
02/17/2024,26892,,11804,Terminal LS - Transferencia TPV,48074,0,"-110227208,58"
02/17/2024,26858,,11798,Terminal LS - Tarjeta TPV,"171209,01",0,"-110055999,57"
02/17/2024,26886,,11783,Terminal LS - Transferencia TPV,79541,0,"-109976458,57"
02/17/2024,26849,,11746,Terminal LS - Tarjeta TPV,"404368,99",0,"-109572089,58"
02/17/2024,26871,,11716,Terminal LS - Transferencia TPV,103796,0,"-109468293,58"
02/17/2024,26889,,11792,Terminal LS - Transferencia TPV,"209231,01",0,"-109259062,57"
02/17/2024,26841,,11700,Terminal LS - Tarjeta TPV,23000,0,"-109236062,57"
02/17/2024,26845,,11720,Terminal LS - Tarjeta TPV,147063,0,"-109088999,57"
02/17/2024,26865,,11685,Terminal LS - Transferencia TPV,"154492,99",0,"-108934506,58"
02/17/2024,26868,,11703,Terminal LS - Transferencia TPV,169789,0,"-108764717,58"
02/17/2024,26869,,11712,Terminal LS - Transferencia TPV,66000,0,"-108981390,18"
02/17/2024,26872,,11729,Terminal LS - Transferencia TPV,50000,0,"-108931390,18"
02/17/2024,26873,,11732,Terminal LS - Transferencia TPV,100000,0,"-108831390,18"
02/17/2024,26874,,11732,Terminal LS - Transferencia TPV,"168999,98",0,"-109032390,2"
02/17/2024,26876,,11736,Terminal LS - Transferencia TPV,"157114,99",0,"-109475275,21"
02/17/2024,26851,,11773,Terminal LS - Tarjeta TPV,86970,0,"-109388305,21"
02/17/2024,26847,,11725,Terminal LS - Tarjeta TPV,90685,0,"-109297620,21"
02/17/2024,26857,,11797,Terminal LS - Tarjeta TPV,172739,0,"-109124881,21"
02/17/2024,26121,,,Terminal LS - Transferencia TPV,0,2067650,"-111192531,21"
02/17/2024,26855,,11787,Terminal LS - Tarjeta TPV,"52990,99",0,"-111139540,22"
02/17/2024,26850,,11770,Terminal LS - Tarjeta TPV,"74842,99",0,"-111064697,23"
02/17/2024,26852,,11779,Terminal LS - Tarjeta TPV,89920,0,"-110974777,23"
02/17/2024,26842,,11702,Terminal LS - Tarjeta TPV,88000,0,"-110886777,23"
02/17/2024,26859,,11799,Terminal LS - Tarjeta TPV,"79759,01",0,"-110807018,22"
02/17/2024,26875,,11733,Terminal LS - Transferencia TPV,227915,0,"-110579103,22"
02/17/2024,26848,,11731,Terminal LS - Tarjeta TPV,54000,0,"-110525103,22"
02/17/2024,26881,,11761,Terminal LS - Transferencia TPV,"79549,99",0,"-110445553,23"
02/18/2024,27329,,11896,Terminal LS - Tarjeta TPV,98443,0,"-110347110,23"
02/18/2024,27347,,11876,Terminal LS - Transferencia TPV,71237,0,"-110275873,23"
02/18/2024,27320,,11846,Terminal LS - Tarjeta TPV,79431,0,"-110196442,23"
02/18/2024,27344,,11859,Terminal LS - Transferencia TPV,109150,0,"-110087292,23"
02/18/2024,27319,,11845,Terminal LS - Tarjeta TPV,60000,0,"-110027292,23"
02/18/2024,27346,,11872,Terminal LS - Transferencia TPV,54000,0,"-109973292,23"
02/18/2024,27324,,11871,Terminal LS - Tarjeta TPV,"91012,99",0,"-109882279,24"
02/18/2024,27343,,11858,Terminal LS - Transferencia TPV,"197431,01",0,"-109684848,23"
02/18/2024,27334,,11903,Terminal LS - Tarjeta TPV,55023,0,"-109629825,23"
02/18/2024,27340,,11827,Terminal LS - Transferencia TPV,69300,0,"-109560525,23"
02/18/2024,27341,,11830,Terminal LS - Transferencia TPV,"89999,99",0,"-109470525,24"
02/18/2024,27325,,11875,Terminal LS - Tarjeta TPV,72000,0,"-109398525,24"
02/18/2024,27318,,11832,Terminal LS - Tarjeta TPV,"66031,01",0,"-109332494,23"
02/18/2024,27351,,11892,Terminal LS - Transferencia TPV,"98879,99",0,"-109233614,24"
02/18/2024,27348,,11878,Terminal LS - Transferencia TPV,88391,0,"-109145223,24"
02/18/2024,27332,,11899,Terminal LS - Tarjeta TPV,"89920,01",0,"-109055303,23"
02/18/2024,27330,,11897,Terminal LS - Tarjeta TPV,"123462,99",0,"-108931840,24"
02/18/2024,27338,,11813,Terminal LS - Transferencia TPV,125430,0,"-108806410,24"
02/18/2024,27339,,11817,Terminal LS - Transferencia TPV,77028,0,"-108729382,24"
02/18/2024,27328,,11891,Terminal LS - Tarjeta TPV,"209778,01",0,"-108519604,23"
02/18/2024,27322,,11868,Terminal LS - Tarjeta TPV,90139,0,"-108429465,23"
02/18/2024,26864,,,Terminal LS - Tarjeta TPV,0,2724771,"-111154236,23"
02/18/2024,27352,,11893,Terminal LS - Transferencia TPV,"88827,99",0,"-111065408,24"
02/18/2024,27342,,11857,Terminal LS - Transferencia TPV,"113629,99",0,"-110951778,25"
02/18/2024,27327,,11890,Terminal LS - Tarjeta TPV,82491,0,"-110869287,25"
02/18/2024,27331,,11898,Terminal LS - Tarjeta TPV,"76999,99",0,"-110792287,26"
02/18/2024,26893,,,Terminal LS - Transferencia TPV,0,3388915,"-114181202,26"
02/18/2024,27321,,11849,Terminal LS - Tarjeta TPV,"132203,99",0,"-114048998,27"
02/18/2024,27337,,11808,Terminal LS - Transferencia TPV,75498,0,"-113973500,27"
02/18/2024,27349,,11883,Terminal LS - Transferencia TPV,61500,0,"-113912000,27"
02/18/2024,27345,,11865,Terminal LS - Transferencia TPV,"106090,99",0,"-113805909,28"
02/18/2024,27317,,11828,Terminal LS - Tarjeta TPV,68615,0,"-113737294,28"
02/18/2024,27333,,11900,Terminal LS - Tarjeta TPV,89046,0,"-113648248,28"
02/18/2024,27323,,11869,Terminal LS - Tarjeta TPV,"93199,99",0,"-113555048,29"
02/18/2024,27335,,11906,Terminal LS - Tarjeta TPV,68833,0,"-113486215,29"
02/18/2024,27326,,11887,Terminal LS - Tarjeta TPV,"172000,01",0,"-113314215,28"
02/18/2024,27350,,11884,Terminal LS - Transferencia TPV,59000,0,"-113255215,28"
02/19/2024,27353,,,Terminal LS - Transferencia TPV,0,1486154,"-122651965,93"
02/19/2024,27336,,,Terminal LS - Tarjeta TPV,0,1817862,"-124469827,93"
02/20/2024,27521,,11915,Terminal LS - Tarjeta TPV,197322,0,"-125819505,93"
02/20/2024,27530,,11919,Terminal LS - Transferencia TPV,75389,0,"-126222616,93"
02/20/2024,27529,,11917,Terminal LS - Transferencia TPV,118219,0,"-126104397,93"
02/20/2024,27528,,11916,Terminal LS - Transferencia TPV,52500,0,"-126051897,93"
02/20/2024,27527,,11912,Terminal LS - Transferencia TPV,76809,0,"-125975088,93"
02/20/2024,27526,,11910,Terminal LS - Transferencia TPV,54000,0,"-126339048,72"
02/20/2024,27524,,11924,Terminal LS - Tarjeta TPV,295000,0,"-126044048,72"
02/20/2024,27520,,11911,Terminal LS - Tarjeta TPV,62278,0,"-126568475,66"
02/20/2024,27519,,11909,Terminal LS - Tarjeta TPV,"105981,01",0,"-126462494,65"
02/20/2024,27532,,11925,Terminal LS - Transferencia TPV,86424,0,"-126376070,65"
02/20/2024,27533,,11927,Terminal LS - Transferencia TPV,80633,0,"-126295437,65"
02/20/2024,27534,,11929,Terminal LS - Transferencia TPV,"255119,99",0,"-127099091,72"
02/20/2024,27531,,11922,Terminal LS - Transferencia TPV,"107073,99",0,"-126992017,73"
02/20/2024,27523,,11921,Terminal LS - Tarjeta TPV,"101392,99",0,"-126890624,74"
02/20/2024,27522,,11920,Terminal LS - Tarjeta TPV,"78666,99",0,"-128046624,42"
02/21/2024,27625,,11941,Terminal LS - Transferencia TPV,61000,0,"-128143625,08"
02/21/2024,27616,,11935,Terminal LS - Tarjeta TPV,76700,0,"-128126925,08"
02/21/2024,27618,,11944,Terminal LS - Tarjeta TPV,70472,0,"-128056453,08"
02/21/2024,27614,,11930,Terminal LS - Tarjeta TPV,"93416,99",0,"-127963036,09"
02/21/2024,27617,,11942,Terminal LS - Tarjeta TPV,173285,0,"-127789751,09"
02/21/2024,27619,,11949,Terminal LS - Tarjeta TPV,262769,0,"-127526982,09"
02/21/2024,27624,,11940,Terminal LS - Transferencia TPV,84785,0,"-127442197,09"
02/21/2024,27623,,11938,Terminal LS - Transferencia TPV,56500,0,"-127385697,09"
02/21/2024,27626,,11948,Terminal LS - Transferencia TPV,90139,0,"-127295558,09"
02/21/2024,27615,,11934,Terminal LS - Tarjeta TPV,24700,0,"-127270858,09"
02/21/2024,27627,,11951,Terminal LS - Transferencia TPV,"115815,01",0,"-127155043,08"
02/21/2024,27620,,11950,Terminal LS - Tarjeta TPV,231083,0,"-127773960,08"
02/21/2024,27622,,11932,Terminal LS - Transferencia TPV,95500,0,"-127678460,08"
02/21/2024,27525,,,Terminal LS - Tarjeta TPV,0,840639,"-128519099,08"
02/21/2024,27535,,,Terminal LS - Transferencia TPV,0,906167,"-129425266,08"
02/22/2024,27808,,11974,Terminal LS - Tarjeta TPV,59000,0,"-129366266,08"
02/22/2024,27799,,11980,Terminal LS - Efectivo TPV,"68614,99",0,"-129297651,09"
02/22/2024,27804,,11959,Terminal LS - Tarjeta TPV,"83036,99",0,"-129225121,8"
02/22/2024,27810,,11982,Terminal LS - Tarjeta TPV,52000,0,"-129173121,8"
02/22/2024,27806,,11963,Terminal LS - Tarjeta TPV,105435,0,"-129067686,8"
02/22/2024,27814,,11992,Terminal LS - Tarjeta TPV,11000,0,"-129056686,8"
02/22/2024,27824,,11983,Terminal LS - Transferencia TPV,79322,0,"-128977364,8"
02/22/2024,27812,,11989,Terminal LS - Tarjeta TPV,"25020,01",0,"-128952344,79"
02/22/2024,27823,,11981,Terminal LS - Transferencia TPV,99426,0,"-128852918,79"
02/22/2024,27822,,11976,Terminal LS - Transferencia TPV,54000,0,"-128798918,79"
02/22/2024,27819,,11968,Terminal LS - Transferencia TPV,79978,0,"-128718940,79"
02/22/2024,27813,,11991,Terminal LS - Tarjeta TPV,14750,0,"-128704190,79"
02/22/2024,27807,,11970,Terminal LS - Tarjeta TPV,78994,0,"-128625196,79"
02/22/2024,27817,,11952,Terminal LS - Transferencia TPV,"58000,01",0,"-128567196,78"
02/22/2024,27805,,11962,Terminal LS - Tarjeta TPV,"151870,01",0,"-128415326,77"
02/22/2024,27815,,11993,Terminal LS - Tarjeta TPV,"135481,01",0,"-128279845,76"
02/22/2024,27811,,11986,Terminal LS - Tarjeta TPV,"212508,99",0,"-128067336,77"
02/22/2024,27821,,11975,Terminal LS - Transferencia TPV,"154000,01",0,"-127913336,76"
02/22/2024,27820,,11969,Terminal LS - Transferencia TPV,87000,0,"-127826336,76"
02/22/2024,27803,,11954,Terminal LS - Tarjeta TPV,50500,0,"-127775836,76"
02/22/2024,27809,,11978,Terminal LS - Tarjeta TPV,23163,0,"-127752673,76"
02/22/2024,27621,,,Terminal LS - Tarjeta TPV,0,932425,"-128805098,76"
02/22/2024,27628,,,Terminal LS - Transferencia TPV,0,503739,"-129433843,69"
02/22/2024,27818,,11958,Terminal LS - Transferencia TPV,38750,0,"-129395093,69"
02/22/2024,27825,,11990,Terminal LS - Transferencia TPV,150000,0,"-129245093,69"
02/23/2024,27816,,,Terminal LS - Tarjeta TPV,0,1002757,"-130247850,69"
02/23/2024,28219,,12032,Terminal LS - Transferencia TPV,169200,0,"-130078650,69"
02/23/2024,28228,,12057,Terminal LS - Transferencia TPV,102704,0,"-129975946,69"
02/23/2024,28223,,12050,Terminal LS - Transferencia TPV,"195299,99",0,"-129780646,7"
02/23/2024,28206,,12059,Terminal LS - Tarjeta TPV,"668666,99",0,"-129111979,71"
02/23/2024,28208,,12063,Terminal LS - Tarjeta TPV,103796,0,"-129008183,71"
02/23/2024,28204,,12048,Terminal LS - Tarjeta TPV,121606,0,"-128886577,71"
02/23/2024,28217,,12027,Terminal LS - Transferencia TPV,59000,0,"-128827577,71"
02/23/2024,28212,,12007,Terminal LS - Transferencia TPV,85659,0,"-128741918,71"
02/23/2024,28210,,12003,Terminal LS - Transferencia TPV,54000,0,"-128687918,71"
02/23/2024,28215,,12021,Terminal LS - Transferencia TPV,172000,0,"-128515918,71"
02/23/2024,28216,,12023,Terminal LS - Transferencia TPV,"85768,99",0,"-128430149,72"
02/23/2024,28211,,12004,Terminal LS - Transferencia TPV,56500,0,"-128373649,72"
02/23/2024,28213,,12014,Terminal LS - Transferencia TPV,26400,0,"-128347249,72"
02/23/2024,28224,,12051,Terminal LS - Transferencia TPV,84130,0,"-128263119,72"
02/23/2024,28225,,12052,Terminal LS - Transferencia TPV,87954,0,"-128175165,72"
02/23/2024,28214,,12020,Terminal LS - Transferencia TPV,82054,0,"-128093111,72"
02/23/2024,28202,,12047,Terminal LS - Tarjeta TPV,151688,0,"-127941423,72"
02/23/2024,28205,,12053,Terminal LS - Tarjeta TPV,"99644,01",0,"-127841779,71"
02/23/2024,28203,,12047,Terminal LS - Tarjeta TPV,"75976,99",0,"-127765802,72"
02/23/2024,28220,,12043,Terminal LS - Transferencia TPV,"351814,99",0,"-127413987,73"
02/23/2024,28218,,12029,Terminal LS - Transferencia TPV,"84675,99",0,"-127329311,74"
02/23/2024,28221,,12046,Terminal LS - Transferencia TPV,"84675,99",0,"-127244635,75"
02/23/2024,28229,,12064,Terminal LS - Transferencia TPV,"175999,98",0,"-127068635,77"
02/23/2024,28207,,12062,Terminal LS - Tarjeta TPV,"303521,99",0,"-126765113,78"
02/23/2024,27826,,,Terminal LS - Transferencia TPV,0,800476,"-127565589,78"
02/23/2024,28227,,12056,Terminal LS - Transferencia TPV,146844,0,"-127418745,78"
02/23/2024,28222,,12049,Terminal LS - Transferencia TPV,83600,0,"-127335145,78"
02/23/2024,28226,,12054,Terminal LS - Transferencia TPV,"81288,99",0,"-127460916,79"
02/24/2024,28939,,12170,Terminal LS - Transferencia TPV,277300,0,"-127183616,79"
02/24/2024,28921,,12079,Terminal LS - Transferencia TPV,90685,0,"-127092931,79"
02/24/2024,28937,,12162,Terminal LS - Transferencia TPV,"102703,99",0,"-126990227,8"
02/24/2024,28933,,12132,Terminal LS - Transferencia TPV,"138977,99",0,"-126851249,81"
02/24/2024,28928,,12109,Terminal LS - Transferencia TPV,124500,0,"-126726749,81"
02/24/2024,28931,,12123,Terminal LS - Transferencia TPV,"125000,01",0,"-126601749,8"
02/24/2024,28907,,12127,Terminal LS - Tarjeta TPV,185085,0,"-126416664,8"
02/24/2024,28914,,12169,Terminal LS - Tarjeta TPV,"602673,99",0,"-125813990,81"
02/24/2024,28903,,12108,Terminal LS - Tarjeta TPV,146517,0,"-125667473,81"
02/24/2024,28925,,12098,Terminal LS - Transferencia TPV,"284074,02",0,"-125383399,79"
02/24/2024,28916,,12182,Terminal LS - Tarjeta TPV,"241353,98",0,"-125142045,81"
02/24/2024,28940,,12175,Terminal LS - Transferencia TPV,81400,0,"-125060645,81"
02/24/2024,28938,,12163,Terminal LS - Transferencia TPV,"249399,98",0,"-124811245,83"
02/24/2024,28943,,12180,Terminal LS - Transferencia TPV,96148,0,"-124715097,83"
02/24/2024,28936,,12155,Terminal LS - Transferencia TPV,89000,0,"-124626097,83"
02/24/2024,28918,,12188,Terminal LS - Tarjeta TPV,226200,0,"-124399897,83"
02/24/2024,28941,,12176,Terminal LS - Transferencia TPV,58096,0,"-124341801,83"
02/24/2024,28209,,,Terminal LS - Tarjeta TPV,0,3608021,"-127949822,83"
02/24/2024,28230,,,Terminal LS - Transferencia TPV,0,2269566,"-130219388,83"
02/24/2024,28905,,12112,Terminal LS - Tarjeta TPV,41600,0,"-130538978,83"
02/24/2024,28911,,12151,Terminal LS - Tarjeta TPV,221796,0,"-130317182,83"
02/24/2024,28912,,12158,Terminal LS - Tarjeta TPV,55500,0,"-130261682,83"
02/24/2024,28915,,12176,Terminal LS - Tarjeta TPV,87000,0,"-130174682,83"
02/24/2024,28929,,12112,Terminal LS - Transferencia TPV,41600,0,"-130133082,83"
02/24/2024,28927,,12106,Terminal LS - Transferencia TPV,48750,0,"-130084332,83"
02/24/2024,28917,,12184,Terminal LS - Tarjeta TPV,"97786,99",0,"-129986545,84"
02/24/2024,28904,,12111,Terminal LS - Tarjeta TPV,190111,0,"-129796434,84"
02/24/2024,28922,,12091,Terminal LS - Transferencia TPV,140000,0,"-129656434,84"
02/24/2024,28910,,12147,Terminal LS - Tarjeta TPV,"81397,99",0,"-129575036,85"
02/24/2024,28913,,12161,Terminal LS - Tarjeta TPV,"83801,99",0,"-129491234,86"
02/24/2024,28930,,12116,Terminal LS - Transferencia TPV,78120,0,"-129413114,86"
02/24/2024,28932,,12125,Terminal LS - Transferencia TPV,62500,0,"-129350614,86"
02/24/2024,28946,,12189,Terminal LS - Transferencia TPV,67741,0,"-129282873,86"
02/24/2024,28944,,12181,Terminal LS - Transferencia TPV,79322,0,"-129203551,86"
02/24/2024,28902,,12096,Terminal LS - Tarjeta TPV,267357,0,"-128936194,86"
02/24/2024,28909,,12141,Terminal LS - Tarjeta TPV,81944,0,"-128854250,86"
02/24/2024,28906,,12118,Terminal LS - Tarjeta TPV,"98770,01",0,"-128755480,85"
02/24/2024,28924,,12093,Terminal LS - Transferencia TPV,"65499,99",0,"-132340909,77"
02/24/2024,28920,,12070,Terminal LS - Transferencia TPV,85550,0,"-132255359,77"
02/24/2024,28935,,12150,Terminal LS - Transferencia TPV,147000,0,"-132108359,77"
02/24/2024,28934,,12138,Terminal LS - Transferencia TPV,136000,0,"-131972359,77"
02/24/2024,28942,,12178,Terminal LS - Transferencia TPV,"117453,98",0,"-131854905,79"
02/24/2024,28926,,12102,Terminal LS - Transferencia TPV,"422396,02",0,"-131432509,77"
02/24/2024,28901,,12071,Terminal LS - Tarjeta TPV,69100,0,"-131363409,77"
02/24/2024,28923,,12092,Terminal LS - Transferencia TPV,67000,0,"-131296409,77"
02/24/2024,28908,,12133,Terminal LS - Tarjeta TPV,90139,0,"-131206270,77"
02/24/2024,28945,,12185,Terminal LS - Transferencia TPV,160939,0,"-131045331,77"
02/25/2024,28947,,,Terminal LS - Transferencia TPV,0,3438201,"-134483532,77"
02/25/2024,29415,,12276,Terminal LS - Tarjeta TPV,101065,0,"-134382467,77"
02/25/2024,29414,,12274,Terminal LS - Tarjeta TPV,131111,0,"-134251356,77"
02/25/2024,29413,,12272,Terminal LS - Tarjeta TPV,146189,0,"-134105167,77"
02/25/2024,29412,,12268,Terminal LS - Tarjeta TPV,"111443,99",0,"-133993723,78"
02/25/2024,29411,,12251,Terminal LS - Tarjeta TPV,"58453,99",0,"-133935269,79"
02/25/2024,28919,,,Terminal LS - Tarjeta TPV,0,2868129,"-136853277,99"
02/25/2024,29410,,12233,Terminal LS - Tarjeta TPV,68615,0,"-136784662,99"
02/25/2024,29409,,12206,Terminal LS - Tarjeta TPV,69489,0,"-136715173,99"
02/25/2024,29426,,12244,Terminal LS - Transferencia TPV,59000,0,"-136656173,99"
02/25/2024,29424,,12225,Terminal LS - Transferencia TPV,"485766,98",0,"-136170407,01"
02/25/2024,29423,,12213,Terminal LS - Transferencia TPV,92870,0,"-136077537,01"
02/25/2024,29422,,12210,Terminal LS - Transferencia TPV,109587,0,"-135967950,01"
02/25/2024,29421,,12204,Terminal LS - Transferencia TPV,118765,0,"-135849185,01"
02/25/2024,29420,,12201,Terminal LS - Transferencia TPV,"124899,99",0,"-135724285,02"
02/25/2024,29418,,12191,Terminal LS - Transferencia TPV,"58999,99",0,"-135665285,03"
02/25/2024,29427,,12247,Terminal LS - Transferencia TPV,60000,0,"-135605285,03"
02/25/2024,29428,,12252,Terminal LS - Transferencia TPV,"76153,99",0,"-135529131,04"
02/25/2024,29429,,12255,Terminal LS - Transferencia TPV,"118000,01",0,"-135411131,03"
02/25/2024,29430,,12257,Terminal LS - Transferencia TPV,217426,0,"-135193705,03"
02/25/2024,29431,,12265,Terminal LS - Transferencia TPV,72000,0,"-135121705,03"
02/25/2024,29432,,12267,Terminal LS - Transferencia TPV,"76590,99",0,"-135045114,04"
02/25/2024,29433,,12277,Terminal LS - Transferencia TPV,81180,0,"-134963934,04"
02/25/2024,29434,,12278,Terminal LS - Transferencia TPV,107200,0,"-134856734,04"
02/25/2024,29425,,12234,Terminal LS - Transferencia TPV,30300,0,"-134826434,04"
02/25/2024,29419,,12195,Terminal LS - Transferencia TPV,65300,0,"-134761134,04"
02/25/2024,29416,,12279,Terminal LS - Tarjeta TPV,"87188,99",0,"-134673945,05"
02/26/2024,29435,,,Terminal LS - Transferencia TPV,0,1954039,"-136627984,05"
02/26/2024,29417,,,Terminal LS - Tarjeta TPV,0,773553,"-137401537,05"
02/28/2024,29739,,12323,Terminal LS - Transferencia TPV,106000,0,"-145511599,86"
02/28/2024,29727,,12306,Terminal LS - Transferencia TPV,167500,0,"-145344099,86"
02/28/2024,29730,,12310,Terminal LS - Transferencia TPV,66500,0,"-145277599,86"
02/28/2024,29720,,12315,Terminal LS - Tarjeta TPV,"257380,99",0,"-145414118,82"
02/28/2024,29718,,12305,Terminal LS - Tarjeta TPV,236874,0,"-145177244,82"
02/28/2024,29738,,12321,Terminal LS - Transferencia TPV,"255447,98",0,"-144921796,84"
02/28/2024,29735,,12317,Terminal LS - Transferencia TPV,"59999,99",0,"-144861796,85"
02/28/2024,29724,,12325,Terminal LS - Tarjeta TPV,"214366,99",0,"-144647429,86"
02/28/2024,29723,,12324,Terminal LS - Tarjeta TPV,"108713,01",0,"-144538716,85"
02/28/2024,29736,,12319,Terminal LS - Transferencia TPV,"75999,99",0,"-144765217,79"
02/28/2024,29722,,12322,Terminal LS - Tarjeta TPV,53600,0,"-144711617,79"
02/28/2024,29715,,12309,Terminal LS - Efectivo TPV,70000,0,"-144641617,79"
02/28/2024,29731,,12311,Terminal LS - Transferencia TPV,99500,0,"-144542117,79"
02/28/2024,29728,,12307,Terminal LS - Transferencia TPV,"132000,01",0,"-144572118,05"
02/28/2024,29732,,12313,Terminal LS - Transferencia TPV,62500,0,"-144509618,05"
02/28/2024,29729,,12308,Terminal LS - Transferencia TPV,105000,0,"-144404618,05"
02/28/2024,29721,,12318,Terminal LS - Tarjeta TPV,170554,0,"-144234064,05"
02/28/2024,29737,,12320,Terminal LS - Transferencia TPV,275798,0,"-143958266,05"
02/28/2024,29726,,12304,Terminal LS - Transferencia TPV,80524,0,"-143877742,05"
02/28/2024,29733,,12314,Terminal LS - Transferencia TPV,72111,0,"-143805631,05"
02/28/2024,29734,,12316,Terminal LS - Transferencia TPV,66000,0,"-143739631,05"
02/28/2024,29719,,12312,Terminal LS - Tarjeta TPV,"196448,01",0,"-143543183,04"
02/29/2024,29980,,12364,Terminal LS - Tarjeta TPV,37367,0,"-143505816,04"
02/29/2024,29965,,12326,Terminal LS - Tarjeta TPV,97787,0,"-143408029,04"
02/29/2024,29966,,12327,Terminal LS - Tarjeta TPV,"154601,98",0,"-143253427,06"
02/29/2024,29967,,12330,Terminal LS - Tarjeta TPV,99535,0,"-143153892,06"
02/29/2024,29968,,12338,Terminal LS - Tarjeta TPV,62500,0,"-143091392,06"
02/29/2024,29969,,12339,Terminal LS - Tarjeta TPV,"73312,99",0,"-143018079,07"
02/29/2024,29970,,12342,Terminal LS - Tarjeta TPV,"150231,01",0,"-142867848,06"
02/29/2024,29971,,12348,Terminal LS - Tarjeta TPV,"118655,99",0,"-142749192,07"
02/29/2024,29972,,12350,Terminal LS - Tarjeta TPV,91559,0,"-142657633,07"
02/29/2024,29973,,12352,Terminal LS - Tarjeta TPV,174706,0,"-142482927,07"
02/29/2024,29974,,12355,Terminal LS - Tarjeta TPV,88500,0,"-142394427,07"
02/29/2024,29975,,12356,Terminal LS - Tarjeta TPV,387870,0,"-142006557,07"
02/29/2024,29976,,12358,Terminal LS - Tarjeta TPV,101611,0,"-141904946,07"
02/29/2024,29977,,12359,Terminal LS - Tarjeta TPV,203113,0,"-141701833,07"
02/29/2024,29978,,12360,Terminal LS - Tarjeta TPV,83037,0,"-141618796,07"
02/29/2024,29979,,12362,Terminal LS - Tarjeta TPV,"112318,99",0,"-141506477,08"
02/29/2024,29981,,12365,Terminal LS - Tarjeta TPV,77574,0,"-141428903,08"
02/29/2024,29982,,12366,Terminal LS - Tarjeta TPV,82272,0,"-141346631,08"
02/29/2024,29983,,12368,Terminal LS - Tarjeta TPV,73313,0,"-141273318,08"
02/29/2024,29985,,12328,Terminal LS - Transferencia TPV,"188362,99",0,"-141084955,09"
02/29/2024,29986,,12331,Terminal LS - Transferencia TPV,700000,0,"-140384955,09"
02/29/2024,29987,,12333,Terminal LS - Transferencia TPV,61000,0,"-140323955,09"
02/29/2024,29988,,12344,Terminal LS - Transferencia TPV,67500,0,"-140256455,09"
02/29/2024,29989,,12345,Terminal LS - Transferencia TPV,"89599,99",0,"-140166855,1"
02/29/2024,29990,,12346,Terminal LS - Transferencia TPV,"122479,99",0,"-140044375,11"
02/29/2024,29991,,12353,Terminal LS - Transferencia TPV,"195137,01",0,"-139849238,1"
02/29/2024,29992,,12363,Terminal LS - Transferencia TPV,106200,0,"-139743038,1"
02/29/2024,29740,,,Terminal LS - Transferencia TPV,0,1624880,"-143006675,83"
02/29/2024,29725,,,Terminal LS - Tarjeta TPV,0,1237935,"-144690950,83"
03/01/2024,30403,,12432,Terminal LS - Tarjeta TPV,89265,0,"-144940732,87"
03/01/2024,30400,,12423,Terminal LS - Tarjeta TPV,91341,0,"-144849391,87"
03/01/2024,30418,,12389,Terminal LS - Transferencia TPV,66102,0,"-144783289,87"
03/01/2024,30434,,12438,Terminal LS - Transferencia TPV,"91799,99",0,"-144691489,88"
03/01/2024,30429,,12424,Terminal LS - Transferencia TPV,95820,0,"-144595669,88"
03/01/2024,30398,,12408,Terminal LS - Tarjeta TPV,60883,0,"-144534786,88"
03/01/2024,30416,,12387,Terminal LS - Transferencia TPV,66500,0,"-144468286,88"
03/01/2024,29993,,,Terminal LS - Transferencia TPV,0,1530279,"-146224422,88"
03/01/2024,30413,,12384,Terminal LS - Transferencia TPV,155000,0,"-148062636,88"
03/01/2024,30395,,12371,Terminal LS - Tarjeta TPV,225402,0,"-147837234,88"
03/01/2024,30427,,12419,Terminal LS - Transferencia TPV,170991,0,"-147666243,88"
03/01/2024,30406,,12444,Terminal LS - Tarjeta TPV,158670,0,"-147507573,88"
03/01/2024,30422,,12398,Terminal LS - Transferencia TPV,"103999,99",0,"-147403573,89"
03/01/2024,30397,,12379,Terminal LS - Tarjeta TPV,45050,0,"-148161427,89"
03/01/2024,30426,,12417,Terminal LS - Transferencia TPV,65000,0,"-148096427,89"
03/01/2024,29984,,,Terminal LS - Tarjeta TPV,0,2269861,"-151388906,89"
03/01/2024,30421,,12396,Terminal LS - Transferencia TPV,79213,0,"-151309693,89"
03/01/2024,30420,,12394,Terminal LS - Transferencia TPV,91778,0,"-152314988,89"
03/01/2024,29893,,,Terminal SE - Transferencia TPV,458700,0,"-153466288,89"
03/01/2024,29893,,,Terminal SE - Transferencia TPV,0,458700,"-153924988,89"
03/01/2024,30399,,12409,Terminal LS - Tarjeta TPV,"114830,99",0,"-154902311,9"
03/01/2024,30424,,12401,Terminal LS - Transferencia TPV,135372,0,"-154766939,9"
03/01/2024,30408,,12449,Terminal LS - Tarjeta TPV,84020,0,"-154682919,9"
03/01/2024,30438,,12446,Terminal LS - Transferencia TPV,"173284,99",0,"-154509634,91"
03/01/2024,30433,,12435,Terminal LS - Transferencia TPV,73500,0,"-155603427,91"
03/01/2024,30402,,12430,Terminal LS - Tarjeta TPV,"78999,99",0,"-156561769,92"
03/01/2024,30405,,12443,Terminal LS - Tarjeta TPV,"205979,98",0,"-159288335,94"
03/01/2024,30428,,12420,Terminal LS - Transferencia TPV,68287,0,"-161410721,94"
03/01/2024,30417,,12388,Terminal LS - Transferencia TPV,97787,0,"-161312934,94"
03/01/2024,30435,,12439,Terminal LS - Transferencia TPV,92980,0,"-161219954,94"
03/01/2024,30407,,12447,Terminal LS - Tarjeta TPV,"163997,99",0,"-163367305,95"
03/01/2024,30412,,12380,Terminal LS - Transferencia TPV,129500,0,"-163237805,95"
03/01/2024,30415,,12386,Terminal LS - Transferencia TPV,56500,0,"-163181305,95"
03/01/2024,30432,,12429,Terminal LS - Transferencia TPV,75498,0,"-163105807,95"
03/01/2024,30404,,12433,Terminal LS - Tarjeta TPV,"347772,01",0,"-162758035,94"
03/01/2024,30411,,12370,Terminal LS - Transferencia TPV,78994,0,"-162679041,94"
03/01/2024,30436,,12441,Terminal LS - Transferencia TPV,109600,0,"-162569441,94"
03/01/2024,30439,,12448,Terminal LS - Transferencia TPV,123463,0,"-162445978,94"
03/01/2024,30441,,12451,Terminal LS - Transferencia TPV,90685,0,"-162355293,94"
03/01/2024,30401,,12427,Terminal LS - Tarjeta TPV,"179840,99",0,"-162175452,95"
03/01/2024,30440,,12450,Terminal LS - Transferencia TPV,"50000,99",0,"-162125451,96"
03/01/2024,30419,,12391,Terminal LS - Transferencia TPV,89046,0,"-162036405,96"
03/01/2024,30414,,12385,Terminal LS - Transferencia TPV,"80414,99",0,"-163472369,97"
03/01/2024,30396,,12373,Terminal LS - Tarjeta TPV,"96912,99",0,"-163375456,98"
03/01/2024,30437,,12445,Terminal LS - Transferencia TPV,62800,0,"-163312656,98"
03/01/2024,30431,,12425,Terminal LS - Transferencia TPV,"42611,01",0,"-163270045,97"
03/01/2024,30430,,12425,Terminal LS - Transferencia TPV,42611,0,"-163227434,97"
03/01/2024,30425,,12404,Terminal LS - Transferencia TPV,170000,0,"-163057434,97"
03/01/2024,30423,,12400,Terminal LS - Transferencia TPV,66500,0,"-164340934,97"
03/02/2024,30410,,,Terminal LS - Tarjeta TPV,"29995,06",0,"-164310939,91"
03/02/2024,31073,,12505,Terminal LS - Transferencia TPV,123000,0,"-164187939,91"
03/02/2024,31078,,12525,Terminal LS - Transferencia TPV,90685,0,"-164097254,91"
03/02/2024,31087,,12564,Terminal LS - Transferencia TPV,"87024,99",0,"-164010229,92"
03/02/2024,31082,,12545,Terminal LS - Transferencia TPV,"101173,99",0,"-163909055,93"
03/02/2024,31059,,12541,Terminal LS - Tarjeta TPV,61000,0,"-163848055,93"
03/02/2024,31068,,12460,Terminal LS - Transferencia TPV,96585,0,"-163751470,93"
03/02/2024,31071,,12495,Terminal LS - Transferencia TPV,23500,0,"-163727970,93"
03/02/2024,31067,,12456,Terminal LS - Transferencia TPV,66648,0,"-163661322,93"
03/02/2024,31074,,12511,Terminal LS - Transferencia TPV,72111,0,"-163589211,93"
03/02/2024,31070,,12494,Terminal LS - Transferencia TPV,"144713,99",0,"-163444497,94"
03/02/2024,31061,,12558,Terminal LS - Tarjeta TPV,67600,0,"-163376897,94"
03/02/2024,31060,,12548,Terminal LS - Tarjeta TPV,117672,0,"-163259225,94"
03/02/2024,31066,,12455,Terminal LS - Transferencia TPV,"108166,99",0,"-163151058,95"
03/02/2024,31084,,12556,Terminal LS - Transferencia TPV,56000,0,"-163095058,95"
03/02/2024,31080,,12537,Terminal LS - Transferencia TPV,"85003,99",0,"-163010054,96"
03/02/2024,31065,,12453,Terminal LS - Transferencia TPV,45050,0,"-162965004,96"
03/02/2024,30409,,,Terminal LS - Tarjeta TPV,0,1972961,"-164937965,96"
03/02/2024,31057,,12506,Terminal LS - Tarjeta TPV,"155803,99",0,"-164982136,97"
03/02/2024,31079,,12533,Terminal LS - Transferencia TPV,113630,0,"-164868506,97"
03/02/2024,30442,,,Terminal LS - Transferencia TPV,0,2895673,"-167764179,97"
03/02/2024,31072,,12497,Terminal LS - Transferencia TPV,85222,0,"-167678957,97"
03/02/2024,31089,,12567,Terminal LS - Transferencia TPV,157060,0,"-167521897,97"
03/02/2024,31085,,12559,Terminal LS - Transferencia TPV,"69160,99",0,"-167910637,4"
03/02/2024,31069,,12473,Terminal LS - Transferencia TPV,89265,0,"-167821372,4"
03/02/2024,31083,,12554,Terminal LS - Transferencia TPV,71893,0,"-167749479,4"
03/02/2024,31077,,12524,Terminal LS - Transferencia TPV,21852,0,"-167727627,4"
03/02/2024,31081,,12539,Terminal LS - Transferencia TPV,"191913,99",0,"-167535713,41"
03/02/2024,31063,,12569,Terminal LS - Tarjeta TPV,"194699,98",0,"-167341013,43"
03/02/2024,31062,,12565,Terminal LS - Tarjeta TPV,77137,0,"-167263876,43"
03/02/2024,31056,,12457,Terminal LS - Tarjeta TPV,"149903,99",0,"-167113972,44"
03/02/2024,31075,,12512,Terminal LS - Transferencia TPV,"76699,99",0,"-167037272,45"
03/02/2024,31090,,12568,Terminal LS - Transferencia TPV,"83801,99",0,"-166953470,46"
03/02/2024,31058,,12508,Terminal LS - Tarjeta TPV,"73312,99",0,"-166880157,47"
03/02/2024,31076,,12520,Terminal LS - Transferencia TPV,182026,0,"-166698131,47"
03/02/2024,31086,,12560,Terminal LS - Transferencia TPV,90139,0,"-166607992,47"
03/02/2024,31088,,12566,Terminal LS - Transferencia TPV,"77901,99",0,"-166530090,48"
03/03/2024,31482,,12608,Terminal LS - Tarjeta TPV,"56500,01",0,"-166473590,47"
03/03/2024,31483,,12627,Terminal LS - Tarjeta TPV,"141490,99",0,"-166332099,48"
03/03/2024,31091,,,Terminal LS - Transferencia TPV,0,2410319,"-168742418,48"
03/03/2024,31481,,12577,Terminal LS - Tarjeta TPV,"83036,99",0,"-168659381,49"
03/03/2024,31490,,12589,Terminal LS - Transferencia TPV,"81671,01",0,"-168577710,48"
03/03/2024,31491,,12597,Terminal LS - Transferencia TPV,199700,0,"-168378010,48"
03/03/2024,31492,,12609,Terminal LS - Transferencia TPV,63400,0,"-168314610,48"
03/03/2024,31493,,12618,Terminal LS - Transferencia TPV,"87079,99",0,"-168227530,49"
03/03/2024,31494,,12622,Terminal LS - Transferencia TPV,61000,0,"-168166530,49"
03/03/2024,31495,,12625,Terminal LS - Transferencia TPV,59000,0,"-168107530,49"
03/03/2024,31488,,12574,Terminal LS - Transferencia TPV,41708,0,"-168065822,49"
03/03/2024,31496,,12629,Terminal LS - Transferencia TPV,"174049,99",0,"-167891772,5"
03/03/2024,31497,,12637,Terminal LS - Transferencia TPV,27970,0,"-167863802,5"
03/03/2024,31498,,12638,Terminal LS - Transferencia TPV,75826,0,"-167787976,5"
03/03/2024,31499,,12639,Terminal LS - Transferencia TPV,"95055,99",0,"-167692920,51"
03/03/2024,31064,,,Terminal LS - Tarjeta TPV,0,897129,"-168590049,51"
03/03/2024,31489,,12586,Terminal LS - Transferencia TPV,"122499,99",0,"-168467549,52"
03/03/2024,31487,,12570,Terminal LS - Transferencia TPV,59500,0,"-168408049,52"
03/03/2024,31485,,12635,Terminal LS - Tarjeta TPV,134200,0,"-168273849,52"
03/03/2024,31484,,12634,Terminal LS - Tarjeta TPV,"86751,99",0,"-168187097,53"
03/04/2024,31500,,,Terminal LS - Transferencia TPV,0,1148504,"-169335601,53"
03/04/2024,31486,,,Terminal LS - Tarjeta TPV,0,501977,"-169837578,53"
03/05/2024,31636,,12656,Terminal LS - Tarjeta TPV,173941,0,"-170013637,53"
03/05/2024,31645,,12657,Terminal LS - Transferencia TPV,"90563,01",0,"-170065267,62"
03/05/2024,31644,,12653,Terminal LS - Transferencia TPV,"131656,99",0,"-169933610,63"
03/05/2024,31642,,12663,Terminal LS - Tarjeta TPV,50000,0,"-169883610,63"
03/05/2024,31641,,12662,Terminal LS - Tarjeta TPV,"68614,99",0,"-169814995,64"
03/05/2024,31640,,12661,Terminal LS - Tarjeta TPV,"93962,99",0,"-169721032,65"
03/05/2024,31639,,12660,Terminal LS - Tarjeta TPV,"82708,99",0,"-169638323,66"
03/05/2024,31638,,12659,Terminal LS - Tarjeta TPV,"74842,99",0,"-169563480,67"
03/05/2024,31637,,12658,Terminal LS - Tarjeta TPV,110898,0,"-169452582,67"
03/05/2024,31635,,12655,Terminal LS - Tarjeta TPV,8200,0,"-169444382,67"
03/05/2024,31634,,12654,Terminal LS - Tarjeta TPV,"101829,98",0,"-169342552,69"
03/05/2024,31633,,12650,Terminal LS - Tarjeta TPV,156426,0,"-169186126,69"
03/05/2024,31632,,12649,Terminal LS - Tarjeta TPV,"15077,99",0,"-169171048,7"
03/05/2024,31631,,12648,Terminal LS - Tarjeta TPV,68300,0,"-169210778,34"
03/05/2024,31630,,12647,Terminal LS - Tarjeta TPV,88063,0,"-169538915,34"
03/06/2024,31758,,12672,Terminal LS - Tarjeta TPV,123681,0,"-171281401,64"
03/06/2024,31763,,12670,Terminal LS - Transferencia TPV,60967,0,"-171220434,64"
03/06/2024,31762,,12668,Terminal LS - Transferencia TPV,58000,0,"-171162434,64"
03/06/2024,31761,,12665,Terminal LS - Transferencia TPV,138595,0,"-171023839,64"
03/06/2024,31759,,12676,Terminal LS - Tarjeta TPV,"114721,99",0,"-170909117,65"
03/06/2024,31646,,,Terminal LS - Transferencia TPV,0,222264,"-171495431,79"
03/06/2024,31757,,12667,Terminal LS - Tarjeta TPV,54500,0,"-171440931,79"
03/06/2024,31769,,12680,Terminal LS - Transferencia TPV,151324,0,"-171289607,79"
03/06/2024,31771,,12683,Terminal LS - Transferencia TPV,67577,0,"-171222030,79"
03/06/2024,31768,,12678,Terminal LS - Transferencia TPV,"334005,99",0,"-171043024,75"
03/06/2024,31766,,12675,Terminal LS - Transferencia TPV,"495107,99",0,"-170547916,76"
03/06/2024,31756,,12666,Terminal LS - Tarjeta TPV,54500,0,"-170493416,76"
03/06/2024,31767,,12677,Terminal LS - Transferencia TPV,196000,0,"-170297416,76"
03/06/2024,31643,,,Terminal LS - Tarjeta TPV,0,1092875,"-171390291,76"
03/06/2024,31765,,12674,Terminal LS - Transferencia TPV,"177163,99",0,"-171213127,77"
03/06/2024,31764,,12671,Terminal LS - Transferencia TPV,6883,0,"-171206244,77"
03/06/2024,31770,,12681,Terminal LS - Transferencia TPV,84402,0,"-171121842,77"
03/07/2024,31893,,12708,Terminal LS - Tarjeta TPV,82709,0,"-173121340,66"
03/07/2024,31895,,12690,Terminal LS - Transferencia TPV,120950,0,"-173000390,66"
03/07/2024,31896,,12691,Terminal LS - Transferencia TPV,35509,0,"-172964881,66"
03/07/2024,31897,,12695,Terminal LS - Transferencia TPV,"79758,99",0,"-176580519,15"
03/07/2024,31892,,12707,Terminal LS - Tarjeta TPV,280796,0,"-176299723,15"
03/07/2024,31760,,,Terminal LS - Tarjeta TPV,0,347403,"-176647126,15"
03/07/2024,31772,,,Terminal LS - Transferencia TPV,0,1770023,"-178737848,4"
03/07/2024,31890,,12703,Terminal LS - Tarjeta TPV,73750,0,"-178664098,4"
03/07/2024,31898,,12697,Terminal LS - Transferencia TPV,70636,0,"-178593462,4"
03/07/2024,31899,,12698,Terminal LS - Transferencia TPV,"99999,99",0,"-178493462,41"
03/07/2024,31900,,12699,Terminal LS - Transferencia TPV,78230,0,"-178415232,41"
03/07/2024,31901,,12700,Terminal LS - Transferencia TPV,211744,0,"-178203488,41"
03/07/2024,31902,,12701,Terminal LS - Transferencia TPV,"181697,99",0,"-178529390,41"
03/07/2024,31903,,12705,Terminal LS - Transferencia TPV,92433,0,"-178436957,41"
03/07/2024,31904,,12706,Terminal LS - Transferencia TPV,"58499,99",0,"-178378457,42"
03/07/2024,31889,,12702,Terminal LS - Tarjeta TPV,"76590,99",0,"-178711366,42"
03/07/2024,31891,,12704,Terminal LS - Tarjeta TPV,108385,0,"-178887968,22"
03/08/2024,32331,,12758,Terminal LS - Transferencia TPV,69500,0,"-178818468,22"
03/08/2024,32335,,12788,Terminal LS - Transferencia TPV,87407,0,"-178731061,22"
03/08/2024,32334,,12786,Terminal LS - Transferencia TPV,107839,0,"-178623222,22"
03/08/2024,32308,,12738,Terminal LS - Tarjeta TPV,"92651,99",0,"-178530570,23"
03/08/2024,32329,,12747,Terminal LS - Transferencia TPV,"199939,99",0,"-178330630,24"
03/08/2024,32313,,12752,Terminal LS - Tarjeta TPV,120000,0,"-178210630,24"
03/08/2024,32333,,12782,Terminal LS - Transferencia TPV,"109805,99",0,"-178100824,25"
03/08/2024,32311,,12746,Terminal LS - Tarjeta TPV,59000,0,"-178041824,25"
03/08/2024,32319,,12780,Terminal LS - Tarjeta TPV,"132257,99",0,"-177909566,26"
03/08/2024,32321,,12785,Terminal LS - Tarjeta TPV,"82818,99",0,"-177826747,27"
03/08/2024,32318,,12779,Terminal LS - Tarjeta TPV,"86532,99",0,"-177740214,28"
03/08/2024,32304,,12724,Terminal LS - Tarjeta TPV,"119999,99",0,"-177620214,29"
03/08/2024,32316,,12770,Terminal LS - Tarjeta TPV,117126,0,"-177503088,29"
03/08/2024,32302,,12712,Terminal LS - Tarjeta TPV,"216496,99",0,"-177286591,3"
03/08/2024,32310,,12745,Terminal LS - Tarjeta TPV,"94181,01",0,"-177192410,29"
03/08/2024,32320,,12783,Terminal LS - Tarjeta TPV,135800,0,"-177056610,29"
03/08/2024,32317,,12773,Terminal LS - Tarjeta TPV,104124,0,"-176952486,29"
03/08/2024,31905,,,Terminal LS - Transferencia TPV,0,1029461,"-178041947,29"
03/08/2024,32315,,12768,Terminal LS - Tarjeta TPV,50000,0,"-177991947,29"
03/08/2024,32337,,12790,Terminal LS - Transferencia TPV,190000,0,"-177801947,29"
03/08/2024,32336,,12789,Terminal LS - Transferencia TPV,"111990,99",0,"-177689956,3"
03/08/2024,32326,,12726,Terminal LS - Transferencia TPV,62500,0,"-177627456,3"
03/08/2024,32330,,12757,Terminal LS - Transferencia TPV,126000,0,"-177909150,3"
03/08/2024,32322,,12787,Terminal LS - Tarjeta TPV,153181,0,"-177755969,3"
03/08/2024,32305,,12731,Terminal LS - Tarjeta TPV,69707,0,"-177686262,3"
03/08/2024,32327,,12732,Terminal LS - Transferencia TPV,"85003,99",0,"-177601258,31"
03/08/2024,32325,,12719,Terminal LS - Transferencia TPV,"77027,99",0,"-177524230,32"
03/08/2024,32338,,12791,Terminal LS - Transferencia TPV,51461,0,"-177472769,32"
03/08/2024,32309,,12744,Terminal LS - Tarjeta TPV,"132640,99",0,"-177340128,33"
03/08/2024,32314,,12753,Terminal LS - Tarjeta TPV,95602,0,"-177244526,33"
03/08/2024,32307,,12737,Terminal LS - Tarjeta TPV,81398,0,"-177163128,33"
03/08/2024,32323,,12792,Terminal LS - Tarjeta TPV,"113082,99",0,"-177050045,34"
03/08/2024,32312,,12749,Terminal LS - Tarjeta TPV,73531,0,"-176976514,34"
03/08/2024,32328,,12743,Terminal LS - Transferencia TPV,"70799,99",0,"-176905714,35"
03/08/2024,32332,,12763,Terminal LS - Transferencia TPV,88500,0,"-176817214,35"
03/08/2024,32306,,12735,Terminal LS - Tarjeta TPV,65009,0,"-176752205,35"
03/08/2024,31894,,,Terminal LS - Tarjeta TPV,0,622230,"-177374435,35"
03/08/2024,32303,,12721,Terminal LS - Tarjeta TPV,"71099,99",0,"-177303335,36"
03/09/2024,32839,,12872,Terminal LS - Transferencia TPV,"87516,99",0,"-177215818,37"
03/09/2024,32339,,,Terminal LS - Transferencia TPV,0,1437773,"-178653591,37"
03/09/2024,32324,,,Terminal LS - Tarjeta TPV,0,2266237,"-180919828,37"
03/09/2024,32842,,12875,Terminal LS - Transferencia TPV,92870,0,"-180826958,37"
03/09/2024,32841,,12874,Terminal LS - Transferencia TPV,74296,0,"-180752662,37"
03/09/2024,32834,,12857,Terminal LS - Transferencia TPV,"149466,99",0,"-180603195,38"
03/09/2024,32832,,12847,Terminal LS - Transferencia TPV,"135809,01",0,"-180467386,37"
03/09/2024,32831,,12844,Terminal LS - Transferencia TPV,110243,0,"-180357143,37"
03/09/2024,32830,,12828,Terminal LS - Transferencia TPV,402456,0,"-179954687,37"
03/09/2024,32829,,12821,Terminal LS - Transferencia TPV,102000,0,"-179852687,37"
03/09/2024,32828,,12815,Terminal LS - Transferencia TPV,67000,0,"-179785687,37"
03/09/2024,32827,,12803,Terminal LS - Transferencia TPV,104000,0,"-179681687,37"
03/09/2024,32826,,12794,Terminal LS - Transferencia TPV,92324,0,"-179589363,37"
03/09/2024,32825,,12793,Terminal LS - Transferencia TPV,102048,0,"-179487315,37"
03/09/2024,32823,,12879,Terminal LS - Tarjeta TPV,213000,0,"-179274315,37"
03/09/2024,32822,,12878,Terminal LS - Tarjeta TPV,111991,0,"-179162324,37"
03/09/2024,32821,,12876,Terminal LS - Tarjeta TPV,181370,0,"-178980954,37"
03/09/2024,32820,,12871,Terminal LS - Tarjeta TPV,"71018,99",0,"-178909935,38"
03/09/2024,32819,,12870,Terminal LS - Tarjeta TPV,"222123,99",0,"-178687811,39"
03/09/2024,32816,,12867,Terminal LS - Tarjeta TPV,127833,0,"-178559978,39"
03/09/2024,32815,,12853,Terminal LS - Tarjeta TPV,195246,0,"-178364732,39"
03/09/2024,32814,,12849,Terminal LS - Tarjeta TPV,75935,0,"-178288797,39"
03/09/2024,32813,,12848,Terminal LS - Tarjeta TPV,268231,0,"-178020566,39"
03/09/2024,32812,,12840,Terminal LS - Tarjeta TPV,"161156,99",0,"-177859409,4"
03/09/2024,32811,,12836,Terminal LS - Tarjeta TPV,"74623,99",0,"-177784785,41"
03/09/2024,32810,,12823,Terminal LS - Tarjeta TPV,78175,0,"-177706610,41"
03/09/2024,32809,,12799,Terminal LS - Tarjeta TPV,93417,0,"-177613193,41"
03/09/2024,32833,,12850,Terminal LS - Transferencia TPV,190000,0,"-177523192,79"
03/09/2024,32817,,12868,Terminal LS - Tarjeta TPV,83800,0,"-177494892,91"
03/09/2024,32818,,12868,Terminal LS - Tarjeta TPV,"401857,01",0,"-177093035,9"
03/09/2024,32835,,12859,Terminal LS - Transferencia TPV,73800,0,"-177019235,9"
03/09/2024,32836,,12860,Terminal LS - Transferencia TPV,"374322,01",0,"-176644913,89"
03/09/2024,32837,,12863,Terminal LS - Transferencia TPV,80000,0,"-176564913,89"
03/09/2024,32838,,12869,Terminal LS - Transferencia TPV,"451999,98",0,"-176112913,91"
03/09/2024,32840,,12873,Terminal LS - Transferencia TPV,"92870,01",0,"-176020043,9"
03/10/2024,33183,,12937,Terminal LS - Tarjeta TPV,79978,0,"-175940065,9"
03/10/2024,33197,,12944,Terminal LS - Transferencia TPV,65119,0,"-175874946,9"
03/10/2024,33215,,12943,Terminal SE - Efectivo TPV,56800,0,"-175818146,9"
03/10/2024,33196,,12941,Terminal LS - Transferencia TPV,57000,0,"-175761146,9"
03/10/2024,33177,,12883,Terminal LS - Tarjeta TPV,"70799,99",0,"-175690346,91"
03/10/2024,32843,,,Terminal LS - Transferencia TPV,0,2783021,"-178473367,91"
03/10/2024,33198,,12945,Terminal LS - Transferencia TPV,"68999,99",0,"-178404367,92"
03/10/2024,33199,,12965,Terminal LS - Transferencia TPV,62387,0,"-178341980,92"
03/10/2024,33195,,12910,Terminal LS - Transferencia TPV,6337,0,"-178335643,92"
03/10/2024,33178,,12901,Terminal LS - Tarjeta TPV,"115268,99",0,"-178220374,93"
03/10/2024,33179,,12911,Terminal LS - Tarjeta TPV,102267,0,"-178118107,93"
03/10/2024,33190,,12962,Terminal LS - Tarjeta TPV,108385,0,"-178009722,93"
03/10/2024,33191,,12966,Terminal LS - Tarjeta TPV,7000,0,"-178002722,93"
03/10/2024,33194,,12894,Terminal LS - Transferencia TPV,"124118,99",0,"-177878603,94"
03/10/2024,33193,,12891,Terminal LS - Transferencia TPV,77800,0,"-177800803,94"
03/10/2024,32824,,,Terminal LS - Tarjeta TPV,0,2359778,"-180160581,94"
03/10/2024,33214,,12933,Terminal SE - Efectivo TPV,115000,0,"-180045581,94"
03/10/2024,33189,,12959,Terminal LS - Tarjeta TPV,62600,0,"-179982981,94"
03/10/2024,33180,,12914,Terminal LS - Tarjeta TPV,91778,0,"-179891203,94"
03/10/2024,33181,,12920,Terminal LS - Tarjeta TPV,"73203,99",0,"-179817999,95"
03/10/2024,33182,,12934,Terminal LS - Tarjeta TPV,65000,0,"-179752999,95"
03/10/2024,33188,,12957,Terminal LS - Tarjeta TPV,"7999,99",0,"-179744999,96"
03/10/2024,33187,,12955,Terminal LS - Tarjeta TPV,"75599,99",0,"-179669399,97"
03/10/2024,33186,,12954,Terminal LS - Tarjeta TPV,"140015,99",0,"-179529383,98"
03/10/2024,33185,,12952,Terminal LS - Tarjeta TPV,"197212,99",0,"-179332170,99"
03/10/2024,33184,,12951,Terminal LS - Tarjeta TPV,"106964,99",0,-179225206
03/11/2024,33200,,,Terminal LS - Transferencia TPV,0,461762,-179686968
03/11/2024,33192,,,Terminal LS - Tarjeta TPV,0,1303973,-180990941
03/13/2024,33456,,12988,Terminal LS - Tarjeta TPV,78011,0,"-182668002,62"
03/13/2024,33462,,13005,Terminal LS - Tarjeta TPV,156022,0,"-182511980,62"
03/13/2024,33464,,12992,Terminal LS - Transferencia TPV,79500,0,"-184374001,73"
03/13/2024,33465,,12993,Terminal LS - Transferencia TPV,57000,0,"-184317001,73"
03/13/2024,33461,,13001,Terminal LS - Tarjeta TPV,93417,0,"-184223584,73"
03/13/2024,33460,,12998,Terminal LS - Tarjeta TPV,68232,0,"-184155352,73"
03/13/2024,33459,,12995,Terminal LS - Tarjeta TPV,76044,0,"-184079308,73"
03/13/2024,33458,,12991,Terminal LS - Tarjeta TPV,111444,0,"-183967864,73"
03/13/2024,33468,,12999,Terminal LS - Transferencia TPV,"88281,01",0,"-183895583,72"
03/13/2024,33467,,12997,Terminal LS - Transferencia TPV,113302,0,"-191262531,7"
03/13/2024,33471,,13004,Terminal LS - Transferencia TPV,200381,0,"-191062150,7"
03/13/2024,33470,,13003,Terminal LS - Transferencia TPV,"60693,99",0,"-191001456,71"
03/13/2024,33469,,13002,Terminal LS - Transferencia TPV,72220,0,"-190929236,71"
03/13/2024,33466,,12996,Terminal LS - Transferencia TPV,73313,0,"-190855923,71"
03/13/2024,33457,,12989,Terminal LS - Tarjeta TPV,91231,0,"-191656676,84"
03/14/2024,33678,,13015,Terminal LS - Transferencia TPV,120000,0,"-194202076,84"
03/14/2024,33472,,,Terminal LS - Transferencia TPV,0,744690,"-194946766,84"
03/14/2024,33689,,13039,Terminal LS - Transferencia TPV,55558,0,"-194891208,84"
03/14/2024,33672,,13035,Terminal LS - Tarjeta TPV,140167,0,"-194751041,84"
03/14/2024,33671,,13031,Terminal LS - Tarjeta TPV,77574,0,"-194673467,84"
03/14/2024,33670,,13022,Terminal LS - Tarjeta TPV,148265,0,"-194525202,84"
03/14/2024,33669,,13010,Terminal LS - Tarjeta TPV,"86314,99",0,"-194438887,85"
03/14/2024,33674,,13041,Terminal LS - Tarjeta TPV,101829,0,"-195740158,97"
03/14/2024,33675,,13041,Terminal LS - Tarjeta TPV,"101829,98",0,"-195638328,99"
03/14/2024,33690,,13040,Terminal LS - Transferencia TPV,91619,0,"-195546709,99"
03/14/2024,33673,,13037,Terminal LS - Tarjeta TPV,105981,0,"-195440728,99"
03/14/2024,33677,,13007,Terminal LS - Transferencia TPV,79978,0,"-195360750,99"
03/14/2024,33463,,,Terminal LS - Tarjeta TPV,0,674401,"-196035151,99"
03/14/2024,33679,,13019,Terminal LS - Transferencia TPV,"110351,99",0,-195924800
03/14/2024,33680,,13023,Terminal LS - Transferencia TPV,79213,0,-195845587
03/14/2024,33681,,13024,Terminal LS - Transferencia TPV,90357,0,-195755230
03/14/2024,33682,,13025,Terminal LS - Transferencia TPV,191313,0,-195563917
03/14/2024,33683,,13026,Terminal LS - Transferencia TPV,72100,0,-195491817
03/14/2024,33684,,13028,Terminal LS - Transferencia TPV,"115814,99",0,"-195376002,01"
03/14/2024,33685,,13032,Terminal LS - Transferencia TPV,"332148,01",0,-195043854
03/14/2024,33686,,13033,Terminal LS - Transferencia TPV,"88554,99",0,"-194955299,01"
03/14/2024,33687,,13034,Terminal LS - Transferencia TPV,"144768,99",0,"-194810530,02"
03/14/2024,33688,,13038,Terminal LS - Transferencia TPV,135481,0,"-194675049,02"
03/15/2024,34054,,13108,Terminal LS - Tarjeta TPV,"153945,99",0,"-194521103,03"
03/15/2024,34044,,13079,Terminal LS - Tarjeta TPV,59000,0,"-194462103,03"
03/15/2024,34073,,13085,Terminal LS - Transferencia TPV,"122000,01",0,"-194340103,02"
03/15/2024,34061,,13045,Terminal LS - Transferencia TPV,30046,0,"-194362333,72"
03/15/2024,34074,,13086,Terminal LS - Transferencia TPV,86861,0,"-194275472,72"
03/15/2024,34078,,13103,Terminal LS - Transferencia TPV,"241462,99",0,"-194034009,73"
03/15/2024,34046,,13081,Terminal LS - Tarjeta TPV,79541,0,"-193954468,73"
03/15/2024,34069,,13067,Terminal LS - Transferencia TPV,"84999,99",0,"-193869468,74"
03/15/2024,34057,,13112,Terminal LS - Tarjeta TPV,55558,0,"-193813910,74"
03/15/2024,34067,,13061,Terminal LS - Transferencia TPV,"80305,99",0,"-193733604,75"
03/15/2024,34070,,13069,Terminal LS - Transferencia TPV,"69200,01",0,"-193664404,74"
03/15/2024,34082,,13113,Terminal LS - Transferencia TPV,"161484,99",0,"-193502919,75"
03/15/2024,34084,,13116,Terminal LS - Transferencia TPV,14966,0,"-193487953,75"
03/15/2024,34047,,13088,Terminal LS - Tarjeta TPV,"90356,99",0,"-193397596,76"
03/15/2024,34065,,13059,Terminal LS - Transferencia TPV,"112318,98",0,"-193285277,78"
03/15/2024,34052,,13104,Terminal LS - Tarjeta TPV,"88830,01",0,"-193196447,77"
03/15/2024,34056,,13111,Terminal LS - Tarjeta TPV,95711,0,"-200600736,77"
03/15/2024,33676,,,Terminal LS - Tarjeta TPV,0,761959,"-201362695,77"
03/15/2024,34045,,13080,Terminal LS - Tarjeta TPV,83911,0,"-201278784,77"
03/15/2024,34039,,13055,Terminal LS - Tarjeta TPV,143567,0,"-201135217,77"
03/15/2024,34049,,13094,Terminal LS - Tarjeta TPV,88172,0,"-201047045,77"
03/15/2024,34076,,13090,Terminal LS - Transferencia TPV,78885,0,"-200968160,77"
03/15/2024,33691,,,Terminal LS - Transferencia TPV,0,1707337,"-202675497,77"
03/15/2024,34063,,13051,Terminal LS - Transferencia TPV,"68499,99",0,"-202606997,78"
03/15/2024,34072,,13083,Terminal LS - Transferencia TPV,80961,0,"-202526036,78"
03/15/2024,34038,,13050,Terminal LS - Tarjeta TPV,134826,0,"-202391210,78"
03/15/2024,34083,,13114,Terminal LS - Transferencia TPV,"164106,99",0,"-202227103,79"
03/15/2024,34050,,13096,Terminal LS - Tarjeta TPV,"204368,99",0,"-202022734,8"
03/15/2024,34071,,13082,Terminal LS - Transferencia TPV,102135,0,"-201920599,8"
03/15/2024,34051,,13102,Terminal LS - Tarjeta TPV,"80305,99",0,"-201840293,81"
03/15/2024,34080,,13107,Terminal LS - Transferencia TPV,192500,0,"-201647793,81"
03/15/2024,34064,,13057,Terminal LS - Transferencia TPV,"83692,99",0,"-201564100,82"
03/15/2024,34041,,13062,Terminal LS - Tarjeta TPV,"88827,99",0,"-201475272,83"
03/15/2024,34075,,13087,Terminal LS - Transferencia TPV,114500,0,"-201360772,83"
03/15/2024,34058,,13115,Terminal LS - Tarjeta TPV,"272492,99",0,"-201088279,84"
03/15/2024,34077,,13095,Terminal LS - Transferencia TPV,86861,0,"-201001418,84"
03/15/2024,34043,,13078,Terminal LS - Tarjeta TPV,93963,0,"-200907455,84"
03/15/2024,34062,,13047,Terminal LS - Transferencia TPV,"263299,99",0,"-200644155,85"
03/15/2024,34055,,13109,Terminal LS - Tarjeta TPV,56650,0,"-200587505,85"
03/15/2024,33956,,13072,Terminal SE - Transferencia TPV,77500,0,"-200510005,85"
03/15/2024,34068,,13066,Terminal LS - Transferencia TPV,58000,0,"-200452005,85"
03/15/2024,34048,,13089,Terminal LS - Tarjeta TPV,106746,0,"-200345259,85"
03/15/2024,34081,,13110,Terminal LS - Transferencia TPV,"96147,99",0,"-200249111,86"
03/15/2024,34053,,13105,Terminal LS - Tarjeta TPV,84457,0,"-200164654,86"
03/15/2024,34079,,13106,Terminal LS - Transferencia TPV,288350,0,"-199876304,86"
03/15/2024,33942,,13091,Terminal SE - Efectivo TPV,126500,0,"-199749804,86"
03/15/2024,34060,,13042,Terminal LS - Transferencia TPV,"305816,99",0,"-199443987,87"
03/15/2024,34042,,13076,Terminal LS - Tarjeta TPV,54083,0,"-199389904,87"
03/15/2024,34040,,13058,Terminal LS - Tarjeta TPV,87850,0,"-199302054,87"
03/15/2024,34066,,13060,Terminal LS - Transferencia TPV,"83145,99",0,"-199218908,88"
03/16/2024,34703,,13225,Terminal LS - Transferencia TPV,95820,0,"-199123088,88"
03/16/2024,34667,,13142,Terminal LS - Tarjeta TPV,"84457,01",0,"-201113174,86"
03/16/2024,34670,,13172,Terminal LS - Tarjeta TPV,87954,0,"-201025220,86"
03/16/2024,34685,,13147,Terminal LS - Transferencia TPV,"113999,99",0,"-200911220,87"
03/16/2024,34696,,13204,Terminal LS - Transferencia TPV,"83583,01",0,"-200827637,86"
03/16/2024,34674,,13182,Terminal LS - Tarjeta TPV,"94618,99",0,"-200733018,87"
03/16/2024,34675,,13183,Terminal LS - Tarjeta TPV,"94399,99",0,"-200638618,88"
03/16/2024,34686,,13155,Terminal LS - Transferencia TPV,65097,0,"-200573521,88"
03/16/2024,34676,,13185,Terminal LS - Tarjeta TPV,64244,0,"-200509277,88"
03/16/2024,34677,,13192,Terminal LS - Tarjeta TPV,"143784,99",0,"-200365492,89"
03/16/2024,34689,,13167,Terminal LS - Transferencia TPV,108550,0,"-200256942,89"
03/16/2024,34678,,13194,Terminal LS - Tarjeta TPV,"345149,99",0,"-199911792,9"
03/16/2024,34673,,13179,Terminal LS - Tarjeta TPV,"101064,99",0,"-199810727,91"
03/16/2024,34672,,13178,Terminal LS - Tarjeta TPV,79759,0,"-199730968,91"
03/16/2024,34679,,13203,Terminal LS - Tarjeta TPV,80196,0,"-199650772,91"
03/16/2024,34668,,13146,Terminal LS - Tarjeta TPV,114941,0,"-199535831,91"
03/16/2024,34695,,13200,Terminal LS - Transferencia TPV,90685,0,"-199445146,91"
03/16/2024,34669,,13169,Terminal LS - Tarjeta TPV,79759,0,"-199365387,91"
03/16/2024,34059,,,Terminal LS - Tarjeta TPV,0,2203159,"-201568546,91"
03/16/2024,34085,,,Terminal LS - Transferencia TPV,0,3070548,"-207990215,91"
03/16/2024,34691,,13173,Terminal LS - Transferencia TPV,83600,0,"-212120002,91"
03/16/2024,34697,,13208,Terminal LS - Transferencia TPV,"164762,99",0,"-211955239,92"
03/16/2024,34694,,13198,Terminal LS - Transferencia TPV,"366518,99",0,"-211588720,93"
03/16/2024,34692,,13181,Terminal LS - Transferencia TPV,"94499,99",0,"-211494220,94"
03/16/2024,34690,,13170,Terminal LS - Transferencia TPV,167800,0,"-211326420,94"
03/16/2024,34687,,13161,Terminal LS - Transferencia TPV,134498,0,"-211191922,94"
03/16/2024,34682,,13117,Terminal LS - Transferencia TPV,61000,0,"-211130922,94"
03/16/2024,34680,,13222,Terminal LS - Tarjeta TPV,"132968,99",0,"-210997953,95"
03/16/2024,34698,,13217,Terminal LS - Transferencia TPV,"140349,99",0,"-210857603,96"
03/16/2024,34700,,13221,Terminal LS - Transferencia TPV,90685,0,"-210766918,96"
03/16/2024,34701,,13223,Terminal LS - Transferencia TPV,475345,0,"-210291573,96"
03/16/2024,34671,,13177,Terminal LS - Tarjeta TPV,95930,0,"-210195643,96"
03/16/2024,34684,,13143,Terminal LS - Transferencia TPV,46500,0,"-210149143,96"
03/16/2024,34688,,13162,Terminal LS - Transferencia TPV,"158425,98",0,"-209990717,98"
03/16/2024,34699,,13220,Terminal LS - Transferencia TPV,82500,0,"-209908217,98"
03/16/2024,34693,,13187,Terminal LS - Transferencia TPV,"73203,99",0,"-209835013,99"
03/16/2024,34702,,13224,Terminal LS - Transferencia TPV,334115,0,"-209500898,99"
03/16/2024,34683,,13141,Terminal LS - Transferencia TPV,173000,0,"-209327898,99"
03/17/2024,35424,,13327,Terminal LS - Tarjeta TPV,"148045,99",0,-210441749
03/17/2024,35422,,13310,Terminal LS - Tarjeta TPV,"83583,01",0,"-210358165,99"
03/17/2024,35442,,13339,Terminal LS - Transferencia TPV,"91777,99",0,-210266388
03/17/2024,34681,,,Terminal LS - Tarjeta TPV,0,1599224,-211865612
03/17/2024,35425,,13331,Terminal LS - Tarjeta TPV,54000,0,-211811612
03/17/2024,35423,,13311,Terminal LS - Tarjeta TPV,"60693,99",0,"-211750918,01"
03/17/2024,35441,,13332,Terminal LS - Transferencia TPV,"70253,99",0,"-211680664,02"
03/17/2024,35440,,13328,Terminal LS - Transferencia TPV,"60693,99",0,"-211619970,03"
03/17/2024,35439,,13326,Terminal LS - Transferencia TPV,86000,0,"-211533970,03"
03/17/2024,35438,,13321,Terminal LS - Transferencia TPV,90685,0,"-211443285,03"
03/17/2024,35437,,13308,Terminal LS - Transferencia TPV,"200927,99",0,"-211242357,04"
03/17/2024,35436,,13304,Terminal LS - Transferencia TPV,88336,0,"-211154021,04"
03/17/2024,35421,,13275,Terminal LS - Tarjeta TPV,"274240,99",0,"-210879780,05"
03/17/2024,35426,,13335,Terminal LS - Tarjeta TPV,57000,0,"-210822780,05"
03/17/2024,35427,,13337,Terminal LS - Tarjeta TPV,"375086,98",0,"-210447693,07"
03/17/2024,35428,,13338,Terminal LS - Tarjeta TPV,95165,0,"-210352528,07"
03/17/2024,35429,,13353,Terminal LS - Tarjeta TPV,66976,0,"-210285552,07"
03/17/2024,35431,,13247,Terminal LS - Transferencia TPV,"210723,01",0,"-210074829,06"
03/17/2024,35432,,13254,Terminal LS - Transferencia TPV,97131,0,"-209977698,06"
03/17/2024,35433,,13278,Terminal LS - Transferencia TPV,16000,0,"-209961698,06"
03/17/2024,35434,,13283,Terminal LS - Transferencia TPV,111000,0,"-209850698,06"
03/17/2024,35435,,13301,Terminal LS - Transferencia TPV,61500,0,"-209789198,06"
03/17/2024,35420,,13253,Terminal LS - Tarjeta TPV,108870,0,"-209680328,06"
03/17/2024,35443,,13343,Terminal LS - Transferencia TPV,82272,0,"-209598056,06"
03/17/2024,34704,,,Terminal LS - Transferencia TPV,0,3204987,"-212803043,06"
03/18/2024,35444,,,Terminal LS - Transferencia TPV,0,1266798,"-214609841,06"
03/18/2024,35430,,,Terminal LS - Tarjeta TPV,0,1323661,"-215933502,06"
03/19/2024,35593,,13362,Terminal LS - Transferencia TPV,135000,0,"-215798502,06"
03/19/2024,35584,,13378,Terminal LS - Tarjeta TPV,76500,0,"-215722002,06"
03/19/2024,35583,,13375,Terminal LS - Tarjeta TPV,"109805,99",0,"-215612196,07"
03/19/2024,35582,,13374,Terminal LS - Tarjeta TPV,"69761,99",0,"-215542434,08"
03/19/2024,35581,,13366,Terminal LS - Tarjeta TPV,"171209,01",0,"-215371225,07"
03/19/2024,35580,,13361,Terminal LS - Tarjeta TPV,"87953,98",0,"-215283271,09"
03/19/2024,35598,,13371,Terminal LS - Transferencia TPV,82000,0,"-215201271,09"
03/19/2024,35600,,13373,Terminal LS - Transferencia TPV,38787,0,"-215162484,09"
03/19/2024,35597,,13370,Terminal LS - Transferencia TPV,"113999,99",0,"-215307670,31"
03/19/2024,35596,,13369,Terminal LS - Transferencia TPV,"133000,01",0,"-215174670,3"
03/19/2024,35585,,13383,Terminal LS - Tarjeta TPV,"82163,01",0,"-215092507,29"
03/19/2024,35595,,13367,Terminal LS - Transferencia TPV,"86970,01",0,"-216096605,53"
03/19/2024,35603,,13383,Terminal LS - Transferencia TPV,82163,0,"-216014442,53"
03/19/2024,35592,,13360,Terminal LS - Transferencia TPV,87000,0,"-215927442,53"
03/19/2024,35599,,13372,Terminal LS - Transferencia TPV,78284,0,"-238885158,53"
03/19/2024,35586,,13385,Terminal LS - Tarjeta TPV,"74623,99",0,"-238810534,54"
03/19/2024,35587,,13388,Terminal LS - Tarjeta TPV,197759,0,"-238612775,54"
03/19/2024,35607,,13389,Terminal LS - Transferencia TPV,288300,0,"-238324475,54"
03/19/2024,35606,,13387,Terminal LS - Transferencia TPV,98552,0,"-238225923,54"
03/19/2024,35605,,13386,Terminal LS - Transferencia TPV,68287,0,"-238157636,54"
03/19/2024,35589,,13355,Terminal LS - Transferencia TPV,264407,0,"-237893229,54"
03/19/2024,35590,,13357,Terminal LS - Transferencia TPV,72111,0,"-238229119,74"
03/19/2024,35608,,13390,Terminal LS - Transferencia TPV,"48400,01",0,"-238180719,73"
03/19/2024,35604,,13384,Terminal LS - Transferencia TPV,88500,0,"-238879171,56"
03/19/2024,35591,,13359,Terminal LS - Transferencia TPV,63000,0,"-238816171,56"
03/19/2024,35602,,13382,Terminal LS - Transferencia TPV,155804,0,"-239228953,36"
03/19/2024,35601,,13379,Terminal LS - Transferencia TPV,77137,0,"-239151816,36"
03/19/2024,35594,,13363,Terminal LS - Transferencia TPV,"68068,99",0,"-239083747,37"
03/20/2024,35689,,13396,Terminal LS - Transferencia TPV,52800,0,"-239030947,37"
03/20/2024,35691,,13398,Terminal LS - Transferencia TPV,"169132,99",0,"-238861814,38"
03/20/2024,35685,,13402,Terminal LS - Tarjeta TPV,311389,0,"-240144005,28"
03/20/2024,35692,,13400,Terminal LS - Transferencia TPV,116000,0,"-240028005,28"
03/20/2024,35588,,,Terminal LS - Tarjeta TPV,0,869773,"-240897778,28"
03/20/2024,35693,,13401,Terminal LS - Transferencia TPV,173941,0,"-240939237,52"
03/20/2024,35690,,13397,Terminal LS - Transferencia TPV,21000,0,"-240918237,52"
03/20/2024,35686,,13403,Terminal LS - Tarjeta TPV,"192842,99",0,"-240725394,53"
03/20/2024,35688,,13394,Terminal LS - Transferencia TPV,84130,0,"-240641264,53"
03/20/2024,35609,,,Terminal LS - Transferencia TPV,0,2129770,"-242771034,53"
03/21/2024,35687,,,Terminal LS - Tarjeta TPV,0,504231,"-244504624,42"
03/21/2024,35694,,,Terminal LS - Transferencia TPV,0,617003,"-245121627,42"
03/21/2024,35836,,13414,Terminal LS - Tarjeta TPV,108167,0,"-245013460,42"
03/21/2024,35837,,13432,Terminal LS - Tarjeta TPV,90904,0,"-244922556,42"
03/21/2024,35838,,13437,Terminal LS - Tarjeta TPV,129472,0,"-244793084,42"
03/21/2024,35840,,13410,Terminal LS - Transferencia TPV,111000,0,"-244682084,42"
03/21/2024,35841,,13411,Terminal LS - Transferencia TPV,52050,0,"-244630034,42"
03/21/2024,35842,,13412,Terminal LS - Transferencia TPV,"181000,02",0,"-244449034,4"
03/21/2024,35843,,13413,Terminal LS - Transferencia TPV,68232,0,"-244380802,4"
03/21/2024,35844,,13415,Terminal LS - Transferencia TPV,66000,0,"-244314802,4"
03/21/2024,35845,,13418,Terminal LS - Transferencia TPV,88172,0,"-244226630,4"
03/21/2024,35846,,13421,Terminal LS - Transferencia TPV,100846,0,"-244125784,4"
03/21/2024,35847,,13422,Terminal LS - Transferencia TPV,67500,0,"-244058284,4"
03/21/2024,35848,,13424,Terminal LS - Transferencia TPV,"65049,99",0,"-243993234,41"
03/22/2024,36212,,13503,Terminal LS - Tarjeta TPV,75389,0,"-243917845,41"
03/22/2024,36232,,13500,Terminal LS - Transferencia TPV,"101038,99",0,"-243816806,42"
03/22/2024,36204,,13460,Terminal LS - Tarjeta TPV,53000,0,"-243763806,42"
03/22/2024,36220,,13465,Terminal LS - Transferencia TPV,74624,0,"-243689182,42"
03/22/2024,36236,,13509,Terminal LS - Transferencia TPV,69489,0,"-243637693,42"
03/22/2024,36202,,13450,Terminal LS - Tarjeta TPV,"85768,99",0,"-243551924,43"
03/22/2024,36222,,13469,Terminal LS - Transferencia TPV,95930,0,"-243455994,43"
03/22/2024,36208,,13475,Terminal LS - Tarjeta TPV,100519,0,"-243355475,43"
03/22/2024,36231,,13497,Terminal LS - Transferencia TPV,50000,0,"-243305475,43"
03/22/2024,36215,,13513,Terminal LS - Tarjeta TPV,"639598,98",0,"-242665876,45"
03/22/2024,36226,,13483,Terminal LS - Transferencia TPV,7600,0,"-242658276,45"
03/22/2024,36235,,13506,Terminal LS - Transferencia TPV,"169898,01",0,"-242488378,44"
03/22/2024,36211,,13502,Terminal LS - Tarjeta TPV,"89701,99",0,"-242710487,45"
03/22/2024,36207,,13468,Terminal LS - Tarjeta TPV,62600,0,"-242647887,45"
03/22/2024,36241,,13517,Terminal LS - Transferencia TPV,66484,0,"-242581403,45"
03/22/2024,36227,,13488,Terminal LS - Transferencia TPV,62000,0,"-242519403,45"
03/22/2024,36237,,13510,Terminal LS - Transferencia TPV,33300,0,"-242486103,45"
03/22/2024,36206,,13462,Terminal LS - Tarjeta TPV,"83582,99",0,"-242402520,46"
03/22/2024,36199,,13446,Terminal LS - Tarjeta TPV,"226166,99",0,"-242176353,47"
03/22/2024,36234,,13505,Terminal LS - Transferencia TPV,89593,0,"-242086760,47"
03/22/2024,36209,,13485,Terminal LS - Tarjeta TPV,102048,0,"-241984712,47"
03/22/2024,36242,,13518,Terminal LS - Transferencia TPV,"141000,01",0,"-241843712,46"
03/22/2024,36229,,13491,Terminal LS - Transferencia TPV,"109999,99",0,"-241733712,47"
03/22/2024,36214,,13511,Terminal LS - Tarjeta TPV,"129240,49",0,"-241604471,98"
03/22/2024,36223,,13471,Terminal LS - Transferencia TPV,"127000,01",0,"-241477471,97"
03/22/2024,36203,,13455,Terminal LS - Tarjeta TPV,86000,0,"-241391471,97"
03/22/2024,36205,,13461,Terminal LS - Tarjeta TPV,"104342,99",0,"-241287128,98"
03/22/2024,36230,,13495,Terminal LS - Transferencia TPV,"80305,99",0,"-241206822,99"
03/22/2024,36228,,13489,Terminal LS - Transferencia TPV,75000,0,"-241131822,99"
03/22/2024,36210,,13493,Terminal LS - Tarjeta TPV,101611,0,"-241030211,99"
03/22/2024,36240,,13516,Terminal LS - Transferencia TPV,88937,0,"-240941274,99"
03/22/2024,36221,,13467,Terminal LS - Transferencia TPV,75607,0,"-240865667,99"
03/22/2024,36218,,13447,Terminal LS - Transferencia TPV,"59928,99",0,-240805739
03/22/2024,35839,,,Terminal LS - Tarjeta TPV,0,328543,-241134282
03/22/2024,36233,,13504,Terminal LS - Transferencia TPV,"86314,99",0,"-241047967,01"
03/22/2024,36217,,13440,Terminal LS - Transferencia TPV,64000,0,"-240983967,01"
03/22/2024,36200,,13449,Terminal LS - Tarjeta TPV,44000,0,"-240939967,01"
03/22/2024,36201,,13449,Terminal LS - Tarjeta TPV,22000,0,"-240917967,01"
03/22/2024,36213,,13507,Terminal LS - Tarjeta TPV,"258957,01",0,-240659010
03/22/2024,36219,,13456,Terminal LS - Transferencia TPV,53050,0,-240605960
03/22/2024,36224,,13479,Terminal LS - Transferencia TPV,94181,0,-240511779
03/22/2024,36225,,13480,Terminal LS - Transferencia TPV,"233431,99",0,"-240278347,01"
03/22/2024,36238,,13512,Terminal LS - Transferencia TPV,"80305,99",0,"-240198041,02"
03/22/2024,36239,,13514,Terminal LS - Transferencia TPV,80852,0,"-240117189,02"
03/23/2024,36216,,,Terminal LS - Tarjeta TPV,0,2264525,"-244482114,54"
03/23/2024,36243,,,Terminal LS - Transferencia TPV,0,2269880,"-246751994,54"
03/24/2024,37327,,13659,Terminal LS - Transferencia TPV,78667,0,"-246904627,34"
03/24/2024,37335,,13704,Terminal LS - Transferencia TPV,"127833,01",0,"-246776794,33"
03/24/2024,37328,,13661,Terminal LS - Transferencia TPV,157333,0,"-246619461,33"
03/24/2024,37314,,13652,Terminal LS - Tarjeta TPV,"56500,01",0,"-246562961,32"
03/24/2024,37329,,13665,Terminal LS - Transferencia TPV,90700,0,"-246472261,32"
03/24/2024,37330,,13666,Terminal LS - Transferencia TPV,"122999,99",0,"-246349261,33"
03/24/2024,37313,,13602,Terminal LS - Tarjeta TPV,77000,0,"-246272261,33"
03/24/2024,37331,,13675,Terminal LS - Transferencia TPV,"83364,99",0,"-247045696,34"
03/24/2024,37332,,13683,Terminal LS - Transferencia TPV,95602,0,"-247399914,34"
03/24/2024,37333,,13686,Terminal LS - Transferencia TPV,57800,0,"-247342114,34"
03/24/2024,37320,,13707,Terminal LS - Tarjeta TPV,114722,0,"-247227392,34"
03/24/2024,37319,,13706,Terminal LS - Tarjeta TPV,86315,0,"-247141077,34"
03/24/2024,37318,,13703,Terminal LS - Tarjeta TPV,89000,0,"-247052077,34"
03/24/2024,37317,,13692,Terminal LS - Tarjeta TPV,221500,0,"-246830577,34"
03/24/2024,37323,,13639,Terminal LS - Transferencia TPV,111226,0,"-246719351,34"
03/24/2024,37336,,13705,Terminal LS - Transferencia TPV,"130899,99",0,"-246588451,35"
03/24/2024,37324,,13642,Terminal LS - Transferencia TPV,"71127,99",0,"-246517323,36"
03/24/2024,37316,,13691,Terminal LS - Tarjeta TPV,67304,0,"-246450019,36"
03/24/2024,37325,,13648,Terminal LS - Transferencia TPV,128000,0,"-246322019,36"
03/24/2024,37326,,13649,Terminal LS - Transferencia TPV,62500,0,"-246259519,36"
03/24/2024,37334,,13700,Terminal LS - Transferencia TPV,"144003,99",0,"-246115515,37"
03/24/2024,37322,,13605,Terminal LS - Transferencia TPV,80196,0,"-246035319,37"
03/24/2024,37315,,13681,Terminal LS - Tarjeta TPV,83583,0,"-245951736,37"
03/25/2024,37687,,13768,Terminal LS - Transferencia TPV,160174,0,"-245791562,37"
03/25/2024,37321,,,Terminal LS - Tarjeta TPV,0,795924,"-246587486,37"
03/25/2024,37337,,,Terminal LS - Transferencia TPV,0,1542252,"-248129738,37"
03/25/2024,37685,,13755,Terminal LS - Transferencia TPV,"98879,99",0,"-248030858,38"
03/25/2024,37684,,13754,Terminal LS - Transferencia TPV,61000,0,"-247969858,38"
03/25/2024,37683,,13715,Terminal LS - Transferencia TPV,72657,0,"-247897201,38"
03/25/2024,37681,,13771,Terminal LS - Tarjeta TPV,"90198,01",0,"-247807003,37"
03/25/2024,37680,,13728,Terminal LS - Tarjeta TPV,179622,0,"-247627381,37"
03/25/2024,37679,,13723,Terminal LS - Tarjeta TPV,"83037,01",0,"-247544344,36"
03/25/2024,37678,,13708,Terminal LS - Tarjeta TPV,"130291,99",0,"-249984088,37"
03/25/2024,37686,,13760,Terminal LS - Transferencia TPV,210215,0,"-249773873,37"
03/25/2024,37688,,13773,Terminal LS - Transferencia TPV,88609,0,"-249685264,37"
03/25/2024,37689,,13778,Terminal LS - Transferencia TPV,102922,0,"-249582342,37"
03/25/2024,37690,,13779,Terminal LS - Transferencia TPV,107183,0,"-249475159,37"
03/26/2024,37691,,,Terminal LS - Transferencia TPV,0,901639,"-253895888,65"
03/26/2024,39318,,13793,Terminal LS - Tarjeta TPV,"87844,01",0,"-253808044,64"
03/26/2024,39321,,13784,Terminal LS - Transferencia TPV,84239,0,"-254866805,64"
03/26/2024,37682,,,Terminal LS - Tarjeta TPV,0,483149,"-255349954,64"
03/26/2024,39322,,13787,Terminal LS - Transferencia TPV,237100,0,"-255506252,94"
03/26/2024,39323,,13788,Terminal LS - Transferencia TPV,80852,0,"-255425400,94"
03/26/2024,39324,,13790,Terminal LS - Transferencia TPV,35000,0,"-255390400,94"
03/26/2024,39325,,13795,Terminal LS - Transferencia TPV,73750,0,"-255859450,94"
03/26/2024,39319,,13794,Terminal LS - Tarjeta TPV,90111,0,"-256222798,42"
03/26/2024,39317,,13783,Terminal LS - Tarjeta TPV,85878,0,"-256136920,42"
03/27/2024,39698,,13863,Terminal LS - Transferencia TPV,"145899,99",0,"-257115768,25"
03/27/2024,39326,,,Terminal LS - Transferencia TPV,0,510941,"-257626709,25"
03/27/2024,39673,,13814,Terminal LS - Tarjeta TPV,"243320,01",0,"-257383389,24"
03/27/2024,39674,,13825,Terminal LS - Tarjeta TPV,"83582,99",0,"-257299806,25"
03/27/2024,39675,,13831,Terminal LS - Tarjeta TPV,85222,0,"-257214584,25"
03/27/2024,39676,,13839,Terminal LS - Tarjeta TPV,"66429,99",0,"-257148154,26"
03/27/2024,39677,,13845,Terminal LS - Tarjeta TPV,154000,0,"-256994154,26"
03/27/2024,39678,,13858,Terminal LS - Tarjeta TPV,177765,0,"-256816389,26"
03/27/2024,39679,,13860,Terminal LS - Tarjeta TPV,"205079,98",0,"-256611309,28"
03/27/2024,39681,,13811,Terminal LS - Transferencia TPV,"91499,99",0,"-256519809,29"
03/27/2024,39682,,13815,Terminal LS - Transferencia TPV,"227040,99",0,"-256292768,3"
03/27/2024,39683,,13816,Terminal LS - Transferencia TPV,176454,0,"-256116314,3"
03/27/2024,39684,,13827,Terminal LS - Transferencia TPV,"64999,99",0,"-256051314,31"
03/27/2024,39320,,,Terminal LS - Tarjeta TPV,0,263833,"-256315147,31"
03/27/2024,39695,,13857,Terminal LS - Transferencia TPV,174269,0,"-257338581,78"
03/27/2024,39694,,13855,Terminal LS - Transferencia TPV,138213,0,"-257200368,78"
03/27/2024,39693,,13854,Terminal LS - Transferencia TPV,62000,0,"-257138368,78"
03/27/2024,39692,,13851,Terminal LS - Transferencia TPV,"675440,98",0,"-256462927,8"
03/27/2024,39691,,13850,Terminal LS - Transferencia TPV,"84149,99",0,"-256378777,81"
03/27/2024,39690,,13848,Terminal LS - Transferencia TPV,224528,0,"-256154249,81"
03/27/2024,39689,,13847,Terminal LS - Transferencia TPV,61786,0,"-256092463,81"
03/27/2024,39688,,13844,Terminal LS - Transferencia TPV,"87953,99",0,"-256004509,82"
03/27/2024,39687,,13836,Terminal LS - Transferencia TPV,169000,0,"-255835509,82"
03/27/2024,39686,,13830,Terminal LS - Transferencia TPV,"158316,99",0,"-255677192,83"
03/27/2024,39685,,13828,Terminal LS - Transferencia TPV,96039,0,"-255581153,83"
03/27/2024,39696,,13861,Terminal LS - Transferencia TPV,80306,0,"-255500847,83"
03/27/2024,39697,,13862,Terminal LS - Transferencia TPV,192296,0,"-255308551,83"
03/27/2024,39699,,13864,Terminal LS - Transferencia TPV,135154,0,"-255173397,83"
03/28/2024,40300,,13922,Terminal LS - Transferencia TPV,"111444,01",0,"-255061953,82"
03/28/2024,40304,,13935,Terminal LS - Transferencia TPV,"116482,98",0,"-254945470,84"
03/28/2024,40285,,13867,Terminal LS - Tarjeta TPV,45050,0,"-254900420,84"
03/28/2024,40286,,13876,Terminal LS - Tarjeta TPV,85659,0,"-254814761,84"
03/28/2024,40287,,13893,Terminal LS - Tarjeta TPV,113630,0,"-254701131,84"
03/28/2024,40288,,13899,Terminal LS - Tarjeta TPV,158644,0,"-254542487,84"
03/28/2024,40289,,13903,Terminal LS - Tarjeta TPV,57689,0,"-254484798,84"
03/28/2024,40308,,13953,Terminal LS - Transferencia TPV,"217753,99",0,"-254267044,85"
03/28/2024,40309,,13958,Terminal LS - Transferencia TPV,"133299,99",0,"-254133744,86"
03/28/2024,40310,,13959,Terminal LS - Transferencia TPV,104000,0,"-254029744,86"
03/28/2024,40311,,13961,Terminal LS - Transferencia TPV,68615,0,"-253961129,86"
03/28/2024,40312,,13962,Terminal LS - Transferencia TPV,"412562,98",0,"-253548566,88"
03/28/2024,40313,,13963,Terminal LS - Transferencia TPV,15000,0,"-253533566,88"
03/28/2024,39700,,,Terminal LS - Transferencia TPV,0,3045345,"-256578911,88"
03/28/2024,40301,,13923,Terminal LS - Transferencia TPV,172739,0,"-256406172,88"
03/28/2024,40302,,13932,Terminal LS - Transferencia TPV,"89155,99",0,"-256317016,89"
03/28/2024,40303,,13934,Terminal LS - Transferencia TPV,87407,0,"-256229609,89"
03/28/2024,40305,,13937,Terminal LS - Transferencia TPV,10500,0,"-256219109,89"
03/28/2024,40306,,13943,Terminal LS - Transferencia TPV,82000,0,"-256137109,89"
03/28/2024,40307,,13949,Terminal LS - Transferencia TPV,127833,0,"-256009276,89"
03/28/2024,39680,,,Terminal LS - Tarjeta TPV,0,1015398,"-257024674,89"
03/28/2024,40314,,13964,Terminal LS - Transferencia TPV,"85768,99",0,"-256938905,9"
03/28/2024,40290,,13905,Terminal LS - Tarjeta TPV,215186,0,"-256723719,9"
03/28/2024,40291,,13915,Terminal LS - Tarjeta TPV,163124,0,"-256560595,9"
03/28/2024,40292,,13929,Terminal LS - Tarjeta TPV,"163997,99",0,"-256396597,91"
03/28/2024,40293,,13942,Terminal LS - Tarjeta TPV,195902,0,"-256200695,91"
03/28/2024,40295,,13866,Terminal LS - Transferencia TPV,69000,0,"-256131695,91"
03/28/2024,40296,,13875,Terminal LS - Transferencia TPV,"84675,99",0,"-256047019,92"
03/28/2024,40297,,13877,Terminal LS - Transferencia TPV,93635,0,"-255953384,92"
03/28/2024,40298,,13902,Terminal LS - Transferencia TPV,108900,0,"-255844484,92"
03/28/2024,40299,,13916,Terminal LS - Transferencia TPV,"63599,99",0,"-255780884,93"
03/28/2024,40315,,13966,Terminal LS - Transferencia TPV,"197500,01",0,"-255583384,92"
03/28/2024,40316,,13967,Terminal LS - Transferencia TPV,"89482,99",0,"-255493901,93"
03/29/2024,40962,,14011,Terminal LS - Tarjeta TPV,51000,0,"-255442901,93"
03/29/2024,40973,,14030,Terminal LS - Transferencia TPV,65500,0,"-255377401,93"
03/29/2024,40981,,14083,Terminal LS - Transferencia TPV,79450,0,"-255297951,93"
03/29/2024,40294,,,Terminal LS - Tarjeta TPV,0,1198881,"-256496832,93"
03/29/2024,40980,,14079,Terminal LS - Transferencia TPV,60000,0,"-256436832,93"
03/29/2024,40963,,14020,Terminal LS - Tarjeta TPV,"162199,99",0,"-256274632,94"
03/29/2024,40968,,14075,Terminal LS - Tarjeta TPV,"251624,01",0,"-256023008,93"
03/29/2024,40976,,14057,Terminal LS - Transferencia TPV,"171537,01",0,"-255851471,92"
03/29/2024,40964,,14036,Terminal LS - Tarjeta TPV,72657,0,"-255778814,92"
03/29/2024,40982,,14087,Terminal LS - Transferencia TPV,"186942,99",0,"-255591871,93"
03/29/2024,40974,,14043,Terminal LS - Transferencia TPV,56000,0,"-255535871,93"
03/29/2024,40978,,14067,Terminal LS - Transferencia TPV,"148699,99",0,"-255387171,94"
03/29/2024,40317,,,Terminal LS - Transferencia TPV,0,2541351,"-257928522,94"
03/29/2024,40960,,13974,Terminal LS - Tarjeta TPV,"64243,01",0,"-257864279,93"
03/29/2024,40979,,14078,Terminal LS - Transferencia TPV,"48000,01",0,"-259021706,31"
03/29/2024,40972,,13974,Terminal LS - Transferencia TPV,128490,0,"-259243216,31"
03/29/2024,40970,,14086,Terminal LS - Tarjeta TPV,55000,0,"-259188216,31"
03/29/2024,40975,,14055,Terminal LS - Transferencia TPV,"85441,01",0,"-259102775,3"
03/29/2024,40969,,14085,Terminal LS - Tarjeta TPV,56000,0,"-259046775,3"
03/29/2024,40977,,14059,Terminal LS - Transferencia TPV,133000,0,"-258913775,3"
03/29/2024,40966,,14050,Terminal LS - Tarjeta TPV,57800,0,"-258855975,3"
03/29/2024,40961,,14010,Terminal LS - Tarjeta TPV,61000,0,"-258794975,3"
03/29/2024,40967,,14051,Terminal LS - Tarjeta TPV,"164653,99",0,"-258630321,31"
03/29/2024,40965,,14039,Terminal LS - Tarjeta TPV,94509,0,"-258535812,31"
03/30/2024,41685,,14153,Terminal LS - Transferencia TPV,54000,0,"-258481812,31"
03/30/2024,41706,,14219,Terminal LS - Transferencia TPV,"208794,01",0,"-260107754,29"
03/30/2024,41699,,14191,Terminal LS - Transferencia TPV,111963,0,"-259995791,29"
03/30/2024,41696,,14182,Terminal LS - Transferencia TPV,"94949,99",0,"-260063863,22"
03/30/2024,41683,,14146,Terminal LS - Transferencia TPV,124000,0,"-260323863,22"
03/30/2024,41691,,14169,Terminal LS - Transferencia TPV,"176016,99",0,"-260147846,23"
03/30/2024,41674,,14220,Terminal LS - Tarjeta TPV,"267903,99",0,"-259879942,24"
03/30/2024,41702,,14202,Terminal LS - Transferencia TPV,"69980,99",0,"-259809961,25"
03/30/2024,41681,,14143,Terminal LS - Transferencia TPV,"61500,01",0,"-259748461,24"
03/30/2024,41677,,14101,Terminal LS - Transferencia TPV,182791,0,"-259565670,24"
03/30/2024,41693,,14172,Terminal LS - Transferencia TPV,80306,0,"-259485364,24"
03/30/2024,41697,,14186,Terminal LS - Transferencia TPV,132330,0,"-259353034,24"
03/30/2024,41700,,14192,Terminal LS - Transferencia TPV,68833,0,"-260831201,24"
03/30/2024,41676,,14094,Terminal LS - Transferencia TPV,134000,0,"-260697201,24"
03/30/2024,41695,,14178,Terminal LS - Transferencia TPV,67000,0,"-260630201,24"
03/30/2024,41688,,14165,Terminal LS - Transferencia TPV,148000,0,"-260482201,24"
03/30/2024,41678,,14103,Terminal LS - Transferencia TPV,"221905,99",0,"-260260295,25"
03/30/2024,41703,,14204,Terminal LS - Transferencia TPV,27096,0,"-260233199,25"
03/30/2024,41679,,14104,Terminal LS - Transferencia TPV,113000,0,"-260120199,25"
03/30/2024,41680,,14131,Terminal LS - Transferencia TPV,"108385,01",0,"-260011814,24"
03/30/2024,41694,,14174,Terminal LS - Transferencia TPV,74733,0,"-259937081,24"
03/30/2024,41698,,14189,Terminal LS - Transferencia TPV,91000,0,"-259846081,24"
03/30/2024,41689,,14167,Terminal LS - Transferencia TPV,"64500,01",0,"-259781581,23"
03/30/2024,41690,,14168,Terminal LS - Transferencia TPV,52050,0,"-259729531,23"
03/30/2024,41705,,14218,Terminal LS - Transferencia TPV,155000,0,"-259574531,23"
03/30/2024,40971,,,Terminal LS - Tarjeta TPV,0,1090687,"-260665218,23"
03/30/2024,41704,,14216,Terminal LS - Transferencia TPV,82500,0,"-260582718,23"
03/30/2024,41682,,14144,Terminal LS - Transferencia TPV,"83583,01",0,"-260499135,22"
03/30/2024,41687,,14161,Terminal LS - Transferencia TPV,"87844,01",0,"-260411291,21"
03/30/2024,41701,,14194,Terminal LS - Transferencia TPV,105000,0,"-260306291,21"
03/30/2024,41686,,14154,Terminal LS - Transferencia TPV,"73000,01",0,"-260233291,2"
03/30/2024,41692,,14170,Terminal LS - Transferencia TPV,77683,0,"-260155608,2"
03/30/2024,41684,,14152,Terminal LS - Transferencia TPV,87200,0,"-260068408,2"
03/30/2024,40983,,,Terminal LS - Transferencia TPV,0,1163060,"-261231468,2"
03/31/2024,41947,,14255,Terminal LS - Transferencia TPV,"133849,99",0,"-261097618,21"
03/31/2024,41949,,14262,Terminal LS - Transferencia TPV,58000,0,"-261039618,21"
03/31/2024,41939,,14226,Terminal LS - Transferencia TPV,227700,0,"-260811918,21"
03/31/2024,41940,,14229,Terminal LS - Transferencia TPV,119147,0,"-260692771,21"
03/31/2024,41952,,14273,Terminal LS - Transferencia TPV,120000,0,"-260572771,21"
03/31/2024,41941,,14232,Terminal LS - Transferencia TPV,86000,0,"-260486771,21"
03/31/2024,41945,,14249,Terminal LS - Transferencia TPV,66800,0,"-260419971,21"
03/31/2024,41950,,14266,Terminal LS - Transferencia TPV,91231,0,"-260328740,21"
03/31/2024,41942,,14233,Terminal LS - Transferencia TPV,60000,0,"-260268740,21"
03/31/2024,41944,,14243,Terminal LS - Transferencia TPV,75170,0,"-260725392,31"
03/31/2024,41707,,,Terminal LS - Transferencia TPV,0,3218944,"-263944336,31"
03/31/2024,41943,,14241,Terminal LS - Transferencia TPV,54000,0,"-263890336,31"
03/31/2024,41675,,,Terminal LS - Tarjeta TPV,0,267903,"-264158239,31"
03/31/2024,41951,,14267,Terminal LS - Transferencia TPV,"199999,99",0,"-263958239,32"
03/31/2024,41946,,14250,Terminal LS - Transferencia TPV,63000,0,"-263895239,32"
03/31/2024,41948,,14256,Terminal LS - Transferencia TPV,"127000,01",0,"-263768239,31"
04/01/2024,41953,,,Terminal LS - Transferencia TPV,0,1481898,"-266491122,31"
04/02/2024,42065,,14275,Terminal LS - Transferencia TPV,"84347,99",0,"-276870774,32"
04/02/2024,42061,,14284,Terminal LS - Tarjeta TPV,63316,0,"-276877458,32"
04/02/2024,42060,,14283,Terminal LS - Tarjeta TPV,22944,0,"-276854514,32"
04/02/2024,42059,,14281,Terminal LS - Tarjeta TPV,52000,0,"-276802514,32"
04/02/2024,42058,,14280,Terminal LS - Tarjeta TPV,82491,0,"-276720023,32"
04/02/2024,42057,,14278,Terminal LS - Tarjeta TPV,125375,0,"-276594648,32"
04/02/2024,42056,,14277,Terminal LS - Tarjeta TPV,176727,0,"-276417921,32"
04/02/2024,42062,,14285,Terminal LS - Tarjeta TPV,107402,0,"-278019070,4"
04/02/2024,42064,,14274,Terminal LS - Transferencia TPV,10000,0,"-278009070,4"
04/02/2024,42066,,14276,Terminal LS - Transferencia TPV,62500,0,"-277946570,4"
04/02/2024,42067,,14279,Terminal LS - Transferencia TPV,66500,0,"-277880070,4"
04/02/2024,42068,,14282,Terminal LS - Transferencia TPV,"106527,99",0,"-277773542,41"
04/02/2024,42069,,14286,Terminal LS - Transferencia TPV,"137666,99",0,"-277635875,42"
04/02/2024,42070,,14287,Terminal LS - Transferencia TPV,229300,0,"-277406575,42"
04/02/2024,42071,,14290,Terminal LS - Transferencia TPV,167200,0,"-277239375,42"
04/03/2024,42140,,14293,Terminal LS - Tarjeta TPV,"29868,99",0,"-278524914,43"
04/03/2024,42063,,,Terminal LS - Tarjeta TPV,0,630255,"-280605169,43"
04/03/2024,42142,,14291,Terminal LS - Transferencia TPV,"241699,98",0,"-283291618,45"
04/03/2024,42143,,14292,Terminal LS - Transferencia TPV,142911,0,"-283148707,45"
04/03/2024,42144,,14295,Terminal LS - Transferencia TPV,88828,0,"-283059879,45"
04/03/2024,42145,,14298,Terminal LS - Transferencia TPV,85004,0,"-282974875,45"
04/03/2024,42146,,14299,Terminal LS - Transferencia TPV,88500,0,"-282886375,45"
04/03/2024,42147,,14304,Terminal LS - Transferencia TPV,"270250,01",0,"-282616125,44"
04/03/2024,42072,,,Terminal LS - Transferencia TPV,0,864041,"-284364366,86"
04/04/2024,42277,,14329,Terminal LS - Transferencia TPV,180988,0,"-284183378,86"
04/04/2024,42275,,14320,Terminal LS - Transferencia TPV,92350,0,"-284091028,86"
04/04/2024,42276,,14321,Terminal LS - Transferencia TPV,"82818,99",0,"-284008209,87"
04/04/2024,42274,,14318,Terminal LS - Transferencia TPV,96039,0,"-284111120,88"
04/04/2024,42273,,14314,Terminal LS - Transferencia TPV,61000,0,"-284050120,88"
04/04/2024,42272,,14312,Terminal LS - Transferencia TPV,159464,0,"-283890656,88"
04/04/2024,42270,,14323,Terminal LS - Tarjeta TPV,"106108,99",0,"-283784547,89"
04/04/2024,42269,,14322,Terminal LS - Tarjeta TPV,"92323,99",0,"-283692223,9"
04/04/2024,42148,,,Terminal LS - Transferencia TPV,0,917193,"-284609416,9"
04/04/2024,42141,,,Terminal LS - Tarjeta TPV,0,29869,"-284639285,9"
04/05/2024,42574,,14351,Terminal LS - Tarjeta TPV,71073,0,"-284568212,9"
04/05/2024,42576,,14388,Terminal LS - Tarjeta TPV,197814,0,"-284370398,9"
04/05/2024,42575,,14364,Terminal LS - Tarjeta TPV,118000,0,"-284252398,9"
04/05/2024,42595,,14384,Terminal LS - Transferencia TPV,"108400,01",0,"-284143998,89"
04/05/2024,42581,,14345,Terminal LS - Transferencia TPV,64000,0,"-284079998,89"
04/05/2024,42594,,14381,Terminal LS - Transferencia TPV,199398,0,"-283880600,89"
04/05/2024,42578,,14391,Terminal LS - Tarjeta TPV,85147,0,"-283795453,89"
04/05/2024,42596,,14385,Terminal LS - Transferencia TPV,"114000,01",0,"-283681453,88"
04/05/2024,42597,,14386,Terminal LS - Transferencia TPV,"107838,99",0,"-283573614,89"
04/05/2024,42598,,14387,Terminal LS - Transferencia TPV,105107,0,"-283468507,89"
04/05/2024,42599,,14389,Terminal LS - Transferencia TPV,251733,0,"-283216774,89"
04/05/2024,42600,,14392,Terminal LS - Transferencia TPV,"102703,99",0,"-283114070,9"
04/05/2024,42577,,14391,Terminal LS - Tarjeta TPV,85146,0,"-283028924,9"
04/05/2024,42278,,,Terminal LS - Transferencia TPV,0,672659,"-283701583,9"
04/05/2024,42592,,14374,Terminal LS - Transferencia TPV,93963,0,"-285380014,9"
04/05/2024,42591,,14372,Terminal LS - Transferencia TPV,"145205,99",0,"-285234808,91"
04/05/2024,42590,,14370,Terminal LS - Transferencia TPV,64500,0,"-285170308,91"
04/05/2024,42589,,14368,Terminal LS - Transferencia TPV,50000,0,"-285120308,91"
04/05/2024,42588,,14363,Terminal LS - Transferencia TPV,59000,0,"-285061308,91"
04/05/2024,42587,,14360,Terminal LS - Transferencia TPV,69700,0,"-284991608,91"
04/05/2024,42586,,14359,Terminal LS - Transferencia TPV,60500,0,"-284931108,91"
04/05/2024,42585,,14358,Terminal LS - Transferencia TPV,"107000,01",0,"-284824108,9"
04/05/2024,42584,,14353,Terminal LS - Transferencia TPV,"75279,99",0,"-284748828,91"
04/05/2024,42583,,14349,Terminal LS - Transferencia TPV,111881,0,"-284636947,91"
04/05/2024,42582,,14347,Terminal LS - Transferencia TPV,66500,0,"-284570447,91"
04/05/2024,42593,,14380,Terminal LS - Transferencia TPV,"140834,99",0,"-284429612,92"
04/05/2024,42580,,14344,Terminal LS - Transferencia TPV,"61250,01",0,"-285132218,91"
04/05/2024,42271,,,Terminal LS - Tarjeta TPV,0,198431,"-285330649,91"
04/05/2024,42573,,14348,Terminal LS - Tarjeta TPV,"74399,99",0,"-285256249,92"
04/06/2024,43173,,14398,Terminal LS - Tarjeta TPV,118109,0,"-285138140,92"
04/06/2024,43175,,14401,Terminal LS - Tarjeta TPV,"87407,01",0,"-285050733,91"
04/06/2024,43187,,14471,Terminal LS - Tarjeta TPV,"172301,99",0,"-284878431,92"
04/06/2024,43190,,14490,Terminal LS - Tarjeta TPV,94782,0,"-284783649,92"
04/06/2024,43184,,14454,Terminal LS - Tarjeta TPV,83911,0,"-284699738,92"
04/06/2024,43189,,14487,Terminal LS - Tarjeta TPV,"182499,98",0,"-284517238,94"
04/06/2024,43199,,14395,Terminal LS - Transferencia TPV,100245,0,"-284416993,94"
04/06/2024,43212,,14465,Terminal LS - Transferencia TPV,"149999,99",0,"-284266993,95"
04/06/2024,43213,,14467,Terminal LS - Transferencia TPV,"78666,99",0,"-284188326,96"
04/06/2024,43204,,14426,Terminal LS - Transferencia TPV,66648,0,"-284121678,96"
04/06/2024,43200,,14396,Terminal LS - Transferencia TPV,"77901,99",0,"-284043776,97"
04/06/2024,43182,,14437,Terminal LS - Tarjeta TPV,96913,0,"-283946863,97"
04/06/2024,43185,,14456,Terminal LS - Tarjeta TPV,303905,0,"-283642958,97"
04/06/2024,43208,,14445,Terminal LS - Transferencia TPV,60000,0,"-283582958,97"
04/06/2024,43179,,14420,Terminal LS - Tarjeta TPV,25000,0,"-283557958,97"
04/06/2024,43181,,14430,Terminal LS - Tarjeta TPV,70363,0,"-283487595,97"
04/06/2024,43216,,14489,Terminal LS - Transferencia TPV,93744,0,"-283393851,97"
04/06/2024,43195,,14499,Terminal LS - Tarjeta TPV,59300,0,"-283334551,97"
04/06/2024,42579,,,Terminal LS - Tarjeta TPV,0,631580,"-283966131,97"
04/06/2024,42601,,,Terminal LS - Transferencia TPV,0,2158793,"-286124924,97"
04/06/2024,43219,,14501,Terminal LS - Transferencia TPV,"80851,99",0,"-286044072,98"
04/06/2024,43180,,14425,Terminal LS - Tarjeta TPV,133952,0,"-285910120,98"
04/06/2024,43202,,14418,Terminal LS - Transferencia TPV,66500,0,"-285843620,98"
04/06/2024,43209,,14449,Terminal LS - Transferencia TPV,"181425,01",0,"-285662195,97"
04/06/2024,43221,,14503,Terminal LS - Transferencia TPV,"207499,99",0,"-285454695,98"
04/06/2024,43205,,14427,Terminal LS - Transferencia TPV,"193661,99",0,"-285261033,99"
04/06/2024,43196,,14500,Terminal LS - Tarjeta TPV,"172629,99",0,-285088404
04/06/2024,43218,,14497,Terminal LS - Transferencia TPV,276918,0,-284811486
04/06/2024,43176,,14404,Terminal LS - Tarjeta TPV,70581,0,-284740905
04/06/2024,43222,,14505,Terminal LS - Transferencia TPV,"81725,99",0,"-284659179,01"
04/06/2024,43217,,14496,Terminal LS - Transferencia TPV,"190700,01",0,-284468479
04/06/2024,43210,,14460,Terminal LS - Transferencia TPV,"117453,99",0,"-284351025,01"
04/06/2024,43203,,14424,Terminal LS - Transferencia TPV,82218,0,"-284268807,01"
04/06/2024,43194,,14498,Terminal LS - Tarjeta TPV,"28171,99",0,"-284240635,02"
04/06/2024,43191,,14491,Terminal LS - Tarjeta TPV,91778,0,"-284148857,02"
04/06/2024,43214,,14475,Terminal LS - Transferencia TPV,"89155,99",0,"-284059701,03"
04/06/2024,43174,,14400,Terminal LS - Tarjeta TPV,63370,0,"-283996331,03"
04/06/2024,43206,,14429,Terminal LS - Transferencia TPV,73204,0,"-283923127,03"
04/06/2024,43220,,14502,Terminal LS - Transferencia TPV,"258616,97",0,"-283664510,06"
04/06/2024,43177,,14411,Terminal LS - Tarjeta TPV,"80305,99",0,"-283584204,07"
04/06/2024,43201,,14417,Terminal LS - Transferencia TPV,82982,0,"-283501222,07"
04/06/2024,43188,,14480,Terminal LS - Tarjeta TPV,138158,0,"-283363064,07"
04/06/2024,43178,,14419,Terminal LS - Tarjeta TPV,"80851,99",0,"-283282212,08"
04/06/2024,43186,,14463,Terminal LS - Tarjeta TPV,85785,0,"-283196427,08"
04/06/2024,43215,,14485,Terminal LS - Transferencia TPV,98552,0,"-283097875,08"
04/06/2024,43223,,14506,Terminal LS - Transferencia TPV,100000,0,"-282997875,08"
04/06/2024,43211,,14464,Terminal LS - Transferencia TPV,"73299,99",0,"-282924575,09"
04/06/2024,43207,,14438,Terminal LS - Transferencia TPV,62250,0,"-282862325,09"
04/06/2024,43193,,14494,Terminal LS - Tarjeta TPV,204424,0,"-282657901,09"
04/06/2024,43197,,14504,Terminal LS - Tarjeta TPV,97131,0,"-282560770,09"
04/06/2024,43183,,14452,Terminal LS - Tarjeta TPV,"88827,99",0,"-282471942,1"
04/06/2024,43192,,14492,Terminal LS - Tarjeta TPV,"198305,99",0,"-282273636,11"
04/07/2024,43669,,14573,Terminal LS - Tarjeta TPV,69270,0,"-282204366,11"
04/07/2024,43664,,14553,Terminal LS - Tarjeta TPV,63316,0,"-282141050,11"
04/07/2024,43665,,14554,Terminal LS - Tarjeta TPV,168532,0,"-281972518,11"
04/07/2024,43666,,14559,Terminal LS - Tarjeta TPV,59000,0,"-281913518,11"
04/07/2024,43681,,14545,Terminal LS - Transferencia TPV,62500,0,"-281851018,11"
04/07/2024,43680,,14542,Terminal LS - Transferencia TPV,298114,0,"-281552904,11"
04/07/2024,43679,,14535,Terminal LS - Transferencia TPV,105000,0,"-281447904,11"
04/07/2024,43678,,14533,Terminal LS - Transferencia TPV,90685,0,"-281357219,11"
04/07/2024,43677,,14532,Terminal LS - Transferencia TPV,142856,0,"-281214363,11"
04/07/2024,43676,,14531,Terminal LS - Transferencia TPV,89702,0,"-281124661,11"
04/07/2024,43675,,14530,Terminal LS - Transferencia TPV,"82818,99",0,"-281041842,12"
04/07/2024,43674,,14529,Terminal LS - Transferencia TPV,190330,0,"-280851512,12"
04/07/2024,43673,,14518,Terminal LS - Transferencia TPV,97000,0,"-280754512,12"
04/07/2024,43672,,14514,Terminal LS - Transferencia TPV,"341162,01",0,"-280413350,11"
04/07/2024,43670,,14580,Terminal LS - Tarjeta TPV,"441570,99",0,"-279971779,12"
04/07/2024,43663,,14547,Terminal LS - Tarjeta TPV,"75497,99",0,"-279896281,13"
04/07/2024,43668,,14572,Terminal LS - Tarjeta TPV,"100518,99",0,"-279795762,14"
04/07/2024,43667,,14571,Terminal LS - Tarjeta TPV,59000,0,"-279736762,14"
04/07/2024,43684,,14551,Terminal LS - Transferencia TPV,48000,0,"-279688762,14"
04/07/2024,43683,,14550,Terminal LS - Transferencia TPV,62250,0,"-279902512,14"
04/07/2024,43685,,14555,Terminal LS - Transferencia TPV,67000,0,"-279835512,14"
04/07/2024,43686,,14562,Terminal LS - Transferencia TPV,"128499,99",0,"-279707012,15"
04/07/2024,43687,,14582,Terminal LS - Transferencia TPV,74351,0,"-279632661,15"
04/07/2024,43688,,14583,Terminal LS - Transferencia TPV,187106,0,"-279445555,15"
04/07/2024,43689,,14590,Terminal LS - Transferencia TPV,"163999,99",0,"-279728745,86"
04/07/2024,43225,,,Terminal LS - Transferencia TPV,"60027,11",0,"-279668718,75"
04/07/2024,43224,,,Terminal LS - Transferencia TPV,0,3004249,"-282672967,75"
04/07/2024,43198,,,Terminal LS - Tarjeta TPV,0,2828763,"-285501730,75"
04/07/2024,43682,,14548,Terminal LS - Transferencia TPV,70000,0,"-285431730,75"
04/08/2024,43690,,,Terminal LS - Transferencia TPV,0,2301374,"-287733104,75"
04/08/2024,43671,,,Terminal LS - Tarjeta TPV,0,1036705,"-289493236,39"
04/09/2024,43731,,14598,Terminal LS - Tarjeta TPV,"173175,99",0,"-294543089,8"
04/09/2024,43730,,14597,Terminal LS - Tarjeta TPV,78448,0,"-294464641,8"
04/09/2024,43725,,14593,Terminal LS - Transferencia TPV,"79868,99",0,"-295411148,19"
04/09/2024,43726,,14594,Terminal LS - Transferencia TPV,109000,0,"-295370548,19"
04/09/2024,43727,,14595,Terminal LS - Transferencia TPV,88500,0,"-295282048,19"
04/09/2024,43728,,14596,Terminal LS - Transferencia TPV,"223216,98",0,"-295058831,21"
04/09/2024,43724,,14591,Terminal LS - Transferencia TPV,85004,0,"-295179227,21"
04/10/2024,43791,,14601,Terminal LS - Tarjeta TPV,"41199,99",0,"-295138027,22"
04/10/2024,43795,,14610,Terminal LS - Tarjeta TPV,"65555,99",0,"-295072471,23"
04/10/2024,43792,,14603,Terminal LS - Tarjeta TPV,"164550,01",0,"-294907921,22"
04/10/2024,43797,,14599,Terminal LS - Transferencia TPV,139852,0,"-294768069,22"
04/10/2024,43793,,14605,Terminal LS - Tarjeta TPV,165900,0,"-294602169,22"
04/10/2024,43794,,14609,Terminal LS - Tarjeta TPV,"83582,99",0,"-294518586,23"
04/10/2024,43732,,,Terminal LS - Tarjeta TPV,0,251323,"-294769909,23"
04/10/2024,43729,,,Terminal LS - Transferencia TPV,0,585588,"-295355497,23"
04/10/2024,43800,,14607,Terminal LS - Transferencia TPV,"59999,99",0,"-295716747,04"
04/10/2024,43801,,14608,Terminal LS - Transferencia TPV,100000,0,"-295616747,04"
04/10/2024,43799,,14604,Terminal LS - Transferencia TPV,302430,0,"-295314317,04"
04/10/2024,43798,,14602,Terminal LS - Transferencia TPV,81000,0,"-295233317,04"
04/10/2024,43790,,14600,Terminal LS - Tarjeta TPV,256049,0,"-294977268,04"
04/11/2024,43986,,14619,Terminal LS - Transferencia TPV,123000,0,"-294854268,04"
04/11/2024,43988,,14628,Terminal LS - Transferencia TPV,"123790,99",0,"-294730477,05"
04/11/2024,43989,,14632,Terminal LS - Transferencia TPV,103523,0,"-294626954,05"
04/11/2024,43990,,14634,Terminal LS - Transferencia TPV,85277,0,"-294541677,05"
04/11/2024,43991,,14635,Terminal LS - Transferencia TPV,"72766,99",0,"-294468910,06"
04/11/2024,43992,,14638,Terminal LS - Transferencia TPV,145588,0,"-294323322,06"
04/11/2024,43993,,14645,Terminal LS - Transferencia TPV,88500,0,"-294234822,06"
04/11/2024,43994,,14646,Terminal LS - Transferencia TPV,"84675,99",0,"-294150146,07"
04/11/2024,43995,,14647,Terminal LS - Transferencia TPV,219283,0,"-293930863,07"
04/11/2024,43996,,14649,Terminal LS - Transferencia TPV,158207,0,"-293772656,07"
04/11/2024,43997,,14650,Terminal LS - Transferencia TPV,119147,0,"-293653509,07"
04/11/2024,43998,,14651,Terminal LS - Transferencia TPV,92488,0,"-293561021,07"
04/11/2024,43982,,14629,Terminal LS - Tarjeta TPV,95602,0,"-294816757,29"
04/11/2024,43796,,,Terminal LS - Tarjeta TPV,0,776882,"-295593639,29"
04/11/2024,43802,,,Terminal LS - Transferencia TPV,0,683282,"-296276921,29"
04/11/2024,43981,,14625,Terminal LS - Tarjeta TPV,71838,0,"-296205083,29"
04/11/2024,43979,,14612,Terminal LS - Tarjeta TPV,"85440,99",0,"-296119642,3"
04/11/2024,43980,,14615,Terminal LS - Tarjeta TPV,106000,0,"-296013642,3"
04/11/2024,43999,,14653,Terminal LS - Transferencia TPV,55000,0,"-295958642,3"
04/11/2024,44000,,14653,Terminal LS - Transferencia TPV,165000,0,"-295793642,3"
04/11/2024,44001,,14653,Terminal LS - Transferencia TPV,55000,0,"-295738642,3"
04/11/2024,44002,,14653,Terminal LS - Transferencia TPV,110000,0,"-295628642,3"
04/11/2024,43983,,14633,Terminal LS - Tarjeta TPV,83966,0,"-295544676,3"
04/11/2024,43984,,14642,Terminal LS - Tarjeta TPV,80154,0,"-295464522,3"
04/11/2024,43987,,14626,Terminal LS - Transferencia TPV,84500,0,"-295380022,3"
04/12/2024,44337,,14656,Terminal LS - Tarjeta TPV,"71127,99",0,"-295308894,31"
04/12/2024,44356,,14655,Terminal LS - Transferencia TPV,70000,0,"-296731439,81"
04/12/2024,44357,,14655,Terminal LS - Transferencia TPV,208500,0,"-296792939,81"
04/12/2024,44353,,14718,Terminal LS - Tarjeta TPV,"162031,01",0,"-296630908,8"
04/12/2024,44340,,14670,Terminal LS - Tarjeta TPV,73477,0,"-296557431,8"
04/12/2024,44360,,14668,Terminal LS - Transferencia TPV,101250,0,"-296456181,8"
04/12/2024,44364,,14688,Terminal LS - Transferencia TPV,157989,0,"-296227856,94"
04/12/2024,44003,,,Terminal LS - Transferencia TPV,0,1885745,"-298113601,94"
04/12/2024,44346,,14707,Terminal LS - Tarjeta TPV,81781,0,"-298031820,94"
04/12/2024,44351,,14715,Terminal LS - Tarjeta TPV,93417,0,"-297938403,94"
04/12/2024,44367,,14701,Terminal LS - Transferencia TPV,164544,0,"-297773859,94"
04/12/2024,44348,,14712,Terminal LS - Tarjeta TPV,"152143,99",0,"-297621715,95"
04/12/2024,44345,,14698,Terminal LS - Tarjeta TPV,241463,0,"-297380252,95"
04/12/2024,44359,,14665,Terminal LS - Transferencia TPV,"117890,99",0,"-297262361,96"
04/12/2024,44349,,14713,Terminal LS - Tarjeta TPV,"234743,99",0,"-297027617,97"
04/12/2024,44362,,14672,Terminal LS - Transferencia TPV,88063,0,"-296939554,97"
04/12/2024,44344,,14693,Terminal LS - Tarjeta TPV,87080,0,"-296852474,97"
04/12/2024,44366,,14697,Terminal LS - Transferencia TPV,167532,0,"-296684942,97"
04/12/2024,44341,,14678,Terminal LS - Tarjeta TPV,83966,0,"-296600976,97"
04/12/2024,43985,,,Terminal LS - Tarjeta TPV,0,523000,"-297123976,97"
04/12/2024,44354,,14719,Terminal LS - Tarjeta TPV,124774,0,"-296999202,97"
04/12/2024,44352,,14717,Terminal LS - Tarjeta TPV,108822,0,"-296890380,97"
04/12/2024,44361,,14669,Terminal LS - Transferencia TPV,84184,0,"-296806196,97"
04/12/2024,44347,,14709,Terminal LS - Tarjeta TPV,82054,0,"-296724142,97"
04/12/2024,44339,,14659,Terminal LS - Tarjeta TPV,12700,0,"-296711442,97"
04/12/2024,44350,,14714,Terminal LS - Tarjeta TPV,83911,0,"-296627531,97"
04/12/2024,44368,,14716,Terminal LS - Transferencia TPV,"205625,98",0,"-296421905,99"
04/12/2024,44336,,14654,Terminal LS - Tarjeta TPV,181000,0,"-296240905,99"
04/12/2024,44342,,14680,Terminal LS - Tarjeta TPV,81398,0,"-296159507,99"
04/12/2024,44363,,14683,Terminal LS - Transferencia TPV,"207599,99",0,-295951908
04/12/2024,44338,,14658,Terminal LS - Tarjeta TPV,82491,0,-295869417
04/12/2024,44343,,14686,Terminal LS - Tarjeta TPV,"95930,99",0,"-295773486,01"
04/12/2024,44358,,14664,Terminal LS - Transferencia TPV,68000,0,"-295705486,01"
04/12/2024,44365,,14689,Terminal LS - Transferencia TPV,164162,0,"-295541324,01"
04/13/2024,44885,,14794,Terminal LS - Tarjeta TPV,100409,0,"-295440915,01"
04/13/2024,44891,,14821,Terminal LS - Tarjeta TPV,"317397,98",0,"-295123517,03"
04/13/2024,44890,,14821,Terminal LS - Tarjeta TPV,317398,0,"-294806119,03"
04/13/2024,44369,,,Terminal LS - Transferencia TPV,0,1806088,"-296612207,03"
04/13/2024,44905,,14789,Terminal LS - Transferencia TPV,"83692,99",0,"-299883481,04"
04/13/2024,44899,,14756,Terminal LS - Transferencia TPV,58000,0,"-299825481,04"
04/13/2024,44910,,14811,Terminal LS - Transferencia TPV,"701116,96",0,"-299124364,08"
04/13/2024,44887,,14817,Terminal LS - Tarjeta TPV,84130,0,"-299040234,08"
04/13/2024,44874,,14722,Terminal LS - Tarjeta TPV,"98879,99",0,"-298941354,09"
04/13/2024,44888,,14818,Terminal LS - Tarjeta TPV,78230,0,"-298863124,09"
04/13/2024,44880,,14769,Terminal LS - Tarjeta TPV,83365,0,"-298779759,09"
04/13/2024,44875,,14725,Terminal LS - Tarjeta TPV,"149303,01",0,"-298630456,08"
04/13/2024,44902,,14762,Terminal LS - Transferencia TPV,"83473,99",0,"-298546982,09"
04/13/2024,44355,,,Terminal LS - Tarjeta TPV,0,2134311,"-300681293,09"
04/13/2024,44903,,14767,Terminal LS - Transferencia TPV,92925,0,"-300588368,09"
04/13/2024,44908,,14799,Terminal LS - Transferencia TPV,"89299,99",0,"-300499068,1"
04/13/2024,44911,,14819,Terminal LS - Transferencia TPV,"75716,99",0,"-300423351,11"
04/13/2024,44879,,14748,Terminal LS - Tarjeta TPV,"93416,41",0,"-300329934,7"
04/13/2024,44881,,14777,Terminal LS - Tarjeta TPV,"71455,99",0,"-300258478,71"
04/13/2024,44886,,14815,Terminal LS - Tarjeta TPV,"98879,99",0,"-300159598,72"
04/13/2024,44884,,14791,Terminal LS - Tarjeta TPV,83037,0,"-300076561,72"
04/13/2024,44895,,14729,Terminal LS - Transferencia TPV,"275060,01",0,"-299801501,71"
04/13/2024,44901,,14761,Terminal LS - Transferencia TPV,"90138,99",0,"-299711362,72"
04/13/2024,44876,,14730,Terminal LS - Tarjeta TPV,73422,0,"-299637940,72"
04/13/2024,44882,,14783,Terminal LS - Tarjeta TPV,"95328,99",0,"-299542611,73"
04/13/2024,44893,,14720,Terminal LS - Transferencia TPV,102376,0,"-299440235,73"
04/13/2024,44883,,14786,Terminal LS - Tarjeta TPV,153946,0,"-299286289,73"
04/13/2024,44907,,14797,Terminal LS - Transferencia TPV,"101610,99",0,"-299184678,74"
04/13/2024,44898,,14754,Terminal LS - Transferencia TPV,61000,0,"-299123678,74"
04/13/2024,44909,,14808,Terminal LS - Transferencia TPV,143676,0,"-298980002,74"
04/13/2024,44896,,14737,Terminal LS - Transferencia TPV,97131,0,"-298882871,74"
04/13/2024,44877,,14731,Terminal LS - Tarjeta TPV,181316,0,"-298701555,74"
04/13/2024,44900,,14757,Terminal LS - Transferencia TPV,136900,0,"-298564655,74"
04/13/2024,44878,,14738,Terminal LS - Tarjeta TPV,"75716,99",0,"-298488938,75"
04/13/2024,44894,,14724,Terminal LS - Transferencia TPV,102431,0,"-298386507,75"
04/13/2024,44889,,14820,Terminal LS - Tarjeta TPV,67741,0,"-298318766,75"
04/13/2024,44906,,14790,Terminal LS - Transferencia TPV,"76999,99",0,"-298241766,76"
04/13/2024,44904,,14775,Terminal LS - Transferencia TPV,58454,0,"-298183312,76"
04/13/2024,44897,,14741,Terminal LS - Transferencia TPV,85555,0,"-298097757,76"
04/14/2024,44912,,,Terminal LS - Transferencia TPV,0,2515554,"-300613311,76"
04/14/2024,45372,,14867,Terminal LS - Transferencia TPV,69500,0,"-300543811,76"
04/14/2024,44892,,,Terminal LS - Tarjeta TPV,0,2223369,"-302767180,76"
04/14/2024,45373,,14881,Terminal LS - Transferencia TPV,28037,0,"-302739143,76"
04/14/2024,45379,,14906,Terminal LS - Transferencia TPV,180000,0,"-302559143,76"
04/14/2024,45374,,14882,Terminal LS - Transferencia TPV,85550,0,"-302473593,76"
04/14/2024,45375,,14883,Terminal LS - Transferencia TPV,85550,0,"-302388043,76"
04/14/2024,45358,,14837,Terminal LS - Tarjeta TPV,79213,0,"-302308830,76"
04/14/2024,45380,,14908,Terminal LS - Transferencia TPV,"98199,99",0,"-302210630,77"
04/14/2024,45378,,14905,Terminal LS - Transferencia TPV,102868,0,"-302107762,77"
04/14/2024,45377,,14901,Terminal LS - Transferencia TPV,12674,0,"-302095088,77"
04/14/2024,45376,,14888,Terminal LS - Transferencia TPV,88300,0,"-302006788,77"
04/14/2024,45359,,14843,Terminal LS - Tarjeta TPV,90194,0,"-301916594,77"
04/14/2024,45360,,14864,Terminal LS - Tarjeta TPV,232613,0,"-301683981,77"
04/14/2024,45361,,14872,Terminal LS - Tarjeta TPV,53000,0,"-301630981,77"
04/14/2024,45362,,14892,Terminal LS - Tarjeta TPV,83802,0,"-301547179,77"
04/14/2024,45371,,14861,Terminal LS - Transferencia TPV,"64999,99",0,"-301482179,78"
04/14/2024,45363,,14894,Terminal LS - Tarjeta TPV,"68800,01",0,"-301413379,77"
04/14/2024,45364,,14909,Terminal LS - Tarjeta TPV,"84238,99",0,"-301329140,78"
04/14/2024,45366,,14828,Terminal LS - Transferencia TPV,"125921,01",0,"-301203219,77"
04/14/2024,45367,,14829,Terminal LS - Transferencia TPV,"73312,99",0,"-301129906,78"
04/14/2024,45368,,14831,Terminal LS - Transferencia TPV,"143200,01",0,"-300986706,77"
04/14/2024,45369,,14836,Terminal LS - Transferencia TPV,"95055,99",0,"-300891650,78"
04/14/2024,45370,,14842,Terminal LS - Transferencia TPV,88500,0,"-300803150,78"
04/15/2024,45382,,,Terminal LS - Transferencia TPV,"5999,02",0,"-300797151,76"
04/15/2024,45365,,,Terminal LS - Tarjeta TPV,0,691680,"-301488831,76"
04/15/2024,45381,,,Terminal LS - Transferencia TPV,0,1347668,"-302836499,76"
04/16/2024,45523,,14913,Terminal LS - Tarjeta TPV,192296,0,"-310307206,09"
04/16/2024,45527,,14912,Terminal LS - Transferencia TPV,111000,0,"-311356732,09"
04/16/2024,45525,,14923,Terminal LS - Tarjeta TPV,156241,0,"-311200491,09"
04/16/2024,45531,,14924,Terminal LS - Transferencia TPV,42700,0,"-311157791,09"
04/16/2024,45529,,14921,Terminal LS - Transferencia TPV,183200,0,"-311144057,09"
04/16/2024,45524,,14920,Terminal LS - Tarjeta TPV,141272,0,"-313547514,23"
04/16/2024,45528,,14919,Terminal LS - Transferencia TPV,"87000,01",0,"-313460514,22"
04/16/2024,45530,,14922,Terminal LS - Transferencia TPV,"69299,99",0,"-313391214,23"
04/17/2024,45627,,14932,Terminal LS - Transferencia TPV,"41649,99",0,"-314137476,24"
04/17/2024,45617,,14930,Terminal LS - Tarjeta TPV,"82162,99",0,"-314055313,25"
04/17/2024,45629,,14936,Terminal LS - Transferencia TPV,63600,0,"-313991713,25"
04/17/2024,45634,,14950,Terminal LS - Transferencia TPV,67489,0,"-313924224,25"
04/17/2024,45618,,14934,Terminal LS - Tarjeta TPV,51300,0,"-313985577,25"
04/17/2024,45619,,14935,Terminal LS - Tarjeta TPV,"73312,99",0,"-314653736,26"
04/17/2024,45620,,14938,Terminal LS - Tarjeta TPV,16717,0,"-314637019,26"
04/17/2024,45621,,14941,Terminal LS - Tarjeta TPV,"165527,99",0,"-314471491,27"
04/17/2024,45622,,14947,Terminal LS - Tarjeta TPV,91778,0,"-314379713,27"
04/17/2024,45623,,14951,Terminal LS - Tarjeta TPV,79759,0,"-314299954,27"
04/17/2024,45625,,14928,Terminal LS - Transferencia TPV,"66866,99",0,"-314233087,28"
04/17/2024,45626,,14931,Terminal LS - Transferencia TPV,42611,0,"-314190476,28"
04/17/2024,45628,,14933,Terminal LS - Transferencia TPV,62600,0,"-314127876,28"
04/17/2024,45630,,14939,Terminal LS - Transferencia TPV,"107729,99",0,"-314020146,29"
04/17/2024,45631,,14942,Terminal LS - Transferencia TPV,92870,0,"-313927276,29"
04/17/2024,45632,,14948,Terminal LS - Transferencia TPV,70800,0,"-313856476,29"
04/17/2024,45633,,14949,Terminal LS - Transferencia TPV,"77901,99",0,"-313778574,3"
04/17/2024,45526,,,Terminal LS - Tarjeta TPV,0,489809,"-315067183,3"
04/17/2024,45532,,,Terminal LS - Transferencia TPV,0,493200,"-316672163,3"
04/18/2024,45788,,14961,Terminal LS - Transferencia TPV,66102,0,"-316893061,54"
04/18/2024,45624,,,Terminal LS - Tarjeta TPV,0,560555,"-317561016,54"
04/18/2024,45791,,14977,Terminal LS - Transferencia TPV,"87953,99",0,"-317473062,55"
04/18/2024,45792,,14981,Terminal LS - Transferencia TPV,"72329,99",0,"-317400732,56"
04/18/2024,45793,,14982,Terminal LS - Transferencia TPV,82600,0,"-317318132,56"
04/18/2024,45794,,14983,Terminal LS - Transferencia TPV,68250,0,"-317249882,56"
04/18/2024,45789,,14963,Terminal LS - Transferencia TPV,114250,0,"-317217742,56"
04/18/2024,45790,,14974,Terminal LS - Transferencia TPV,61000,0,"-317156742,56"
04/18/2024,45635,,,Terminal LS - Transferencia TPV,0,694116,"-317850858,56"
04/18/2024,45787,,14958,Terminal LS - Transferencia TPV,54500,0,"-317796358,56"
04/19/2024,46124,,15045,Terminal LS - Transferencia TPV,"159999,98",0,"-318050358,95"
04/19/2024,46116,,15037,Terminal LS - Transferencia TPV,53500,0,"-319915481,23"
04/19/2024,46119,,15040,Terminal LS - Transferencia TPV,"54636,99",0,"-320127551,24"
04/19/2024,46097,,14991,Terminal LS - Transferencia TPV,"80099,99",0,"-320047451,25"
04/19/2024,46120,,15041,Terminal LS - Transferencia TPV,"57960,98",0,"-319989490,27"
04/19/2024,46123,,15044,Terminal LS - Transferencia TPV,103687,0,"-319885803,27"
04/19/2024,46127,,15048,Terminal LS - Transferencia TPV,187325,0,"-319698478,27"
04/19/2024,46106,,15021,Terminal LS - Transferencia TPV,55250,0,"-320560228,26"
04/19/2024,46105,,15018,Terminal LS - Transferencia TPV,144222,0,"-320416006,26"
04/19/2024,46115,,15036,Terminal LS - Transferencia TPV,"321276,99",0,"-320094729,27"
04/19/2024,46125,,15046,Terminal LS - Transferencia TPV,100300,0,"-319994429,27"
04/19/2024,46122,,15043,Terminal LS - Transferencia TPV,"78666,99",0,"-319915762,28"
04/19/2024,46104,,15015,Terminal LS - Transferencia TPV,66000,0,"-319849762,28"
04/19/2024,45795,,,Terminal LS - Transferencia TPV,0,606985,"-320456747,28"
04/19/2024,46126,,15047,Terminal LS - Transferencia TPV,"97568,99",0,"-320359178,29"
04/19/2024,46110,,15026,Terminal LS - Transferencia TPV,"221140,99",0,"-320138037,3"
04/19/2024,46114,,15032,Terminal LS - Transferencia TPV,"106527,99",0,"-320031509,31"
04/19/2024,46107,,15022,Terminal LS - Transferencia TPV,134389,0,"-319897120,31"
04/19/2024,46102,,15012,Terminal LS - Transferencia TPV,115815,0,"-319781305,31"
04/19/2024,46121,,15042,Terminal LS - Transferencia TPV,55250,0,"-320310155,31"
04/19/2024,46109,,15024,Terminal LS - Transferencia TPV,87954,0,"-320222201,31"
04/19/2024,46108,,15023,Terminal LS - Transferencia TPV,52000,0,"-320170201,31"
04/19/2024,46117,,15038,Terminal LS - Transferencia TPV,"100518,99",0,"-320298249,32"
04/19/2024,46099,,15003,Terminal LS - Transferencia TPV,61000,0,"-324893394,32"
04/19/2024,46101,,15011,Terminal LS - Transferencia TPV,"166292,99",0,"-324727101,33"
04/19/2024,46113,,15031,Terminal LS - Transferencia TPV,"171427,99",0,"-324745489,34"
04/19/2024,46118,,15039,Terminal LS - Transferencia TPV,157934,0,"-324587555,34"
04/19/2024,46111,,15028,Terminal LS - Transferencia TPV,"174268,98",0,"-324413286,36"
04/19/2024,46098,,15000,Terminal LS - Transferencia TPV,88700,0,"-324324586,36"
04/19/2024,46103,,15014,Terminal LS - Transferencia TPV,168000,0,"-324701586,29"
04/19/2024,46100,,15009,Terminal LS - Transferencia TPV,97241,0,"-324604345,29"
04/19/2024,46112,,15030,Terminal LS - Transferencia TPV,"143129,99",0,"-324461215,3"
04/20/2024,46570,,15130,Terminal LS - Tarjeta TPV,94127,0,"-324367088,3"
04/20/2024,46584,,15082,Terminal LS - Transferencia TPV,"69160,99",0,"-324449877,29"
04/20/2024,46574,,15055,Terminal LS - Transferencia TPV,342856,0,"-324107021,29"
04/20/2024,46580,,15070,Terminal LS - Transferencia TPV,104998,0,"-324002023,29"
04/20/2024,46577,,15064,Terminal LS - Transferencia TPV,6500,0,"-323995523,29"
04/20/2024,46599,,15133,Terminal LS - Transferencia TPV,75000,0,"-323920523,29"
04/20/2024,46578,,15066,Terminal LS - Transferencia TPV,105217,0,"-323815306,29"
04/20/2024,46598,,15132,Terminal LS - Transferencia TPV,"59999,99",0,"-323755306,3"
04/20/2024,46572,,15142,Terminal LS - Tarjeta TPV,"141380,99",0,"-323613925,31"
04/20/2024,46603,,15141,Terminal LS - Transferencia TPV,"189947,01",0,"-323423978,3"
04/20/2024,46596,,15127,Terminal LS - Transferencia TPV,"92214,99",0,"-323331763,31"
04/20/2024,46591,,15122,Terminal LS - Transferencia TPV,83037,0,"-323248726,31"
04/20/2024,46582,,15077,Terminal LS - Transferencia TPV,"70099,99",0,"-323178626,32"
04/20/2024,46592,,15123,Terminal LS - Transferencia TPV,359572,0,"-322819054,32"
04/20/2024,46588,,15107,Terminal LS - Transferencia TPV,"170717,99",0,"-322648336,33"
04/20/2024,46601,,15139,Terminal LS - Transferencia TPV,73969,0,"-322574367,33"
04/20/2024,46595,,15126,Terminal LS - Transferencia TPV,72550,0,"-322501817,33"
04/20/2024,46583,,15078,Terminal LS - Transferencia TPV,"79540,99",0,"-322422276,34"
04/20/2024,46576,,15057,Terminal LS - Transferencia TPV,12674,0,"-322409602,34"
04/20/2024,46604,,15144,Terminal LS - Transferencia TPV,100846,0,"-322308756,34"
04/20/2024,46589,,15116,Terminal LS - Transferencia TPV,75607,0,"-322233149,34"
04/20/2024,46128,,,Terminal LS - Transferencia TPV,0,3662085,"-325934714,34"
04/20/2024,46602,,15140,Terminal LS - Transferencia TPV,165965,0,"-325768749,34"
04/20/2024,46571,,15134,Terminal LS - Tarjeta TPV,243539,0,"-325525210,34"
04/20/2024,46590,,15121,Terminal LS - Transferencia TPV,155585,0,"-325369625,34"
04/20/2024,46587,,15101,Terminal LS - Transferencia TPV,157650,0,"-325211975,34"
04/20/2024,46585,,15092,Terminal LS - Transferencia TPV,"58999,99",0,"-325152975,35"
04/20/2024,46600,,15138,Terminal LS - Transferencia TPV,85769,0,"-325067206,35"
04/20/2024,46586,,15093,Terminal LS - Transferencia TPV,82381,0,"-324984825,35"
04/20/2024,46575,,15056,Terminal LS - Transferencia TPV,151433,0,"-324833392,35"
04/20/2024,46593,,15124,Terminal LS - Transferencia TPV,"181916,99",0,"-324651475,36"
04/20/2024,46581,,15073,Terminal LS - Transferencia TPV,78011,0,"-324573464,36"
04/20/2024,46597,,15131,Terminal LS - Transferencia TPV,"59999,99",0,"-324513464,37"
04/20/2024,46594,,15125,Terminal LS - Transferencia TPV,92870,0,"-324420594,37"
04/20/2024,46579,,15067,Terminal LS - Transferencia TPV,89647,0,"-324330947,37"
04/21/2024,47087,,15158,Terminal LS - Transferencia TPV,77683,0,"-324253264,37"
04/21/2024,46573,,,Terminal LS - Tarjeta TPV,0,479046,"-324732310,37"
04/21/2024,47076,,15194,Terminal LS - Tarjeta TPV,73531,0,"-324658779,37"
04/21/2024,47074,,15179,Terminal LS - Tarjeta TPV,88063,0,"-324570716,37"
04/21/2024,47097,,15215,Terminal LS - Transferencia TPV,82272,0,"-324488444,37"
04/21/2024,47083,,15217,Terminal LS - Tarjeta TPV,422888,0,"-324065556,37"
04/21/2024,47095,,15211,Terminal LS - Transferencia TPV,236000,0,"-323829556,37"
04/21/2024,47081,,15214,Terminal LS - Tarjeta TPV,79250,0,"-323750306,37"
04/21/2024,47079,,15210,Terminal LS - Tarjeta TPV,98333,0,"-323651973,37"
04/21/2024,46605,,,Terminal LS - Transferencia TPV,0,3504764,"-327156737,37"
04/21/2024,47094,,15207,Terminal LS - Transferencia TPV,68000,0,"-327088737,37"
04/21/2024,47093,,15204,Terminal LS - Transferencia TPV,61000,0,"-327027737,37"
04/21/2024,47086,,15150,Terminal LS - Transferencia TPV,92543,0,"-326935194,37"
04/21/2024,47085,,15148,Terminal LS - Transferencia TPV,80087,0,"-326855107,37"
04/21/2024,47078,,15201,Terminal LS - Tarjeta TPV,"109368,99",0,"-326745738,38"
04/21/2024,47075,,15181,Terminal LS - Tarjeta TPV,"436323,98",0,"-326309414,4"
04/21/2024,47067,,15153,Terminal LS - Tarjeta TPV,"84457,01",0,"-326224957,39"
04/21/2024,47082,,15216,Terminal LS - Tarjeta TPV,58044,0,"-326166913,39"
04/21/2024,47080,,15213,Terminal LS - Tarjeta TPV,220198,0,"-325946715,39"
04/21/2024,47077,,15198,Terminal LS - Tarjeta TPV,"152634,99",0,"-325794080,4"
04/21/2024,47098,,15216,Terminal LS - Transferencia TPV,58044,0,"-325886036,4"
04/21/2024,47096,,15213,Terminal LS - Transferencia TPV,"49999,98",0,"-325836036,42"
04/21/2024,47073,,15178,Terminal LS - Tarjeta TPV,"63042,99",0,"-325772993,43"
04/21/2024,47072,,15175,Terminal LS - Tarjeta TPV,86861,0,"-325686132,43"
04/21/2024,47071,,15171,Terminal LS - Tarjeta TPV,59500,0,"-325626632,43"
04/21/2024,47070,,15166,Terminal LS - Tarjeta TPV,53000,0,"-325573632,43"
04/21/2024,47069,,15162,Terminal LS - Tarjeta TPV,"158971,99",0,"-325414660,44"
04/21/2024,47088,,15173,Terminal LS - Transferencia TPV,66102,0,"-325348558,44"
04/21/2024,47089,,15186,Terminal LS - Transferencia TPV,75389,0,"-325273169,44"
04/21/2024,47068,,15154,Terminal LS - Tarjeta TPV,183774,0,"-325089395,44"
04/21/2024,47090,,15191,Terminal LS - Transferencia TPV,102157,0,"-324987238,44"
04/21/2024,47091,,15200,Terminal LS - Transferencia TPV,67194,0,"-324920044,44"
04/21/2024,47092,,15202,Terminal LS - Transferencia TPV,80579,0,"-324839465,44"
04/22/2024,47099,,,Terminal LS - Transferencia TPV,0,1197050,"-326036515,44"
04/22/2024,47084,,,Terminal LS - Tarjeta TPV,0,2428238,"-328464753,44"
04/23/2024,47196,,15237,Terminal LS - Transferencia TPV,"160392,98",0,"-333867390,26"
04/23/2024,47189,,15223,Terminal LS - Transferencia TPV,60500,0,"-340201493,54"
04/23/2024,47188,,15220,Terminal LS - Transferencia TPV,173176,0,"-340028317,54"
04/23/2024,47186,,15235,Terminal LS - Tarjeta TPV,"108712,99",0,"-339919604,55"
04/23/2024,47181,,15221,Terminal LS - Tarjeta TPV,148374,0,"-339771230,55"
04/23/2024,47182,,15222,Terminal LS - Tarjeta TPV,61000,0,"-339710230,55"
04/23/2024,47183,,15228,Terminal LS - Tarjeta TPV,"64790,99",0,"-339645439,56"
04/23/2024,47184,,15230,Terminal LS - Tarjeta TPV,93198,0,"-339552241,56"
04/23/2024,47185,,15233,Terminal LS - Tarjeta TPV,112537,0,"-339439704,56"
04/23/2024,47190,,15227,Terminal LS - Transferencia TPV,"84129,99",0,"-339355574,57"
04/23/2024,47191,,15229,Terminal LS - Transferencia TPV,74351,0,"-339281223,57"
04/23/2024,47192,,15231,Terminal LS - Transferencia TPV,83802,0,"-339197421,57"
04/23/2024,47193,,15232,Terminal LS - Transferencia TPV,294000,0,"-338903421,57"
04/23/2024,47194,,15234,Terminal LS - Transferencia TPV,85000,0,"-338818421,57"
04/23/2024,47195,,15236,Terminal LS - Transferencia TPV,"92323,99",0,"-338726097,58"
04/24/2024,47197,,,Terminal LS - Transferencia TPV,0,1107673,"-340357270,54"
04/24/2024,47304,,15259,Terminal LS - Transferencia TPV,87954,0,"-341256416,62"
04/24/2024,47187,,,Terminal LS - Tarjeta TPV,0,588612,"-341845028,62"
04/24/2024,47303,,15258,Terminal LS - Transferencia TPV,"225839,01",0,"-341619189,61"
04/24/2024,47302,,15257,Terminal LS - Transferencia TPV,100737,0,"-341518452,61"
04/24/2024,47301,,15254,Terminal LS - Transferencia TPV,"89592,99",0,"-341428859,62"
04/24/2024,47300,,15249,Terminal LS - Transferencia TPV,83037,0,"-341345822,62"
04/24/2024,47298,,15245,Terminal LS - Tarjeta TPV,66703,0,"-341279119,62"
04/24/2024,47297,,15241,Terminal LS - Tarjeta TPV,"81944,01",0,"-341271675,61"
04/25/2024,47477,,15279,Terminal LS - Tarjeta TPV,139688,0,"-341131987,61"
04/25/2024,47475,,15268,Terminal LS - Tarjeta TPV,"82818,99",0,"-341049168,62"
04/25/2024,47474,,15267,Terminal LS - Tarjeta TPV,70800,0,"-340978368,62"
04/25/2024,47488,,15288,Terminal LS - Transferencia TPV,82218,0,"-340896150,62"
04/25/2024,47487,,15286,Terminal LS - Transferencia TPV,"221631,99",0,"-340674518,63"
04/25/2024,47305,,,Terminal LS - Transferencia TPV,0,587159,"-341261677,63"
04/25/2024,47486,,15281,Terminal LS - Transferencia TPV,145424,0,"-341116253,63"
04/25/2024,47299,,,Terminal LS - Tarjeta TPV,0,148647,"-341264900,63"
04/25/2024,47485,,15277,Terminal LS - Transferencia TPV,100846,0,"-341164054,63"
04/25/2024,47490,,15290,Terminal LS - Transferencia TPV,60726,0,"-341103328,63"
04/25/2024,47484,,15273,Terminal LS - Transferencia TPV,"103195,01",0,"-341000133,62"
04/25/2024,47483,,15272,Terminal LS - Transferencia TPV,"133899,99",0,"-340866233,63"
04/25/2024,47482,,15271,Terminal LS - Transferencia TPV,68000,0,"-340798233,63"
04/25/2024,47481,,15266,Terminal LS - Transferencia TPV,7000,0,"-340791233,63"
04/25/2024,47479,,15293,Terminal LS - Tarjeta TPV,205705,0,"-340585528,63"
04/25/2024,47478,,15280,Terminal LS - Tarjeta TPV,"263999,1",0,"-340321529,53"
04/25/2024,47476,,15278,Terminal LS - Tarjeta TPV,160611,0,"-340510918,53"
04/25/2024,47491,,15292,Terminal LS - Transferencia TPV,"204860,99",0,"-340306057,54"
04/25/2024,47489,,15289,Terminal LS - Transferencia TPV,81200,0,"-340224857,54"
04/26/2024,47817,,15320,Terminal LS - Tarjeta TPV,55000,0,"-340169857,54"
04/26/2024,47480,,,Terminal LS - Tarjeta TPV,0,923623,"-341600480,54"
04/26/2024,47840,,15355,Terminal LS - Transferencia TPV,"477462,98",0,"-341123017,56"
04/26/2024,47841,,15356,Terminal LS - Transferencia TPV,"62999,99",0,"-341060017,57"
04/26/2024,47837,,15337,Terminal LS - Transferencia TPV,121250,0,"-340938767,57"
04/26/2024,47832,,15329,Terminal LS - Transferencia TPV,126000,0,"-340812767,57"
04/26/2024,47814,,15313,Terminal LS - Tarjeta TPV,127724,0,"-340685043,57"
04/26/2024,47823,,15354,Terminal LS - Tarjeta TPV,89538,0,"-340595505,57"
04/26/2024,47819,,15325,Terminal LS - Tarjeta TPV,55250,0,"-340540255,57"
04/26/2024,47825,,15303,Terminal LS - Transferencia TPV,11600,0,"-340528655,57"
04/26/2024,47842,,15359,Terminal LS - Transferencia TPV,173504,0,"-340355151,57"
04/26/2024,47821,,15345,Terminal LS - Tarjeta TPV,103250,0,"-340251901,57"
04/26/2024,47818,,15321,Terminal LS - Tarjeta TPV,"90138,99",0,"-340161762,58"
04/26/2024,47815,,15315,Terminal LS - Tarjeta TPV,"96694,01",0,"-340065068,57"
04/26/2024,47833,,15331,Terminal LS - Transferencia TPV,"122000,01",0,"-340561068,8"
04/26/2024,47822,,15347,Terminal LS - Tarjeta TPV,"107347,01",0,"-340453721,79"
04/26/2024,47835,,15334,Terminal LS - Transferencia TPV,63500,0,"-340390221,79"
04/26/2024,47813,,15300,Terminal LS - Tarjeta TPV,"83255,99",0,"-340306965,8"
04/26/2024,47839,,15352,Terminal LS - Transferencia TPV,85550,0,"-340221415,8"
04/26/2024,47827,,15309,Terminal LS - Transferencia TPV,92652,0,"-340128763,8"
04/26/2024,47829,,15316,Terminal LS - Transferencia TPV,"82490,99",0,"-340046272,81"
04/26/2024,47834,,15332,Terminal LS - Transferencia TPV,61000,0,"-339985272,81"
04/26/2024,47820,,15330,Terminal LS - Tarjeta TPV,"109477,99",0,"-339875794,82"
04/26/2024,47492,,,Terminal LS - Transferencia TPV,0,1209001,"-341084795,82"
04/26/2024,47830,,15322,Terminal LS - Transferencia TPV,18287,0,"-341066508,82"
04/26/2024,47816,,15317,Terminal LS - Tarjeta TPV,"107073,99",0,"-340959434,83"
04/26/2024,47836,,15335,Terminal LS - Transferencia TPV,78557,0,"-340880877,83"
04/26/2024,47838,,15338,Terminal LS - Transferencia TPV,"105325,99",0,"-340775551,84"
04/26/2024,47831,,15326,Terminal LS - Transferencia TPV,7600,0,"-340767951,84"
04/26/2024,47826,,15305,Terminal LS - Transferencia TPV,"63499,99",0,"-340704451,85"
04/26/2024,47828,,15310,Terminal LS - Transferencia TPV,121000,0,"-340583451,85"
04/27/2024,48344,,15446,Terminal LS - Transferencia TPV,309094,0,"-340274357,85"
04/27/2024,47843,,,Terminal LS - Transferencia TPV,0,1874279,"-342977245,72"
04/27/2024,48338,,15437,Terminal LS - Transferencia TPV,154274,0,"-342822971,72"
04/27/2024,48316,,15431,Terminal LS - Tarjeta TPV,"152580,99",0,"-342670390,73"
04/27/2024,48342,,15443,Terminal LS - Transferencia TPV,80087,0,"-342590303,73"
04/27/2024,48333,,15412,Terminal LS - Transferencia TPV,"185899,99",0,"-342404403,74"
04/27/2024,48317,,15436,Terminal LS - Tarjeta TPV,158918,0,"-342245485,74"
04/27/2024,48343,,15445,Terminal LS - Transferencia TPV,82327,0,"-342163158,74"
04/27/2024,48340,,15441,Terminal LS - Transferencia TPV,"84348,01",0,"-342078810,73"
04/27/2024,48337,,15433,Terminal LS - Transferencia TPV,"115486,99",0,"-341963323,74"
04/27/2024,48321,,15367,Terminal LS - Transferencia TPV,80000,0,"-341883323,74"
04/27/2024,48334,,15413,Terminal LS - Transferencia TPV,191258,0,"-341692065,74"
04/27/2024,48336,,15423,Terminal LS - Transferencia TPV,77137,0,"-341614928,74"
04/27/2024,48329,,15398,Terminal LS - Transferencia TPV,171000,0,"-341443928,74"
04/27/2024,47824,,,Terminal LS - Tarjeta TPV,0,1024748,"-342468676,74"
04/27/2024,48331,,15405,Terminal LS - Transferencia TPV,80000,0,"-342388676,74"
04/27/2024,48339,,15439,Terminal LS - Transferencia TPV,76044,0,"-342312632,74"
04/27/2024,48313,,15374,Terminal LS - Tarjeta TPV,173176,0,"-342139456,74"
04/27/2024,48326,,15391,Terminal LS - Transferencia TPV,160000,0,"-341979456,74"
04/27/2024,48312,,15363,Terminal LS - Tarjeta TPV,23491,0,"-341955965,74"
04/27/2024,48319,,15440,Terminal LS - Tarjeta TPV,154550,0,"-341801415,74"
04/27/2024,48315,,15428,Terminal LS - Tarjeta TPV,79486,0,"-341721929,74"
04/27/2024,48328,,15397,Terminal LS - Transferencia TPV,77700,0,"-341644229,74"
04/27/2024,48314,,15426,Terminal LS - Tarjeta TPV,88000,0,"-341556229,74"
04/27/2024,48322,,15371,Terminal LS - Transferencia TPV,150300,0,"-341405929,74"
04/27/2024,48325,,15387,Terminal LS - Transferencia TPV,230000,0,"-341175929,74"
04/27/2024,48324,,15386,Terminal LS - Transferencia TPV,66000,0,"-341109929,74"
04/27/2024,48332,,15409,Terminal LS - Transferencia TPV,56500,0,"-341053429,74"
04/27/2024,48330,,15399,Terminal LS - Transferencia TPV,80633,0,"-340972796,74"
04/27/2024,48318,,15438,Terminal LS - Tarjeta TPV,237584,0,"-340735212,74"
04/27/2024,48323,,15379,Terminal LS - Transferencia TPV,"59999,99",0,"-340675212,75"
04/27/2024,48327,,15394,Terminal LS - Transferencia TPV,68000,0,"-340607212,75"
04/27/2024,48341,,15442,Terminal LS - Transferencia TPV,81289,0,"-340525923,75"
04/27/2024,48335,,15422,Terminal LS - Transferencia TPV,97459,0,"-340428464,75"
04/28/2024,48724,,15494,Terminal LS - Tarjeta TPV,"381260,02",0,"-340047204,73"
04/28/2024,48728,,15514,Terminal LS - Tarjeta TPV,225000,0,"-339822204,73"
04/28/2024,48729,,15514,Terminal LS - Tarjeta TPV,"259127,99",0,"-339563076,74"
04/28/2024,48345,,,Terminal LS - Transferencia TPV,0,2814837,"-342377913,74"
04/28/2024,48320,,,Terminal LS - Tarjeta TPV,0,1067785,"-343445698,74"
04/28/2024,48721,,15460,Terminal LS - Tarjeta TPV,"138595,01",0,"-343307103,73"
04/28/2024,48722,,15472,Terminal LS - Tarjeta TPV,"89264,99",0,"-343217838,74"
04/28/2024,48723,,15475,Terminal LS - Tarjeta TPV,"103413,99",0,"-343114424,75"
04/28/2024,48725,,15503,Terminal LS - Tarjeta TPV,"134388,99",0,"-342980035,76"
04/28/2024,48726,,15506,Terminal LS - Tarjeta TPV,"96803,99",0,"-342883231,77"
04/28/2024,48727,,15510,Terminal LS - Tarjeta TPV,61185,0,"-342822046,77"
04/28/2024,48730,,15517,Terminal LS - Tarjeta TPV,193225,0,"-342628821,77"
04/28/2024,48732,,15449,Terminal LS - Transferencia TPV,"130345,99",0,"-342498475,78"
04/28/2024,48733,,15450,Terminal LS - Transferencia TPV,"403900,01",0,"-342094575,77"
04/28/2024,48734,,15452,Terminal LS - Transferencia TPV,63000,0,"-342031575,77"
04/28/2024,48735,,15456,Terminal LS - Transferencia TPV,116250,0,"-341915325,77"
04/28/2024,48736,,15464,Terminal LS - Transferencia TPV,"141108,01",0,"-341774217,76"
04/28/2024,48737,,15466,Terminal LS - Transferencia TPV,115000,0,"-341659217,76"
04/28/2024,48738,,15476,Terminal LS - Transferencia TPV,"396884,01",0,"-341262333,75"
04/28/2024,48739,,15477,Terminal LS - Transferencia TPV,82500,0,"-341179833,75"
04/28/2024,48740,,15480,Terminal LS - Transferencia TPV,54000,0,"-341125833,75"
04/28/2024,48741,,15484,Terminal LS - Transferencia TPV,60500,0,"-341065333,75"
04/28/2024,48742,,15490,Terminal LS - Transferencia TPV,132914,0,"-340932419,75"
04/28/2024,48743,,15491,Terminal LS - Transferencia TPV,143200,0,"-340789219,75"
04/28/2024,48744,,15492,Terminal LS - Transferencia TPV,93635,0,"-340695584,75"
04/28/2024,48745,,15495,Terminal LS - Transferencia TPV,226440,0,"-340469144,75"
04/28/2024,48746,,15501,Terminal LS - Transferencia TPV,63000,0,"-340406144,75"
04/28/2024,48747,,15502,Terminal LS - Transferencia TPV,157880,0,"-340248264,75"
04/28/2024,48748,,15507,Terminal LS - Transferencia TPV,87462,0,"-340160802,75"
04/28/2024,48749,,15508,Terminal LS - Transferencia TPV,"280414,01",0,"-339880388,74"
04/28/2024,48750,,15509,Terminal LS - Transferencia TPV,165746,0,"-339714642,74"
04/28/2024,48751,,15511,Terminal LS - Transferencia TPV,"218999,99",0,"-339495642,75"
04/28/2024,48752,,15512,Terminal LS - Transferencia TPV,154438,0,"-339341204,75"
04/28/2024,48753,,15513,Terminal LS - Transferencia TPV,218792,0,"-339122412,75"
04/28/2024,48754,,15521,Terminal LS - Transferencia TPV,"169898,01",0,"-338952514,74"
04/29/2024,48755,,,Terminal LS - Transferencia TPV,0,3676298,"-342778812,74"
04/29/2024,48731,,,Terminal LS - Tarjeta TPV,0,1282260,"-344061072,74"
04/30/2024,48846,,15526,Terminal LS - Tarjeta TPV,68615,0,"-344067457,74"
04/30/2024,48850,,15524,Terminal LS - Transferencia TPV,"115814,99",0,"-343951642,75"
04/30/2024,48852,,15531,Terminal LS - Transferencia TPV,59500,0,"-343892142,75"
04/30/2024,48853,,15535,Terminal LS - Transferencia TPV,"91230,99",0,"-343800911,76"
04/30/2024,48847,,15527,Terminal LS - Tarjeta TPV,73040,0,"-343727871,76"
04/30/2024,48854,,15537,Terminal LS - Transferencia TPV,"94727,99",0,"-347388715,8"
04/30/2024,48855,,15538,Terminal LS - Transferencia TPV,152144,0,"-347236571,8"
04/30/2024,48856,,15539,Terminal LS - Transferencia TPV,83911,0,"-347799682,75"
04/30/2024,48857,,15540,Terminal LS - Transferencia TPV,"163232,99",0,"-347843509,76"
04/30/2024,48848,,15542,Terminal LS - Tarjeta TPV,"176181,01",0,"-347667328,75"
04/30/2024,48858,,15543,Terminal LS - Transferencia TPV,"98999,99",0,"-347568328,76"
04/30/2024,48851,,15530,Terminal LS - Transferencia TPV,131500,0,"-347436828,76"
05/01/2024,49329,,15613,Terminal LS - Tarjeta TPV,"93306,99",0,"-347343521,77"
05/01/2024,49331,,15544,Terminal LS - Transferencia TPV,"117699,99",0,"-347225821,78"
05/01/2024,49332,,15545,Terminal LS - Transferencia TPV,"182000,01",0,"-347043821,77"
05/01/2024,49333,,15546,Terminal LS - Transferencia TPV,63000,0,"-346980821,77"
05/01/2024,49334,,15547,Terminal LS - Transferencia TPV,"83364,99",0,"-346897456,78"
05/01/2024,49335,,15582,Terminal LS - Transferencia TPV,55500,0,"-346841956,78"
05/01/2024,49336,,15587,Terminal LS - Transferencia TPV,"113301,99",0,"-346728654,79"
05/01/2024,48849,,,Terminal LS - Tarjeta TPV,0,317836,"-356449029,79"
05/01/2024,48859,,,Terminal LS - Transferencia TPV,0,991062,"-357440091,79"
05/01/2024,49337,,15588,Terminal LS - Transferencia TPV,"54999,99",0,"-358328121,8"
05/01/2024,49338,,15591,Terminal LS - Transferencia TPV,91559,0,"-358236562,8"
05/01/2024,49339,,15599,Terminal LS - Transferencia TPV,"168368,99",0,"-358068193,81"
05/01/2024,49340,,15603,Terminal LS - Transferencia TPV,95602,0,"-357972591,81"
05/01/2024,49341,,15607,Terminal LS - Transferencia TPV,49000,0,"-357923591,81"
05/01/2024,49342,,15608,Terminal LS - Transferencia TPV,"149630,99",0,"-357773960,82"
05/01/2024,49343,,15610,Terminal LS - Transferencia TPV,78120,0,"-357695840,82"
05/01/2024,49344,,15614,Terminal LS - Transferencia TPV,"82490,99",0,"-357613349,83"
05/01/2024,49345,,15615,Terminal LS - Transferencia TPV,80961,0,"-357532388,83"
05/01/2024,49346,,15620,Terminal LS - Transferencia TPV,"78566,99",0,"-357453821,84"
05/01/2024,49347,,15621,Terminal LS - Transferencia TPV,"221905,99",0,"-357231915,85"
05/01/2024,49325,,15571,Terminal LS - Tarjeta TPV,55250,0,"-357176665,85"
05/01/2024,49326,,15594,Terminal LS - Tarjeta TPV,108931,0,"-357067734,85"
05/01/2024,49327,,15596,Terminal LS - Tarjeta TPV,67850,0,"-356999884,85"
05/01/2024,49328,,15602,Terminal LS - Tarjeta TPV,59000,0,"-356940884,85"
05/02/2024,49462,,15644,Terminal LS - Tarjeta TPV,92215,0,"-356848669,85"
05/02/2024,49330,,,Terminal LS - Tarjeta TPV,0,384337,"-357353007,05"
05/02/2024,49348,,,Terminal LS - Transferencia TPV,0,1766067,"-359119074,05"
05/02/2024,49471,,15645,Terminal LS - Transferencia TPV,"176344,01",0,"-359097730,04"
05/02/2024,49470,,15640,Terminal LS - Transferencia TPV,"102266,98",0,"-358995463,06"
05/02/2024,49469,,15635,Terminal LS - Transferencia TPV,52500,0,"-358942963,06"
05/02/2024,49468,,15634,Terminal LS - Transferencia TPV,79000,0,"-358863963,06"
05/02/2024,49467,,15633,Terminal LS - Transferencia TPV,95383,0,"-358768580,06"
05/02/2024,49466,,15628,Terminal LS - Transferencia TPV,91778,0,"-358676802,06"
05/02/2024,49465,,15626,Terminal LS - Transferencia TPV,79431,0,"-358597371,06"
05/02/2024,49463,,15646,Terminal LS - Tarjeta TPV,170281,0,"-358427090,06"
05/02/2024,49461,,15643,Terminal LS - Tarjeta TPV,121660,0,"-358305430,06"
05/02/2024,49460,,15639,Terminal LS - Tarjeta TPV,85222,0,"-358220208,06"
05/02/2024,49459,,15636,Terminal LS - Tarjeta TPV,63917,0,"-358156291,06"
05/02/2024,49458,,15625,Terminal LS - Tarjeta TPV,167000,0,"-357989291,06"
05/03/2024,49707,,15690,Terminal LS - Tarjeta TPV,"149999,99",0,"-357839291,07"
05/03/2024,49733,,15681,Terminal LS - Transferencia TPV,119000,0,"-357720291,07"
05/03/2024,49706,,15689,Terminal LS - Tarjeta TPV,"144604,98",0,"-358799143,37"
05/03/2024,49729,,15664,Terminal LS - Transferencia TPV,63000,0,"-358736143,37"
05/03/2024,49705,,15685,Terminal LS - Tarjeta TPV,"141905,81",0,"-358594237,56"
05/03/2024,49701,,15652,Terminal LS - Tarjeta TPV,55600,0,"-358538637,56"
05/03/2024,49702,,15656,Terminal LS - Tarjeta TPV,40600,0,"-358498037,56"
05/03/2024,49703,,15666,Terminal LS - Tarjeta TPV,124392,0,"-358373645,56"
05/03/2024,49704,,15668,Terminal LS - Tarjeta TPV,92106,0,"-358281539,56"
05/03/2024,49734,,15682,Terminal LS - Transferencia TPV,"70799,99",0,"-358210739,57"
05/03/2024,49730,,15665,Terminal LS - Transferencia TPV,"98999,99",0,"-358111739,58"
05/03/2024,49732,,15680,Terminal LS - Transferencia TPV,"64999,99",0,"-358046739,59"
05/03/2024,49731,,15677,Terminal LS - Transferencia TPV,87407,0,"-357959332,59"
05/03/2024,49735,,15684,Terminal LS - Transferencia TPV,67358,0,"-357891974,59"
05/03/2024,49472,,,Terminal LS - Transferencia TPV,0,676702,"-358568676,59"
05/03/2024,49464,,,Terminal LS - Tarjeta TPV,0,700295,"-359268971,59"
05/03/2024,49736,,15695,Terminal LS - Transferencia TPV,175689,0,"-359093282,59"
05/03/2024,49723,,15653,Terminal LS - Transferencia TPV,97000,0,"-358996282,59"
05/03/2024,49724,,15654,Terminal LS - Transferencia TPV,67500,0,"-358928782,59"
05/03/2024,49725,,15657,Terminal LS - Transferencia TPV,"64999,99",0,"-358863782,6"
05/03/2024,49726,,15658,Terminal LS - Transferencia TPV,59000,0,"-358804782,6"
05/03/2024,49727,,15662,Terminal LS - Transferencia TPV,85222,0,"-358719560,6"
05/03/2024,49728,,15663,Terminal LS - Transferencia TPV,58850,0,"-358660710,6"
05/03/2024,49737,,15698,Terminal LS - Transferencia TPV,177546,0,"-358483164,6"
05/03/2024,49738,,15702,Terminal LS - Transferencia TPV,"76809,01",0,"-358406355,59"
05/03/2024,49739,,15703,Terminal LS - Transferencia TPV,177929,0,"-358228426,59"
05/03/2024,49740,,15704,Terminal LS - Transferencia TPV,79431,0,"-358148995,59"
05/03/2024,49741,,15705,Terminal LS - Transferencia TPV,126577,0,"-358022418,59"
05/03/2024,49713,,15706,Terminal LS - Tarjeta TPV,91778,0,"-357930640,59"
05/03/2024,49712,,15701,Terminal LS - Tarjeta TPV,142146,0,"-357788494,59"
05/03/2024,49711,,15700,Terminal LS - Tarjeta TPV,"263642,99",0,"-357524851,6"
05/03/2024,49710,,15699,Terminal LS - Tarjeta TPV,113083,0,"-357411768,6"
05/03/2024,49709,,15693,Terminal LS - Tarjeta TPV,"127833,01",0,"-357283935,59"
05/03/2024,49708,,15692,Terminal LS - Tarjeta TPV,"96584,99",0,"-357187350,6"
05/04/2024,50205,,15788,Terminal LS - Transferencia TPV,"78229,99",0,"-357109120,61"
05/04/2024,50202,,15777,Terminal LS - Transferencia TPV,"156000,01",0,"-356953120,6"
05/04/2024,50191,,15734,Terminal LS - Transferencia TPV,69500,0,"-356883620,6"
05/04/2024,50195,,15752,Terminal LS - Transferencia TPV,186560,0,"-356697060,6"
05/04/2024,50197,,15757,Terminal LS - Transferencia TPV,"122999,99",0,"-356574060,61"
05/04/2024,50200,,15769,Terminal LS - Transferencia TPV,147500,0,"-356529944,23"
05/04/2024,50196,,15753,Terminal LS - Transferencia TPV,61000,0,"-356468944,23"
05/04/2024,50206,,15793,Terminal LS - Transferencia TPV,"93198,01",0,"-356375746,22"
05/04/2024,50192,,15739,Terminal LS - Transferencia TPV,107000,0,"-356623856,21"
05/04/2024,50207,,15795,Terminal LS - Transferencia TPV,253809,0,"-356370047,21"
05/04/2024,50204,,15783,Terminal LS - Transferencia TPV,113630,0,"-356256417,21"
05/04/2024,50187,,15774,Terminal LS - Tarjeta TPV,56651,0,"-356199766,21"
05/04/2024,50201,,15776,Terminal LS - Transferencia TPV,180000,0,"-356019766,21"
05/04/2024,50199,,15766,Terminal LS - Transferencia TPV,51352,0,"-355968414,21"
05/04/2024,50203,,15781,Terminal LS - Transferencia TPV,"79212,99",0,"-355889201,22"
05/04/2024,50184,,15709,Terminal LS - Tarjeta TPV,"152853,99",0,"-355736347,23"
05/04/2024,50209,,15797,Terminal LS - Transferencia TPV,67600,0,"-355668747,23"
05/04/2024,50194,,15746,Terminal LS - Transferencia TPV,107456,0,"-355561291,23"
05/04/2024,50193,,15742,Terminal LS - Transferencia TPV,75662,0,"-355883629,23"
05/04/2024,49742,,,Terminal LS - Transferencia TPV,0,1818118,"-357701747,23"
05/04/2024,50190,,15729,Terminal LS - Transferencia TPV,"63499,99",0,"-357638247,24"
05/04/2024,50186,,15750,Terminal LS - Tarjeta TPV,"92323,99",0,"-357545923,25"
05/04/2024,49714,,,Terminal LS - Tarjeta TPV,0,1584274,"-359130197,25"
05/04/2024,50189,,15715,Terminal LS - Transferencia TPV,75935,0,"-359054262,25"
05/04/2024,50198,,15764,Terminal LS - Transferencia TPV,73700,0,"-358980562,25"
05/04/2024,50185,,15711,Terminal LS - Tarjeta TPV,92870,0,"-358887692,25"
05/04/2024,50208,,15796,Terminal LS - Transferencia TPV,79322,0,"-358808370,25"
05/05/2024,50616,,15806,Terminal LS - Transferencia TPV,238786,0,"-358569584,25"
05/05/2024,50624,,15853,Terminal LS - Transferencia TPV,113520,0,"-358456064,25"
05/05/2024,50620,,15848,Terminal LS - Transferencia TPV,62000,0,"-358394064,25"
05/05/2024,50625,,15855,Terminal LS - Transferencia TPV,"139414,99",0,"-358254649,26"
05/05/2024,50612,,15858,Terminal LS - Tarjeta TPV,"136045,99",0,"-358118603,27"
05/05/2024,50626,,15857,Terminal LS - Transferencia TPV,"190000,01",0,"-357928603,26"
05/05/2024,50619,,15843,Terminal LS - Transferencia TPV,62000,0,"-357866603,26"
05/05/2024,50628,,15864,Terminal LS - Transferencia TPV,141050,0,"-357725553,26"
05/05/2024,50629,,15867,Terminal LS - Transferencia TPV,156077,0,"-357569476,26"
05/05/2024,50627,,15861,Terminal LS - Transferencia TPV,64000,0,"-357518336,24"
05/05/2024,50611,,15858,Terminal LS - Tarjeta TPV,65100,0,"-357453236,24"
05/05/2024,50630,,15874,Terminal LS - Transferencia TPV,"195099,99",0,"-357258136,25"
05/05/2024,50617,,15831,Terminal LS - Transferencia TPV,77410,0,"-357180726,25"
05/05/2024,50623,,15852,Terminal LS - Transferencia TPV,"130018,99",0,"-357050707,26"
05/05/2024,50188,,,Terminal LS - Tarjeta TPV,0,394697,"-357445404,26"
05/05/2024,50210,,,Terminal LS - Transferencia TPV,0,2243160,"-359688564,26"
05/05/2024,50614,,15802,Terminal LS - Transferencia TPV,"187707,01",0,"-359500857,25"
05/05/2024,50618,,15838,Terminal LS - Transferencia TPV,121824,0,"-359379033,25"
05/05/2024,50631,,15875,Terminal LS - Transferencia TPV,80000,0,"-359299033,25"
05/05/2024,50622,,15851,Terminal LS - Transferencia TPV,98333,0,"-359200700,25"
05/05/2024,50621,,15849,Terminal LS - Transferencia TPV,61300,0,"-359139400,25"
05/05/2024,50615,,15803,Terminal LS - Transferencia TPV,71893,0,"-359067507,25"
05/06/2024,50613,,,Terminal LS - Tarjeta TPV,0,201146,"-359268653,25"
05/06/2024,50632,,,Terminal LS - Transferencia TPV,0,2190436,"-361459089,25"
05/07/2024,50712,,15881,Terminal LS - Transferencia TPV,7000,0,"-363798329,55"
05/07/2024,50711,,15879,Terminal LS - Transferencia TPV,67000,0,"-363731329,55"
05/07/2024,50709,,15894,Terminal LS - Tarjeta TPV,138595,0,"-363592734,55"
05/07/2024,50708,,15893,Terminal LS - Tarjeta TPV,84894,0,"-363507840,55"
05/07/2024,50707,,15892,Terminal LS - Tarjeta TPV,81398,0,"-363426442,55"
05/07/2024,50706,,15891,Terminal LS - Tarjeta TPV,86206,0,"-363340236,55"
05/07/2024,50705,,15882,Terminal LS - Tarjeta TPV,95984,0,"-363244252,55"
05/07/2024,50704,,15878,Terminal LS - Tarjeta TPV,65000,0,"-363179252,55"
05/07/2024,50714,,15887,Terminal LS - Transferencia TPV,100000,0,"-363870742,29"
05/07/2024,50716,,15889,Terminal LS - Transferencia TPV,"141927,99",0,"-363728814,3"
05/07/2024,50715,,15888,Terminal LS - Transferencia TPV,108385,0,"-363620429,3"
05/07/2024,50713,,15883,Terminal LS - Transferencia TPV,"90499,99",0,"-363529929,31"
05/08/2024,50710,,,Terminal LS - Tarjeta TPV,0,552077,"-364819398,78"
05/08/2024,50842,,15914,Terminal LS - Transferencia TPV,"96694,01",0,"-364722704,77"
05/08/2024,50717,,,Terminal LS - Transferencia TPV,0,514812,"-365237516,77"
05/08/2024,50833,,15898,Terminal LS - Tarjeta TPV,52800,0,"-365184716,77"
05/08/2024,50834,,15911,Terminal LS - Tarjeta TPV,160283,0,"-365024433,77"
05/08/2024,50835,,15916,Terminal LS - Tarjeta TPV,"198195,99",0,"-364826237,78"
05/08/2024,50837,,15895,Terminal LS - Transferencia TPV,"59999,99",0,"-364874237,79"
05/08/2024,50838,,15903,Terminal LS - Transferencia TPV,118000,0,"-364756237,79"
05/08/2024,50839,,15905,Terminal LS - Transferencia TPV,"78830,99",0,"-364677406,8"
05/08/2024,50840,,15906,Terminal LS - Transferencia TPV,75444,0,"-364601962,8"
05/08/2024,50841,,15908,Terminal LS - Transferencia TPV,72000,0,"-364529962,8"
05/08/2024,50843,,15915,Terminal LS - Transferencia TPV,71500,0,"-364458462,8"
05/08/2024,50844,,15917,Terminal LS - Transferencia TPV,67850,0,"-364390612,8"
05/08/2024,50845,,15918,Terminal LS - Transferencia TPV,72900,0,"-364317712,8"
05/08/2024,50846,,15919,Terminal LS - Transferencia TPV,"110249,98",0,"-364207462,82"
05/08/2024,50847,,15920,Terminal LS - Transferencia TPV,91122,0,"-364116340,82"
05/08/2024,50848,,15922,Terminal LS - Transferencia TPV,93089,0,"-364023251,82"
05/08/2024,50849,,15923,Terminal LS - Transferencia TPV,"226999,99",0,"-363796251,83"
05/09/2024,51067,,15963,Terminal LS - Tarjeta TPV,"81152,99",0,"-364471798,33"
05/09/2024,51066,,15963,Terminal LS - Tarjeta TPV,81152,0,"-364390646,33"
05/09/2024,51061,,15949,Terminal LS - Tarjeta TPV,69677,0,"-364320969,33"
05/09/2024,50836,,,Terminal LS - Tarjeta TPV,0,411083,"-364732052,33"
05/09/2024,51070,,15927,Terminal LS - Transferencia TPV,68000,0,"-364664052,33"
05/09/2024,51071,,15933,Terminal LS - Transferencia TPV,"172999,98",0,"-364491052,35"
05/09/2024,51082,,15956,Terminal LS - Transferencia TPV,106528,0,"-364384524,35"
05/09/2024,51072,,15934,Terminal LS - Transferencia TPV,68069,0,"-364316455,35"
05/09/2024,51073,,15936,Terminal LS - Transferencia TPV,61000,0,"-364255455,35"
05/09/2024,51074,,15938,Terminal LS - Transferencia TPV,72050,0,"-364183405,35"
05/09/2024,51075,,15940,Terminal LS - Transferencia TPV,115815,0,"-364067590,35"
05/09/2024,51065,,15962,Terminal LS - Tarjeta TPV,87735,0,"-363979855,35"
05/09/2024,51076,,15946,Terminal LS - Transferencia TPV,55000,0,"-363924855,35"
05/09/2024,51077,,15948,Terminal LS - Transferencia TPV,64000,0,"-363860855,35"
05/09/2024,51078,,15953,Terminal LS - Transferencia TPV,87626,0,"-363773229,35"
05/09/2024,51079,,15955,Terminal LS - Transferencia TPV,47000,0,"-363726229,35"
05/09/2024,51083,,15959,Terminal LS - Transferencia TPV,151433,0,"-363574796,35"
05/09/2024,51088,,15970,Terminal LS - Transferencia TPV,"110023,99",0,"-363464772,36"
05/09/2024,51087,,15968,Terminal LS - Transferencia TPV,"409099,99",0,"-363055672,37"
05/09/2024,51068,,15969,Terminal LS - Tarjeta TPV,72985,0,"-362982687,37"
05/09/2024,50850,,,Terminal LS - Transferencia TPV,0,1234679,"-364217366,37"
05/09/2024,51081,,15956,Terminal LS - Transferencia TPV,53264,0,"-364164102,37"
05/09/2024,51084,,15961,Terminal LS - Transferencia TPV,76263,0,"-364247839,37"
05/09/2024,51062,,15950,Terminal LS - Tarjeta TPV,136137,0,"-364111702,37"
05/09/2024,51080,,15956,Terminal LS - Transferencia TPV,53264,0,"-364058438,37"
05/09/2024,51064,,15954,Terminal LS - Tarjeta TPV,"93199,99",0,"-364360578,38"
05/09/2024,51060,,15949,Terminal LS - Tarjeta TPV,69677,0,"-364290901,38"
05/09/2024,51086,,15967,Terminal LS - Transferencia TPV,"83049,99",0,"-364207851,39"
05/09/2024,51063,,15951,Terminal LS - Tarjeta TPV,90303,0,"-364117548,39"
05/09/2024,51085,,15965,Terminal LS - Transferencia TPV,66648,0,"-364050900,39"
05/10/2024,51319,,15991,Terminal LS - Transferencia TPV,"102703,99",0,"-363948196,4"
05/10/2024,51321,,15996,Terminal LS - Transferencia TPV,"118800,99",0,"-363829395,41"
05/10/2024,51322,,15999,Terminal LS - Transferencia TPV,83037,0,"-363746358,41"
05/10/2024,51323,,16008,Terminal LS - Transferencia TPV,77100,0,"-363669258,41"
05/10/2024,51324,,16010,Terminal LS - Transferencia TPV,"147882,01",0,"-363521376,4"
05/10/2024,51325,,16011,Terminal LS - Transferencia TPV,82000,0,"-363439376,4"
05/10/2024,51326,,16012,Terminal LS - Transferencia TPV,157900,0,"-363281476,4"
05/10/2024,51313,,16009,Terminal LS - Tarjeta TPV,102321,0,"-363179155,4"
05/10/2024,51312,,16007,Terminal LS - Tarjeta TPV,108931,0,"-363070224,4"
05/10/2024,51311,,16003,Terminal LS - Tarjeta TPV,90000,0,"-362980224,4"
05/10/2024,51327,,16015,Terminal LS - Transferencia TPV,"98599,99",0,"-362881624,41"
05/10/2024,51328,,16019,Terminal LS - Transferencia TPV,85058,0,"-362796566,41"
05/10/2024,51306,,15981,Terminal LS - Tarjeta TPV,78066,0,"-363390500,41"
05/10/2024,51305,,15979,Terminal LS - Tarjeta TPV,70500,0,"-363320000,41"
05/10/2024,51318,,15980,Terminal LS - Transferencia TPV,61000,0,"-363259000,41"
05/10/2024,51317,,15971,Terminal LS - Transferencia TPV,80250,0,"-363178750,41"
05/10/2024,51069,,,Terminal LS - Tarjeta TPV,0,782018,"-363960768,41"
05/10/2024,51310,,16001,Terminal LS - Tarjeta TPV,81234,0,"-363879534,41"
05/10/2024,51309,,15998,Terminal LS - Tarjeta TPV,92488,0,"-363787046,41"
05/10/2024,51089,,,Terminal LS - Transferencia TPV,0,1921133,"-365708179,41"
05/10/2024,51315,,16014,Terminal LS - Tarjeta TPV,"118218,99",0,"-365589960,42"
05/10/2024,51314,,16013,Terminal LS - Tarjeta TPV,77410,0,"-365512550,42"
05/10/2024,51308,,15997,Terminal LS - Tarjeta TPV,88063,0,"-365424487,42"
05/10/2024,51307,,15989,Terminal LS - Tarjeta TPV,102540,0,"-365321947,42"
05/10/2024,51303,,15972,Terminal LS - Tarjeta TPV,"103999,99",0,"-365217947,43"
05/10/2024,51304,,15975,Terminal LS - Tarjeta TPV,70472,0,"-365147475,43"
05/10/2024,51320,,15992,Terminal LS - Transferencia TPV,79541,0,"-365067934,43"
05/11/2024,51900,,16036,Terminal LS - Transferencia TPV,95711,0,"-364972223,43"
05/11/2024,51905,,16063,Terminal LS - Transferencia TPV,93799,0,"-364878424,43"
05/11/2024,51877,,16025,Terminal LS - Tarjeta TPV,82272,0,"-364796152,43"
05/11/2024,51884,,16068,Terminal LS - Tarjeta TPV,186069,0,"-364610083,43"
05/11/2024,51895,,16110,Terminal LS - Tarjeta TPV,"144877,99",0,"-364465205,44"
05/11/2024,51908,,16084,Terminal LS - Transferencia TPV,78120,0,"-364387085,44"
05/11/2024,51901,,16045,Terminal LS - Transferencia TPV,5800,0,"-364381285,44"
05/11/2024,51899,,16022,Terminal LS - Transferencia TPV,117000,0,"-364264285,44"
05/11/2024,51912,,16097,Terminal LS - Transferencia TPV,"80851,99",0,"-364183433,45"
05/11/2024,51887,,16079,Terminal LS - Tarjeta TPV,105654,0,"-364077779,45"
05/11/2024,51916,,16105,Terminal LS - Transferencia TPV,112537,0,"-363965242,45"
05/11/2024,51891,,16093,Terminal LS - Tarjeta TPV,103086,0,"-363862156,45"
05/11/2024,51919,,16113,Terminal LS - Transferencia TPV,332531,0,"-363529625,45"
05/11/2024,51883,,16065,Terminal LS - Tarjeta TPV,151433,0,"-363378192,45"
05/11/2024,51885,,16072,Terminal LS - Tarjeta TPV,"146843,99",0,"-363231348,46"
05/11/2024,51892,,16094,Terminal LS - Tarjeta TPV,"78447,99",0,"-363152900,47"
05/11/2024,51886,,16078,Terminal LS - Tarjeta TPV,83146,0,"-363069754,47"
05/11/2024,51906,,16073,Terminal LS - Transferencia TPV,"57907,01",0,"-363011847,46"
05/11/2024,51878,,16027,Terminal LS - Tarjeta TPV,347000,0,"-362664847,46"
05/11/2024,51879,,16027,Terminal LS - Tarjeta TPV,"175040,99",0,"-362489806,47"
05/11/2024,51911,,16091,Terminal LS - Transferencia TPV,"78229,99",0,"-362411576,48"
05/11/2024,51880,,16030,Terminal LS - Tarjeta TPV,92870,0,"-362318706,48"
05/11/2024,51913,,16101,Terminal LS - Transferencia TPV,"115923,99",0,"-362202782,49"
05/11/2024,51896,,16111,Terminal LS - Tarjeta TPV,88719,0,"-362114063,49"
05/11/2024,51889,,16087,Terminal LS - Tarjeta TPV,165910,0,"-361948153,49"
05/11/2024,51918,,16109,Terminal LS - Transferencia TPV,73313,0,"-361874840,49"
05/11/2024,51894,,16099,Terminal LS - Tarjeta TPV,"167603,99",0,"-361707236,5"
05/11/2024,51910,,16090,Terminal LS - Transferencia TPV,94728,0,"-361612508,5"
05/11/2024,51915,,16104,Terminal LS - Transferencia TPV,"109477,99",0,"-361503030,51"
05/11/2024,51914,,16103,Terminal LS - Transferencia TPV,145424,0,"-361357606,51"
05/11/2024,51903,,16059,Terminal LS - Transferencia TPV,90521,0,"-361267085,51"
05/11/2024,51890,,16092,Terminal LS - Tarjeta TPV,90139,0,"-361176946,51"
05/11/2024,51316,,,Terminal LS - Tarjeta TPV,0,1184243,"-362361189,51"
05/11/2024,51881,,16044,Terminal LS - Tarjeta TPV,51850,0,"-362309339,51"
05/11/2024,51888,,16083,Terminal LS - Tarjeta TPV,194481,0,"-362114858,51"
05/11/2024,51917,,16107,Terminal LS - Transferencia TPV,72657,0,"-362042201,51"
05/11/2024,51882,,16062,Terminal LS - Tarjeta TPV,175689,0,"-361866512,51"
05/11/2024,51893,,16096,Terminal LS - Tarjeta TPV,"80414,99",0,"-361786097,52"
05/11/2024,51907,,16076,Terminal LS - Transferencia TPV,"96147,99",0,"-361689949,53"
05/11/2024,51902,,16046,Terminal LS - Transferencia TPV,"125000,01",0,"-361564949,52"
05/11/2024,51904,,16060,Terminal LS - Transferencia TPV,167604,0,"-361397345,52"
05/11/2024,51909,,16086,Terminal LS - Transferencia TPV,51850,0,"-361345495,52"
05/11/2024,51329,,,Terminal LS - Transferencia TPV,0,1173873,"-362519368,52"
05/11/2024,51897,,16112,Terminal LS - Tarjeta TPV,87407,0,"-363648367,21"
05/12/2024,51898,,,Terminal LS - Tarjeta TPV,0,2798951,"-366597938,16"
05/12/2024,52365,,16161,Terminal LS - Transferencia TPV,"59999,99",0,"-366537938,17"
05/12/2024,51920,,,Terminal LS - Transferencia TPV,0,2195131,"-368733069,17"
05/12/2024,52362,,16129,Terminal LS - Transferencia TPV,"117125,99",0,"-368615943,18"
05/12/2024,52363,,16142,Terminal LS - Transferencia TPV,"173721,99",0,"-368442221,19"
05/12/2024,52364,,16150,Terminal LS - Transferencia TPV,"755965,02",0,"-367686256,17"
05/12/2024,52366,,16168,Terminal LS - Transferencia TPV,128000,0,"-367558256,17"
05/12/2024,52367,,16176,Terminal LS - Transferencia TPV,"83700,01",0,"-367474556,16"
05/12/2024,52368,,16177,Terminal LS - Transferencia TPV,"264999,99",0,"-367209556,17"
05/12/2024,52369,,16181,Terminal LS - Transferencia TPV,102594,0,"-367106962,17"
05/12/2024,52370,,16184,Terminal LS - Transferencia TPV,"104342,99",0,"-367002619,18"
05/12/2024,52371,,16186,Terminal LS - Transferencia TPV,149576,0,"-366853043,18"
05/12/2024,52372,,16188,Terminal LS - Transferencia TPV,67000,0,"-366786043,18"
05/12/2024,52373,,16189,Terminal LS - Transferencia TPV,142037,0,"-366644006,18"
05/12/2024,52374,,16190,Terminal LS - Transferencia TPV,98224,0,"-366545782,18"
05/12/2024,52375,,16191,Terminal LS - Transferencia TPV,"206499,99",0,"-366339282,19"
05/12/2024,52361,,16124,Terminal LS - Transferencia TPV,160000,0,"-366179282,19"
05/12/2024,52360,,16118,Terminal LS - Transferencia TPV,78200,0,"-366101082,19"
05/12/2024,52353,,16121,Terminal LS - Tarjeta TPV,"168368,99",0,"-365932713,2"
05/12/2024,52354,,16123,Terminal LS - Tarjeta TPV,"81944,01",0,"-365850769,19"
05/12/2024,52355,,16135,Terminal LS - Tarjeta TPV,80000,0,"-365770769,19"
05/12/2024,52356,,16138,Terminal LS - Tarjeta TPV,197705,0,"-365573064,19"
05/12/2024,52357,,16187,Terminal LS - Tarjeta TPV,84676,0,"-365488388,19"
05/12/2024,52359,,16116,Terminal LS - Transferencia TPV,"59999,99",0,"-365428388,2"
05/13/2024,52793,,16207,Terminal LS - Transferencia TPV,"70253,99",0,"-365358134,21"
05/13/2024,52794,,16233,Terminal LS - Transferencia TPV,"89920,01",0,"-365268214,2"
05/13/2024,52792,,16205,Terminal LS - Transferencia TPV,70300,0,"-365197914,2"
05/13/2024,52787,,16241,Terminal LS - Tarjeta TPV,73040,0,"-365124874,2"
05/13/2024,52788,,16269,Terminal LS - Tarjeta TPV,"138758,99",0,"-364986115,21"
05/13/2024,52798,,16264,Terminal LS - Transferencia TPV,"75552,99",0,"-364910562,22"
05/13/2024,52791,,16195,Terminal LS - Transferencia TPV,59000,0,"-364851562,22"
05/13/2024,52799,,16270,Terminal LS - Transferencia TPV,85331,0,"-364766231,22"
05/13/2024,52800,,16275,Terminal LS - Transferencia TPV,"93416,99",0,"-364672814,23"
05/13/2024,52801,,16277,Terminal LS - Transferencia TPV,138923,0,"-364533891,23"
05/13/2024,52797,,16258,Terminal LS - Transferencia TPV,84900,0,"-365400991,23"
05/13/2024,52358,,,Terminal LS - Tarjeta TPV,0,612694,"-366013685,23"
05/13/2024,52376,,,Terminal LS - Transferencia TPV,0,2751983,"-368765668,23"
05/13/2024,52796,,16256,Terminal LS - Transferencia TPV,"126194,01",0,"-368639474,22"
05/13/2024,52795,,16240,Terminal LS - Transferencia TPV,"130500,01",0,"-368508974,21"
05/13/2024,52789,,16280,Terminal LS - Tarjeta TPV,"133514,99",0,"-368375459,22"
05/14/2024,52988,,16294,Terminal LS - Transferencia TPV,119000,0,"-368256459,22"
05/14/2024,52989,,16295,Terminal LS - Transferencia TPV,"79868,99",0,"-368176590,23"
05/14/2024,52979,,16301,Terminal LS - Tarjeta TPV,73531,0,"-368103059,23"
05/14/2024,52978,,16300,Terminal LS - Tarjeta TPV,77574,0,"-368025485,23"
05/14/2024,52790,,,Terminal LS - Tarjeta TPV,0,345312,"-368370797,23"
05/14/2024,52977,,16297,Terminal LS - Tarjeta TPV,66757,0,"-368304040,23"
05/14/2024,52802,,,Terminal LS - Transferencia TPV,0,1024338,"-369328378,23"
05/14/2024,52976,,16296,Terminal LS - Tarjeta TPV,59500,0,"-369268878,23"
05/14/2024,52975,,16288,Terminal LS - Tarjeta TPV,150559,0,"-369337624,33"
05/14/2024,52982,,16305,Terminal LS - Tarjeta TPV,"273366,99",0,"-371157357,34"
05/14/2024,52991,,16307,Terminal LS - Transferencia TPV,146189,0,"-373053432,69"
05/14/2024,52981,,16304,Terminal LS - Tarjeta TPV,"98715,99",0,"-372954716,7"
05/14/2024,52990,,16298,Terminal LS - Transferencia TPV,59000,0,"-372895716,7"
05/14/2024,52983,,16306,Terminal LS - Tarjeta TPV,"167876,99",0,"-372727839,71"
05/14/2024,52985,,16287,Terminal LS - Transferencia TPV,"51499,99",0,"-372676339,72"
05/14/2024,52986,,16289,Terminal LS - Transferencia TPV,167167,0,"-372509172,72"
05/14/2024,52987,,16292,Terminal LS - Transferencia TPV,93963,0,"-372415209,72"
05/14/2024,52992,,16308,Terminal LS - Transferencia TPV,"170226,01",0,"-372244983,71"
05/14/2024,52980,,16303,Terminal LS - Tarjeta TPV,175634,0,"-372069349,71"
05/15/2024,53193,,16336,Terminal LS - Transferencia TPV,"549682,99",0,"-371519666,72"
05/15/2024,52984,,,Terminal LS - Tarjeta TPV,0,1143513,"-372663179,72"
05/15/2024,52993,,,Terminal LS - Transferencia TPV,0,886913,"-373550092,72"
05/15/2024,53190,,16325,Terminal LS - Transferencia TPV,76000,0,"-373474092,72"
05/15/2024,53179,,16323,Terminal LS - Tarjeta TPV,"90903,99",0,"-373383188,73"
05/15/2024,53180,,16335,Terminal LS - Tarjeta TPV,"241899,99",0,"-373141288,74"
05/15/2024,53181,,16338,Terminal LS - Tarjeta TPV,86315,0,"-373054973,74"
05/15/2024,53182,,16340,Terminal LS - Tarjeta TPV,"107510,99",0,"-372947462,75"
05/15/2024,53183,,16342,Terminal LS - Tarjeta TPV,146407,0,"-372801055,75"
05/15/2024,53185,,16311,Terminal LS - Transferencia TPV,61000,0,"-372740055,75"
05/15/2024,53186,,16317,Terminal LS - Transferencia TPV,191300,0,"-372548755,75"
05/15/2024,53187,,16320,Terminal LS - Transferencia TPV,119000,0,"-372429755,75"
05/15/2024,53188,,16321,Terminal LS - Transferencia TPV,130800,0,"-372298955,75"
05/15/2024,53189,,16322,Terminal LS - Transferencia TPV,"9999,99",0,"-372288955,76"
05/15/2024,53191,,16330,Terminal LS - Transferencia TPV,"76262,99",0,"-372212692,77"
05/15/2024,53192,,16332,Terminal LS - Transferencia TPV,"149794,01",0,"-372062898,76"
05/15/2024,53194,,16337,Terminal LS - Transferencia TPV,110352,0,"-371952546,76"
05/16/2024,53373,,16375,Terminal LS - Tarjeta TPV,69270,0,"-371883276,76"
05/16/2024,53372,,16365,Terminal LS - Tarjeta TPV,104015,0,"-371779261,76"
05/16/2024,53374,,16380,Terminal LS - Tarjeta TPV,45572,0,"-371733689,76"
05/16/2024,53385,,16378,Terminal LS - Transferencia TPV,113000,0,"-371620689,76"
05/16/2024,53195,,,Terminal LS - Transferencia TPV,0,1474191,"-373094880,76"
05/16/2024,53384,,16378,Terminal LS - Transferencia TPV,112600,0,"-372982280,76"
05/16/2024,53184,,,Terminal LS - Tarjeta TPV,0,673036,"-373655316,76"
05/16/2024,53387,,16381,Terminal LS - Transferencia TPV,"121114,01",0,"-373534202,75"
05/16/2024,53386,,16379,Terminal LS - Transferencia TPV,77574,0,"-373456628,75"
05/16/2024,53383,,16372,Terminal LS - Transferencia TPV,"87953,99",0,"-373368674,76"
05/16/2024,53382,,16368,Terminal LS - Transferencia TPV,81000,0,"-373287674,76"
05/16/2024,53381,,16367,Terminal LS - Transferencia TPV,89265,0,"-373198409,76"
05/16/2024,53380,,16366,Terminal LS - Transferencia TPV,89265,0,"-373109144,76"
05/16/2024,53379,,16361,Terminal LS - Transferencia TPV,131000,0,"-372978144,76"
05/16/2024,53378,,16360,Terminal LS - Transferencia TPV,61000,0,"-372917144,76"
05/16/2024,53377,,16359,Terminal LS - Transferencia TPV,58500,0,"-372858644,76"
05/16/2024,53376,,16349,Terminal LS - Transferencia TPV,"64999,99",0,"-372793644,77"
05/17/2024,53772,,16413,Terminal LS - Transferencia TPV,60000,0,"-372733644,77"
05/17/2024,53749,,16386,Terminal LS - Tarjeta TPV,"89583,01",0,"-372644061,76"
05/17/2024,53767,,16404,Terminal LS - Transferencia TPV,"40200,01",0,"-372603861,75"
05/17/2024,53780,,16431,Terminal LS - Transferencia TPV,9200,0,"-372594661,75"
05/17/2024,53790,,16449,Terminal LS - Transferencia TPV,112646,0,"-372482015,75"
05/17/2024,53764,,16399,Terminal LS - Transferencia TPV,237000,0,"-372245015,75"
05/17/2024,53781,,16433,Terminal LS - Transferencia TPV,"89999,99",0,"-372155015,76"
05/17/2024,53755,,16442,Terminal LS - Tarjeta TPV,"181151,99",0,"-371973863,77"
05/17/2024,53771,,16412,Terminal LS - Transferencia TPV,160000,0,"-371813863,77"
05/17/2024,53769,,16409,Terminal LS - Transferencia TPV,74132,0,"-371739731,77"
05/17/2024,53766,,16403,Terminal LS - Transferencia TPV,"118999,99",0,"-371620731,78"
05/17/2024,53791,,16450,Terminal LS - Transferencia TPV,63000,0,"-371557731,78"
05/17/2024,53773,,16416,Terminal LS - Transferencia TPV,71700,0,"-371486031,78"
05/17/2024,53757,,16445,Terminal LS - Tarjeta TPV,92324,0,"-371393707,78"
05/17/2024,53787,,16441,Terminal LS - Transferencia TPV,"78338,99",0,"-371315368,79"
05/17/2024,53770,,16410,Terminal LS - Transferencia TPV,"83362,99",0,"-371232005,8"
05/17/2024,53776,,16419,Terminal LS - Transferencia TPV,113000,0,"-371119005,8"
05/17/2024,53783,,16436,Terminal LS - Transferencia TPV,150832,0,"-370968173,8"
05/17/2024,53786,,16440,Terminal LS - Transferencia TPV,320348,0,"-370647825,8"
05/17/2024,53788,,16443,Terminal LS - Transferencia TPV,96421,0,"-370551404,8"
05/17/2024,53785,,16439,Terminal LS - Transferencia TPV,53000,0,"-370498404,8"
05/17/2024,53779,,16427,Terminal LS - Transferencia TPV,142474,0,"-370355930,8"
05/17/2024,53753,,16414,Terminal LS - Tarjeta TPV,"76590,99",0,"-370279339,81"
05/17/2024,53760,,16448,Terminal LS - Tarjeta TPV,75170,0,"-370204169,81"
05/17/2024,53789,,16444,Terminal LS - Transferencia TPV,244522,0,"-369959647,81"
05/17/2024,53762,,16389,Terminal LS - Transferencia TPV,270000,0,"-369689647,81"
05/17/2024,53756,,16444,Terminal LS - Tarjeta TPV,122261,0,"-369567386,81"
05/17/2024,53750,,16389,Terminal LS - Tarjeta TPV,23500,0,"-369543886,81"
05/17/2024,53388,,,Terminal LS - Transferencia TPV,0,1087272,"-370631158,81"
05/17/2024,53375,,,Terminal LS - Tarjeta TPV,0,218857,"-370850015,81"
05/17/2024,53758,,16446,Terminal LS - Tarjeta TPV,162742,0,"-370687273,81"
05/17/2024,53782,,16435,Terminal LS - Transferencia TPV,"72438,99",0,"-370614834,82"
05/17/2024,53752,,16398,Terminal LS - Tarjeta TPV,"83364,99",0,"-370531469,83"
05/17/2024,53751,,16395,Terminal LS - Tarjeta TPV,95930,0,"-370435539,83"
05/17/2024,53777,,16422,Terminal LS - Transferencia TPV,190220,0,"-370245319,83"
05/17/2024,53754,,16432,Terminal LS - Tarjeta TPV,71128,0,"-370174191,83"
05/17/2024,53774,,16417,Terminal LS - Transferencia TPV,"63499,99",0,"-370110691,84"
05/17/2024,53778,,16424,Terminal LS - Transferencia TPV,165255,0,"-369945436,84"
05/17/2024,53768,,16405,Terminal LS - Transferencia TPV,"94727,99",0,"-369850708,85"
05/17/2024,53784,,16438,Terminal LS - Transferencia TPV,63000,0,"-369787708,85"
05/17/2024,53763,,16391,Terminal LS - Transferencia TPV,58000,0,"-369729708,85"
05/17/2024,53765,,16401,Terminal LS - Transferencia TPV,73695,0,"-369656013,85"
05/17/2024,53759,,16447,Terminal LS - Tarjeta TPV,136410,0,"-369519603,85"
05/17/2024,53775,,16418,Terminal LS - Transferencia TPV,67000,0,"-369452603,85"
05/18/2024,54302,,16483,Terminal LS - Transferencia TPV,"72799,99",0,"-369379803,86"
05/18/2024,54309,,16527,Terminal LS - Transferencia TPV,74843,0,"-369304960,86"
05/18/2024,54284,,16506,Terminal LS - Tarjeta TPV,80852,0,"-369224108,86"
05/18/2024,54300,,16466,Terminal LS - Transferencia TPV,78700,0,"-369145408,86"
05/18/2024,54294,,16544,Terminal LS - Tarjeta TPV,80961,0,"-369064447,86"
05/18/2024,54281,,16492,Terminal LS - Tarjeta TPV,51352,0,"-369013095,86"
05/18/2024,54293,,16539,Terminal LS - Tarjeta TPV,138322,0,"-368874773,86"
05/18/2024,54290,,16529,Terminal LS - Tarjeta TPV,"142255,99",0,"-368732517,87"
05/18/2024,54299,,16465,Terminal LS - Transferencia TPV,65000,0,"-368667517,87"
05/18/2024,54278,,16481,Terminal LS - Tarjeta TPV,189401,0,"-368478116,87"
05/18/2024,54280,,16488,Terminal LS - Tarjeta TPV,"83801,99",0,"-368394314,88"
05/18/2024,54315,,16548,Terminal LS - Transferencia TPV,82873,0,"-368311441,88"
05/18/2024,54289,,16520,Terminal LS - Tarjeta TPV,142911,0,"-368168530,88"
05/18/2024,54305,,16496,Terminal LS - Transferencia TPV,66000,0,"-368102530,88"
05/18/2024,54287,,16513,Terminal LS - Tarjeta TPV,92597,0,"-368009933,88"
05/18/2024,54275,,16453,Terminal LS - Tarjeta TPV,83092,0,"-367926841,88"
05/18/2024,54298,,16459,Terminal LS - Transferencia TPV,62000,0,"-367864841,88"
05/18/2024,53761,,,Terminal LS - Tarjeta TPV,0,1210156,"-369074997,88"
05/18/2024,54303,,16491,Terminal LS - Transferencia TPV,44000,0,"-369030997,88"
05/18/2024,54285,,16508,Terminal LS - Tarjeta TPV,"88608,99",0,"-368942388,89"
05/18/2024,53792,,,Terminal LS - Transferencia TPV,0,3437011,"-372379399,89"
05/18/2024,54313,,16546,Terminal LS - Transferencia TPV,"173999,99",0,"-372205399,9"
05/18/2024,54297,,16456,Terminal LS - Transferencia TPV,"170990,99",0,"-372034408,91"
05/18/2024,54307,,16525,Terminal LS - Transferencia TPV,115000,0,"-371919408,91"
05/18/2024,54288,,16519,Terminal LS - Tarjeta TPV,"91558,99",0,"-371827849,92"
05/18/2024,54306,,16512,Terminal LS - Transferencia TPV,58000,0,"-371769849,92"
05/18/2024,54291,,16537,Terminal LS - Tarjeta TPV,83037,0,"-371686812,92"
05/18/2024,54301,,16482,Terminal LS - Transferencia TPV,7000,0,"-371679812,92"
05/18/2024,54304,,16493,Terminal LS - Transferencia TPV,57500,0,"-371622312,92"
05/18/2024,54312,,16545,Terminal LS - Transferencia TPV,390000,0,"-371232312,92"
05/18/2024,54279,,16486,Terminal LS - Tarjeta TPV,62988,0,"-371169324,92"
05/18/2024,54282,,16499,Terminal LS - Tarjeta TPV,94728,0,"-371074596,92"
05/18/2024,54310,,16542,Terminal LS - Transferencia TPV,185522,0,"-370889074,92"
05/18/2024,54276,,16468,Terminal LS - Tarjeta TPV,"93416,99",0,"-370795657,93"
05/18/2024,54277,,16480,Terminal LS - Tarjeta TPV,156514,0,"-370639143,93"
05/18/2024,54308,,16526,Terminal LS - Transferencia TPV,"133623,99",0,"-370505519,94"
05/18/2024,54286,,16510,Terminal LS - Tarjeta TPV,"117453,99",0,"-370388065,95"
05/18/2024,54292,,16538,Terminal LS - Tarjeta TPV,"88281,01",0,"-370299784,94"
05/18/2024,54314,,16547,Terminal LS - Transferencia TPV,"103632,01",0,"-370196152,93"
05/18/2024,54283,,16501,Terminal LS - Tarjeta TPV,132859,0,"-370063293,93"
05/18/2024,54311,,16543,Terminal LS - Transferencia TPV,99808,0,"-369963485,93"
05/18/2024,54296,,16454,Terminal LS - Transferencia TPV,76481,0,"-369887004,93"
05/19/2024,54733,,16560,Terminal LS - Tarjeta TPV,"154492,99",0,"-369732511,94"
05/19/2024,54734,,16561,Terminal LS - Tarjeta TPV,79923,0,"-369652588,94"
05/19/2024,54735,,16566,Terminal LS - Tarjeta TPV,95056,0,"-369557532,94"
05/19/2024,54736,,16569,Terminal LS - Tarjeta TPV,135755,0,"-369421777,94"
05/19/2024,54738,,16584,Terminal LS - Tarjeta TPV,67795,0,"-369353982,94"
05/19/2024,54739,,16597,Terminal LS - Tarjeta TPV,87954,0,"-369266028,94"
05/19/2024,54748,,16604,Terminal LS - Transferencia TPV,102813,0,"-369163215,94"
05/19/2024,54747,,16601,Terminal LS - Transferencia TPV,"59999,99",0,"-369103215,95"
05/19/2024,54746,,16591,Terminal LS - Transferencia TPV,81000,0,"-369022215,95"
05/19/2024,54745,,16588,Terminal LS - Transferencia TPV,73750,0,"-368948465,95"
05/19/2024,54743,,16628,Terminal LS - Tarjeta TPV,"233705,99",0,"-368714759,96"
05/19/2024,54742,,16625,Terminal LS - Tarjeta TPV,78776,0,"-368635983,96"
05/19/2024,54741,,16611,Terminal LS - Tarjeta TPV,91778,0,"-368544205,96"
05/19/2024,54740,,16607,Terminal LS - Tarjeta TPV,"111116,99",0,"-368433088,97"
05/19/2024,54316,,,Terminal LS - Transferencia TPV,0,2117772,"-370550860,97"
05/19/2024,54295,,,Terminal LS - Tarjeta TPV,0,2094987,"-372645847,97"
05/19/2024,54753,,16626,Terminal LS - Transferencia TPV,95000,0,"-372550847,97"
05/19/2024,54752,,16624,Terminal LS - Transferencia TPV,99426,0,"-372451421,97"
05/19/2024,54751,,16620,Terminal LS - Transferencia TPV,77700,0,"-372373721,97"
05/19/2024,54750,,16619,Terminal LS - Transferencia TPV,76263,0,"-372297458,97"
05/19/2024,54749,,16618,Terminal LS - Transferencia TPV,152034,0,"-372145424,97"
05/19/2024,54737,,16570,Terminal LS - Tarjeta TPV,"159354,99",0,"-371986069,98"
05/20/2024,54744,,,Terminal LS - Tarjeta TPV,0,1295706,"-373281775,98"
05/20/2024,54754,,,Terminal LS - Transferencia TPV,0,817986,"-374099761,98"
05/21/2024,54832,,16635,Terminal LS - Transferencia TPV,95820,0,"-374003941,98"
05/21/2024,54834,,16638,Terminal LS - Transferencia TPV,83146,0,"-373920795,98"
05/21/2024,54830,,16633,Terminal LS - Transferencia TPV,58000,0,"-373862795,98"
05/21/2024,54824,,16641,Terminal LS - Tarjeta TPV,"86423,99",0,"-373776371,99"
05/21/2024,54823,,16640,Terminal LS - Tarjeta TPV,114340,0,"-373662031,99"
05/21/2024,54822,,16637,Terminal LS - Tarjeta TPV,149200,0,"-373512831,99"
05/21/2024,54833,,16636,Terminal LS - Transferencia TPV,"179000,01",0,"-373333831,98"
05/21/2024,54827,,16629,Terminal LS - Transferencia TPV,40754,0,"-373293077,98"
05/21/2024,54831,,16634,Terminal LS - Transferencia TPV,120000,0,"-373173077,98"
05/21/2024,54828,,16630,Terminal LS - Transferencia TPV,71346,0,"-373101731,98"
05/21/2024,54825,,16643,Terminal LS - Tarjeta TPV,82327,0,"-373019404,98"
05/21/2024,54829,,16632,Terminal LS - Transferencia TPV,93550,0,"-372925854,98"
05/22/2024,55072,,16650,Terminal LS - Transferencia TPV,222616,0,"-372703238,98"
05/22/2024,55071,,16648,Terminal LS - Transferencia TPV,93100,0,"-372610138,98"
05/22/2024,55070,,16647,Terminal LS - Transferencia TPV,61500,0,"-372548638,98"
05/22/2024,55069,,16646,Terminal LS - Transferencia TPV,17400,0,"-372531238,98"
05/22/2024,54835,,,Terminal LS - Transferencia TPV,0,741616,"-373272854,98"
05/22/2024,55083,,16685,Terminal LS - Transferencia TPV,142583,0,"-373130271,98"
05/22/2024,55084,,16686,Terminal LS - Transferencia TPV,172264,0,"-372958007,98"
05/22/2024,55082,,16684,Terminal LS - Transferencia TPV,138158,0,"-372819849,98"
05/22/2024,55081,,16682,Terminal LS - Transferencia TPV,113903,0,"-372705946,98"
05/22/2024,54826,,,Terminal LS - Tarjeta TPV,0,432291,"-373138237,98"
05/22/2024,55080,,16680,Terminal LS - Transferencia TPV,51850,0,"-373086387,98"
05/22/2024,55079,,16679,Terminal LS - Transferencia TPV,156077,0,"-372930310,98"
05/22/2024,55078,,16677,Terminal LS - Transferencia TPV,76000,0,"-372854310,98"
05/22/2024,55077,,16671,Terminal LS - Transferencia TPV,"79999,99",0,"-372774310,99"
05/22/2024,55076,,16670,Terminal LS - Transferencia TPV,"277000,01",0,"-372497310,98"
05/22/2024,55075,,16667,Terminal LS - Transferencia TPV,52500,0,"-372444810,98"
05/22/2024,55067,,16686,Terminal LS - Tarjeta TPV,"86133,99",0,"-372358676,99"
05/22/2024,55064,,16675,Terminal LS - Tarjeta TPV,87735,0,"-372270941,99"
05/22/2024,55065,,16681,Terminal LS - Tarjeta TPV,"288990,99",0,-371981951
05/22/2024,55066,,16683,Terminal LS - Tarjeta TPV,71346,0,-371910605
05/22/2024,55074,,16657,Terminal LS - Transferencia TPV,89046,0,-371821559
05/22/2024,55073,,16656,Terminal LS - Transferencia TPV,117000,0,-371704559
05/23/2024,55273,,16714,Terminal LS - Transferencia TPV,92203,0,-371612356
05/23/2024,55271,,16712,Terminal LS - Transferencia TPV,115000,0,-371497356
05/23/2024,55270,,16710,Terminal LS - Transferencia TPV,118850,0,-371378506
05/23/2024,55269,,16705,Terminal LS - Transferencia TPV,60000,0,-371318506
05/23/2024,55268,,16702,Terminal LS - Transferencia TPV,95165,0,-371223341
05/23/2024,55267,,16699,Terminal LS - Transferencia TPV,5400,0,-371217941
05/23/2024,55266,,16697,Terminal LS - Transferencia TPV,"177000,01",0,"-371040940,99"
05/23/2024,55264,,16726,Terminal LS - Tarjeta TPV,67741,0,"-370973199,99"
05/23/2024,55263,,16725,Terminal LS - Tarjeta TPV,99972,0,"-370873227,99"
05/23/2024,55262,,16721,Terminal LS - Tarjeta TPV,80961,0,"-370792266,99"
05/23/2024,55085,,,Terminal LS - Transferencia TPV,0,1860996,"-372653262,99"
05/23/2024,55068,,,Terminal LS - Tarjeta TPV,0,534204,"-373187466,99"
05/23/2024,55258,,16688,Terminal LS - Tarjeta TPV,205899,0,"-372981567,99"
05/23/2024,55259,,16690,Terminal LS - Tarjeta TPV,286751,0,"-372694816,99"
05/23/2024,55260,,16700,Terminal LS - Tarjeta TPV,62278,0,"-372632538,99"
05/23/2024,55261,,16720,Terminal LS - Tarjeta TPV,"56814,99",0,-372575724
05/23/2024,55274,,16715,Terminal LS - Transferencia TPV,116500,0,-372459224
05/23/2024,55275,,16717,Terminal LS - Transferencia TPV,"94599,99",0,"-372364624,01"
05/23/2024,55276,,16722,Terminal LS - Transferencia TPV,"68099,99",0,"-372296524,02"
05/23/2024,55277,,16723,Terminal LS - Transferencia TPV,"111772,01",0,"-372184752,01"
05/23/2024,55278,,16724,Terminal LS - Transferencia TPV,170300,0,"-372014452,01"
05/23/2024,55272,,16713,Terminal LS - Transferencia TPV,"66000,01",0,-371948452
05/24/2024,55642,,16760,Terminal LS - Transferencia TPV,74843,0,-371873609
05/24/2024,55659,,16803,Terminal LS - Transferencia TPV,144823,0,-371728786
05/24/2024,55617,,16766,Terminal LS - Tarjeta TPV,"124227,99",0,"-371604558,01"
05/24/2024,55644,,16762,Terminal LS - Transferencia TPV,"85112,99",0,"-371519445,02"
05/24/2024,55663,,16813,Terminal LS - Transferencia TPV,87735,0,"-371431710,02"
05/24/2024,55652,,16780,Terminal LS - Transferencia TPV,74132,0,"-371357578,02"
05/24/2024,55640,,16757,Terminal LS - Transferencia TPV,"145806,01",0,"-371211772,01"
05/24/2024,55655,,16789,Terminal LS - Transferencia TPV,100792,0,"-371110980,01"
05/24/2024,55645,,16764,Terminal LS - Transferencia TPV,"117000,01",0,-370993980
05/24/2024,55632,,16812,Terminal LS - Tarjeta TPV,"181370,01",0,"-370812609,99"
05/24/2024,55621,,16787,Terminal LS - Tarjeta TPV,67368,0,"-370745241,99"
05/24/2024,55653,,16784,Terminal LS - Transferencia TPV,"274185,99",0,-370471056
05/24/2024,55279,,,Terminal LS - Transferencia TPV,0,1290890,-371761946
05/24/2024,55265,,,Terminal LS - Tarjeta TPV,0,860416,-372622362
05/24/2024,55629,,16807,Terminal LS - Tarjeta TPV,15300,0,-372607062
05/24/2024,55639,,16753,Terminal LS - Transferencia TPV,"76481,01",0,"-372530580,99"
05/24/2024,55641,,16758,Terminal LS - Transferencia TPV,88609,0,"-372441971,99"
05/24/2024,55658,,16802,Terminal LS - Transferencia TPV,"71299,99",0,-372370672
05/24/2024,55647,,16768,Terminal LS - Transferencia TPV,"117999,99",0,"-372252672,01"
05/24/2024,55657,,16798,Terminal LS - Transferencia TPV,289646,0,"-371963026,01"
05/24/2024,55660,,16808,Terminal LS - Transferencia TPV,50570,0,"-371912456,01"
05/24/2024,55649,,16774,Terminal LS - Transferencia TPV,86806,0,"-371825650,01"
05/24/2024,55618,,16779,Terminal LS - Tarjeta TPV,"139414,99",0,"-371686235,02"
05/24/2024,55648,,16769,Terminal LS - Transferencia TPV,101830,0,"-371584405,02"
05/24/2024,55665,,16816,Terminal LS - Transferencia TPV,101720,0,"-371482685,02"
05/24/2024,55622,,16799,Terminal LS - Tarjeta TPV,268832,0,"-371213853,02"
05/24/2024,55636,,16744,Terminal LS - Transferencia TPV,23200,0,"-371190653,02"
05/24/2024,55616,,16743,Terminal LS - Tarjeta TPV,51850,0,"-371138803,02"
05/24/2024,55637,,16750,Terminal LS - Transferencia TPV,9600,0,"-371129203,02"
05/24/2024,55664,,16814,Terminal LS - Transferencia TPV,"154055,99",0,"-370975147,03"
05/24/2024,55638,,16752,Terminal LS - Transferencia TPV,80078,0,"-370895069,03"
05/24/2024,55627,,16805,Terminal LS - Tarjeta TPV,30000,0,"-370865069,03"
05/24/2024,55626,,16804,Terminal LS - Tarjeta TPV,70000,0,"-370795069,03"
05/24/2024,55661,,16809,Terminal LS - Transferencia TPV,"101720,01",0,"-370693349,02"
05/24/2024,55633,,16815,Terminal LS - Tarjeta TPV,224528,0,"-370468821,02"
05/24/2024,55654,,16786,Terminal LS - Transferencia TPV,193389,0,"-370275432,02"
05/24/2024,55625,,16804,Terminal LS - Tarjeta TPV,26476,0,"-370248956,02"
05/24/2024,55624,,16801,Terminal LS - Tarjeta TPV,155039,0,"-370093917,02"
05/24/2024,55628,,16805,Terminal LS - Tarjeta TPV,"39051,99",0,"-370054865,03"
05/24/2024,55630,,16808,Terminal LS - Tarjeta TPV,50568,0,"-370004297,03"
05/24/2024,55631,,16808,Terminal LS - Tarjeta TPV,50568,0,"-369953729,03"
05/24/2024,55662,,16810,Terminal LS - Transferencia TPV,49167,0,"-369904562,03"
05/24/2024,55635,,16742,Terminal LS - Transferencia TPV,"104724,99",0,"-369799837,04"
05/24/2024,55643,,16761,Terminal LS - Transferencia TPV,114200,0,"-369685637,04"
05/24/2024,55619,,16781,Terminal LS - Tarjeta TPV,150987,0,"-369534650,04"
05/24/2024,55620,,16782,Terminal LS - Tarjeta TPV,"75000,01",0,"-369459650,03"
05/24/2024,55646,,16765,Terminal LS - Transferencia TPV,62600,0,"-369397050,03"
05/24/2024,55656,,16793,Terminal LS - Transferencia TPV,11500,0,"-369385550,03"
05/24/2024,55650,,16776,Terminal LS - Transferencia TPV,"117000,01",0,"-369268550,02"
05/24/2024,55623,,16800,Terminal LS - Tarjeta TPV,198032,0,"-369070518,02"
05/24/2024,55651,,16778,Terminal LS - Transferencia TPV,82819,0,"-368987699,02"
05/25/2024,55634,,,Terminal LS - Tarjeta TPV,0,1918610,"-370906309,02"
05/25/2024,56054,,16819,Terminal LS - Tarjeta TPV,80688,0,"-370825621,02"
05/25/2024,56055,,16822,Terminal LS - Tarjeta TPV,55000,0,"-370770621,02"
05/25/2024,56056,,16824,Terminal LS - Tarjeta TPV,"93962,99",0,"-370676658,03"
05/25/2024,56057,,16838,Terminal LS - Tarjeta TPV,"285713,01",0,"-370390945,02"
05/25/2024,56058,,16840,Terminal LS - Tarjeta TPV,65000,0,"-370325945,02"
05/25/2024,56059,,16842,Terminal LS - Tarjeta TPV,99050,0,"-370226895,02"
05/25/2024,56060,,16866,Terminal LS - Tarjeta TPV,78503,0,"-370148392,02"
05/25/2024,56061,,16884,Terminal LS - Tarjeta TPV,"79977,99",0,"-370068414,03"
05/25/2024,56062,,16885,Terminal LS - Tarjeta TPV,79650,0,"-369988764,03"
05/25/2024,56063,,16888,Terminal LS - Tarjeta TPV,127396,0,"-369861368,03"
05/25/2024,56064,,16895,Terminal LS - Tarjeta TPV,"88281,01",0,"-369773087,02"
05/25/2024,56066,,16897,Terminal LS - Tarjeta TPV,246926,0,"-369526161,02"
05/25/2024,56068,,16825,Terminal LS - Transferencia TPV,"117344,01",0,"-369408817,01"
05/25/2024,56069,,16826,Terminal LS - Transferencia TPV,"59999,99",0,"-369348817,02"
05/25/2024,56070,,16839,Terminal LS - Transferencia TPV,"90685,01",0,"-369258132,01"
05/25/2024,56071,,16841,Terminal LS - Transferencia TPV,"113849,99",0,"-369144282,02"
05/25/2024,56072,,16851,Terminal LS - Transferencia TPV,95820,0,"-369048462,02"
05/25/2024,56073,,16859,Terminal LS - Transferencia TPV,118000,0,"-368930462,02"
05/25/2024,56074,,16860,Terminal LS - Transferencia TPV,"90499,99",0,"-368839962,03"
05/25/2024,56075,,16863,Terminal LS - Transferencia TPV,71346,0,"-368768616,03"
05/25/2024,56076,,16869,Terminal LS - Transferencia TPV,92597,0,"-368676019,03"
05/25/2024,56077,,16871,Terminal LS - Transferencia TPV,37694,0,"-368638325,03"
05/25/2024,56078,,16876,Terminal LS - Transferencia TPV,98880,0,"-368539445,03"
05/25/2024,56079,,16887,Terminal LS - Transferencia TPV,278000,0,"-368261445,03"
05/25/2024,56080,,16890,Terminal LS - Transferencia TPV,15296,0,"-368246149,03"
05/25/2024,56081,,16891,Terminal LS - Transferencia TPV,"83255,99",0,"-368162893,04"
05/25/2024,56082,,16894,Terminal LS - Transferencia TPV,245300,0,"-367917593,04"
05/25/2024,56083,,16899,Terminal LS - Transferencia TPV,91341,0,"-367826252,04"
05/25/2024,56065,,16896,Terminal LS - Tarjeta TPV,26000,0,"-367800252,04"
05/25/2024,55666,,,Terminal LS - Transferencia TPV,0,3193444,"-370993696,04"
05/26/2024,56478,,16954,Terminal LS - Transferencia TPV,106500,0,"-370887196,04"
05/26/2024,56067,,,Terminal LS - Tarjeta TPV,0,1406147,"-372293343,04"
05/26/2024,56084,,,Terminal LS - Transferencia TPV,0,1699908,"-373993251,04"
05/26/2024,56464,,16933,Terminal LS - Tarjeta TPV,"207210,01",0,"-373786041,03"
05/26/2024,56465,,16963,Terminal LS - Tarjeta TPV,"104670,01",0,"-373681371,02"
05/26/2024,56466,,16967,Terminal LS - Tarjeta TPV,"84129,99",0,"-373597241,03"
05/26/2024,56467,,16969,Terminal LS - Tarjeta TPV,"499423,97",0,"-373097817,06"
05/26/2024,56468,,16971,Terminal LS - Tarjeta TPV,"158971,99",0,"-372938845,07"
05/26/2024,56470,,16903,Terminal LS - Transferencia TPV,90139,0,"-372848706,07"
05/26/2024,56471,,16915,Terminal LS - Transferencia TPV,90000,0,"-372758706,07"
05/26/2024,56472,,16916,Terminal LS - Transferencia TPV,"166999,99",0,"-372591706,08"
05/26/2024,56473,,16917,Terminal LS - Transferencia TPV,63000,0,"-372528706,08"
05/26/2024,56474,,16926,Terminal LS - Transferencia TPV,26222,0,"-372502484,08"
05/26/2024,56475,,16927,Terminal LS - Transferencia TPV,78230,0,"-372424254,08"
05/26/2024,56476,,16941,Terminal LS - Transferencia TPV,"82499,99",0,"-372341754,09"
05/26/2024,56483,,16977,Terminal LS - Transferencia TPV,90685,0,"-372251069,09"
05/26/2024,56482,,16968,Terminal LS - Transferencia TPV,87735,0,"-372163334,09"
05/26/2024,56481,,16964,Terminal LS - Transferencia TPV,67000,0,"-372096334,09"
05/26/2024,56480,,16962,Terminal LS - Transferencia TPV,"122000,01",0,"-371974334,08"
05/26/2024,56479,,16956,Terminal LS - Transferencia TPV,168000,0,"-371806334,08"
05/26/2024,56477,,16947,Terminal LS - Transferencia TPV,197850,0,"-371608484,08"
05/27/2024,56469,,,Terminal LS - Tarjeta TPV,0,1054403,"-372662887,08"
05/27/2024,56484,,,Terminal LS - Transferencia TPV,0,1436861,"-374099748,08"
05/28/2024,56572,,16981,Terminal LS - Tarjeta TPV,51000,0,"-374048748,08"
05/28/2024,56571,,16980,Terminal LS - Tarjeta TPV,47000,0,"-374001748,08"
05/28/2024,56577,,16985,Terminal LS - Transferencia TPV,171319,0,"-373830429,08"
05/28/2024,56576,,16984,Terminal LS - Transferencia TPV,61000,0,"-373769429,08"
05/28/2024,56575,,16983,Terminal LS - Transferencia TPV,183000,0,"-373586429,08"
05/28/2024,56573,,16982,Terminal LS - Tarjeta TPV,"13766,99",0,"-373572662,09"
05/29/2024,56645,,16994,Terminal LS - Tarjeta TPV,66648,0,"-373506014,09"
05/29/2024,56574,,,Terminal LS - Tarjeta TPV,0,111766,"-373617780,09"
05/29/2024,56578,,,Terminal LS - Transferencia TPV,0,415319,"-374033099,09"
05/29/2024,56647,,16997,Terminal LS - Tarjeta TPV,284620,0,"-373748479,09"
05/29/2024,56648,,16998,Terminal LS - Tarjeta TPV,77600,0,"-373670879,09"
05/29/2024,56650,,16992,Terminal LS - Transferencia TPV,62950,0,"-373607929,09"
05/29/2024,56651,,16993,Terminal LS - Transferencia TPV,"84999,99",0,"-373522929,1"
05/29/2024,56652,,17002,Terminal LS - Transferencia TPV,146407,0,"-373376522,1"
05/29/2024,56646,,16996,Terminal LS - Tarjeta TPV,95602,0,"-373280920,1"
05/30/2024,56934,,17043,Terminal LS - Transferencia TPV,"72766,99",0,"-373208153,11"
05/30/2024,56935,,17050,Terminal LS - Transferencia TPV,"87625,99",0,"-373120527,12"
05/30/2024,56936,,17051,Terminal LS - Transferencia TPV,"183555,99",0,"-372936971,13"
05/30/2024,56937,,17052,Terminal LS - Transferencia TPV,86970,0,"-372850001,13"
05/30/2024,56938,,17054,Terminal LS - Transferencia TPV,"157879,99",0,"-372692121,14"
05/30/2024,56916,,17056,Terminal LS - Tarjeta TPV,99426,0,"-372592695,14"
05/30/2024,56940,,17057,Terminal LS - Transferencia TPV,10000,0,"-372582695,14"
05/30/2024,56941,,17059,Terminal LS - Transferencia TPV,75170,0,"-372507525,14"
05/30/2024,56942,,17060,Terminal LS - Transferencia TPV,"138212,99",0,"-372369312,15"
05/30/2024,56943,,17062,Terminal LS - Transferencia TPV,"128399,99",0,"-372240912,16"
05/30/2024,56939,,17055,Terminal LS - Transferencia TPV,107074,0,"-372133838,16"
05/30/2024,56917,,17058,Terminal LS - Tarjeta TPV,151324,0,"-371982514,16"
05/30/2024,56919,,17005,Terminal LS - Transferencia TPV,56500,0,"-371926014,16"
05/30/2024,56920,,17006,Terminal LS - Transferencia TPV,"158099,99",0,"-371767914,17"
05/30/2024,56921,,17014,Terminal LS - Transferencia TPV,9400,0,"-371758514,17"
05/30/2024,56922,,17015,Terminal LS - Transferencia TPV,73859,0,"-371684655,17"
05/30/2024,56923,,17016,Terminal LS - Transferencia TPV,15700,0,"-371668955,17"
05/30/2024,56924,,17018,Terminal LS - Transferencia TPV,32000,0,"-371636955,17"
05/30/2024,56925,,17022,Terminal LS - Transferencia TPV,"71018,99",0,"-371565936,18"
05/30/2024,56926,,17023,Terminal LS - Transferencia TPV,"85222,01",0,"-371480714,17"
05/30/2024,56927,,17026,Terminal LS - Transferencia TPV,64000,0,"-371416714,17"
05/30/2024,56928,,17030,Terminal LS - Transferencia TPV,167604,0,"-371249110,17"
05/30/2024,56929,,17031,Terminal LS - Transferencia TPV,72000,0,"-371177110,17"
05/30/2024,56930,,17032,Terminal LS - Transferencia TPV,67000,0,"-371110110,17"
05/30/2024,56931,,17037,Terminal LS - Transferencia TPV,93417,0,"-371016693,17"
05/30/2024,56932,,17038,Terminal LS - Transferencia TPV,78994,0,"-370937699,17"
05/30/2024,56933,,17042,Terminal LS - Transferencia TPV,"69379,99",0,"-370868319,18"
05/30/2024,56910,,17008,Terminal LS - Tarjeta TPV,46500,0,"-370821819,18"
05/30/2024,56911,,17009,Terminal LS - Tarjeta TPV,158262,0,"-370663557,18"
05/30/2024,56912,,17025,Terminal LS - Tarjeta TPV,"102000,01",0,"-370561557,17"
05/30/2024,56913,,17041,Terminal LS - Tarjeta TPV,81398,0,"-370480159,17"
05/30/2024,56914,,17047,Terminal LS - Tarjeta TPV,143355,0,"-370336804,17"
05/30/2024,56653,,,Terminal LS - Transferencia TPV,0,294357,"-370631161,17"
05/30/2024,56649,,,Terminal LS - Tarjeta TPV,0,524470,"-371155631,17"
05/30/2024,56915,,17049,Terminal LS - Tarjeta TPV,"167930,98",0,"-370987700,19"
05/31/2024,57449,,17125,Terminal LS - Transferencia TPV,"157399,99",0,"-370830300,2"
05/31/2024,57447,,17114,Terminal LS - Transferencia TPV,66000,0,"-370764300,2"
05/31/2024,57429,,17128,Terminal LS - Tarjeta TPV,145151,0,"-370619149,2"
05/31/2024,57463,,17161,Terminal LS - Transferencia TPV,"157999,99",0,"-370461149,21"
05/31/2024,57462,,17160,Terminal LS - Transferencia TPV,"108385,01",0,"-370352764,2"
05/31/2024,57425,,17095,Terminal LS - Tarjeta TPV,"66975,99",0,"-370285788,21"
05/31/2024,57459,,17150,Terminal LS - Transferencia TPV,81500,0,"-370204288,21"
05/31/2024,57441,,17088,Terminal LS - Transferencia TPV,82491,0,"-370121797,21"
05/31/2024,57443,,17092,Terminal LS - Transferencia TPV,127615,0,"-369994182,21"
05/31/2024,57423,,17071,Terminal LS - Tarjeta TPV,"75716,99",0,"-369918465,22"
05/31/2024,57456,,17142,Terminal LS - Transferencia TPV,90248,0,"-369828217,22"
05/31/2024,57436,,17163,Terminal LS - Tarjeta TPV,92200,0,"-369736017,22"
05/31/2024,57428,,17126,Terminal LS - Tarjeta TPV,80415,0,"-369655602,22"
05/31/2024,57440,,17077,Terminal LS - Transferencia TPV,58850,0,"-369596752,22"
05/31/2024,57445,,17107,Terminal LS - Transferencia TPV,151324,0,"-369445428,22"
05/31/2024,57432,,17148,Terminal LS - Tarjeta TPV,"97568,99",0,"-369347859,23"
05/31/2024,57439,,17069,Terminal LS - Transferencia TPV,107074,0,"-369240785,23"
05/31/2024,57446,,17112,Terminal LS - Transferencia TPV,"132203,98",0,"-369108581,25"
05/31/2024,57451,,17135,Terminal LS - Transferencia TPV,207101,0,"-368901480,25"
05/31/2024,57434,,17158,Terminal LS - Tarjeta TPV,87735,0,"-368813745,25"
05/31/2024,57460,,17151,Terminal LS - Transferencia TPV,"217099,99",0,"-368596645,26"
05/31/2024,57430,,17131,Terminal LS - Tarjeta TPV,108000,0,"-368488645,26"
05/31/2024,57424,,17085,Terminal LS - Tarjeta TPV,51850,0,"-368436795,26"
05/31/2024,57427,,17122,Terminal LS - Tarjeta TPV,265281,0,"-368171514,26"
05/31/2024,57431,,17145,Terminal LS - Tarjeta TPV,"89592,99",0,"-368081921,27"
05/31/2024,57438,,17067,Terminal LS - Transferencia TPV,10400,0,"-368071521,27"
05/31/2024,57448,,17115,Terminal LS - Transferencia TPV,64000,0,"-368007521,27"
05/31/2024,57442,,17090,Terminal LS - Transferencia TPV,64000,0,"-367943521,27"
05/31/2024,57444,,17096,Terminal LS - Transferencia TPV,143130,0,"-367800391,27"
05/31/2024,57422,,17064,Terminal LS - Tarjeta TPV,150286,0,"-367650105,27"
05/31/2024,56944,,,Terminal LS - Transferencia TPV,0,2161846,"-369811951,27"
05/31/2024,57433,,17149,Terminal LS - Tarjeta TPV,"90138,99",0,"-369721812,28"
05/31/2024,57426,,17121,Terminal LS - Tarjeta TPV,157700,0,"-369564112,28"
05/31/2024,57452,,17137,Terminal LS - Transferencia TPV,"163833,99",0,"-369400278,29"
05/31/2024,57454,,17140,Terminal LS - Transferencia TPV,74100,0,"-369326178,29"
05/31/2024,57458,,17144,Terminal LS - Transferencia TPV,"171536,99",0,"-369154641,3"
05/31/2024,57435,,17159,Terminal LS - Tarjeta TPV,"115268,99",0,"-369039372,31"
05/31/2024,56918,,,Terminal LS - Tarjeta TPV,0,950195,"-369989567,31"
05/31/2024,57453,,17138,Terminal LS - Transferencia TPV,"154492,98",0,"-369835074,33"
05/31/2024,57457,,17143,Terminal LS - Transferencia TPV,"80305,99",0,"-369754768,34"
05/31/2024,57455,,17141,Terminal LS - Transferencia TPV,"114199,99",0,"-369640568,35"
05/31/2024,57450,,17127,Terminal LS - Transferencia TPV,"89920,01",0,"-369550648,34"
05/31/2024,57461,,17153,Terminal LS - Transferencia TPV,74276,0,"-369476372,34"
